gi|514486632|gb|KE346360.1|	261	274	AATG	13	-	3	CATT
gi|514486632|gb|KE346360.1|	378	390	AAGGAC	12	-	2	TGTCCT
gi|514486632|gb|KE346360.1|	760	772	ATCGCC	12	-	2	GCGATG
gi|514486632|gb|KE346360.1|	1084	1104	A	20	-	20	T
gi|514486632|gb|KE346360.1|	1230	1266	AG	36	-	18	TC
gi|514486632|gb|KE346360.1|	1261	1278	ACTCTC	17	+	2	CTCTCA
gi|514486632|gb|KE346360.1|	1351	1366	AGCCTG	15	+	2	CCTGAG
gi|514486632|gb|KE346360.1|	2495	2507	AAGCTC	12	-	2	TTGAGC
gi|514486632|gb|KE346360.1|	2773	2804	A	31	-	31	T
gi|514486632|gb|KE346360.1|	2832	2845	AAAATG	13	-	2	TCATTT
gi|514486632|gb|KE346360.1|	3048	3066	A	18	-	18	T
gi|514486632|gb|KE346360.1|	3144	3156	ACGAGC	12	+	2	GAGCAC
gi|514486632|gb|KE346360.1|	3201	3221	AGC	20	-	6	TGC
gi|514486632|gb|KE346360.1|	3467	3509	A	42	-	42	T
gi|514486632|gb|KE346360.1|	3621	3633	ACCGC	12	-	2	TGCGG
gi|514486632|gb|KE346360.1|	3718	3738	A	20	-	20	T
gi|514486632|gb|KE346360.1|	3753	3765	A	12	-	12	T
gi|514486632|gb|KE346360.1|	3896	3909	AAACAG	13	-	2	GTTTCT
gi|514486632|gb|KE346360.1|	4391	4415	A	24	-	24	T
gi|514486632|gb|KE346360.1|	4843	4856	AAGAGG	13	-	2	CTCTTC
gi|514486632|gb|KE346360.1|	4930	4945	AAAC	15	-	3	TTTG
gi|514486632|gb|KE346360.1|	6253	6269	AAAC	16	-	4	TTTG
gi|514486632|gb|KE346360.1|	8157	8169	ACCATC	12	-	2	TGGTGA
gi|514486632|gb|KE346360.1|	9683	9696	AAAAAC	13	+	2	ACAAAA
gi|514486632|gb|KE346360.1|	9725	9741	A	16	+	16	A
gi|514486632|gb|KE346360.1|	9776	9793	A	17	+	17	A
gi|514486632|gb|KE346360.1|	9829	9843	ACATGC	14	-	2	GCATGT
gi|514486632|gb|KE346360.1|	10561	10573	ACGGGC	12	-	2	CCGTGC
gi|514486632|gb|KE346360.1|	10973	10990	AC	17	+	8	AC
gi|514486632|gb|KE346360.1|	11704	11717	ACAGCG	13	-	2	TGTCGC
gi|514486632|gb|KE346360.1|	11835	11884	AC	49	+	24	AC
gi|514486632|gb|KE346360.1|	11930	11943	ACTC	13	-	3	AGTG
gi|514486632|gb|KE346360.1|	12045	12063	AGG	18	-	6	CCT
gi|514486632|gb|KE346360.1|	12295	12307	AATCGG	12	+	2	GAATCG
gi|514486632|gb|KE346360.1|	12571	12583	AGCTCC	12	+	2	CCAGCT
gi|514486632|gb|KE346360.1|	12795	12807	AGCCC	12	+	2	GCCCA
gi|514486632|gb|KE346360.1|	13293	13305	ACGATG	12	+	2	CGATGA
gi|514486632|gb|KE346360.1|	13305	13322	AGC	17	+	5	AGC
gi|514486632|gb|KE346360.1|	13320	13338	AAG	18	+	6	AGA
gi|514486632|gb|KE346360.1|	13454	13472	ATC	18	-	6	ATG
gi|514486632|gb|KE346360.1|	13467	13490	ACCATC	23	-	3	TGATGG
gi|514486632|gb|KE346360.1|	13493	13506	AGC	13	-	4	CTG
gi|514486632|gb|KE346360.1|	13562	13575	AGC	13	-	4	GCT
gi|514486632|gb|KE346360.1|	13576	13599	AGC	23	-	7	TGC
gi|514486632|gb|KE346360.1|	13599	13627	ACGCCG	28	-	4	GTCGGC
gi|514486632|gb|KE346360.1|	13720	13748	AGC	28	-	9	CTG
gi|514486632|gb|KE346360.1|	13961	13983	AGC	22	-	7	TGC
gi|514486632|gb|KE346360.1|	14127	14149	A	22	+	22	A
gi|514486632|gb|KE346360.1|	14197	14211	AGG	14	+	4	GGA
gi|514486632|gb|KE346360.1|	14383	14395	C	12	-	12	G
gi|514486632|gb|KE346360.1|	14516	14547	A	31	+	31	A
gi|514486632|gb|KE346360.1|	15556	15568	ACGAGC	12	-	2	TGCTCG
gi|514486632|gb|KE346360.1|	15733	15745	CG	12	+	6	CG
gi|514486632|gb|KE346360.1|	15825	15839	AG	14	+	7	AG
gi|514486632|gb|KE346360.1|	15949	15969	ACGGCG	20	+	3	GACGGC
gi|514486632|gb|KE346360.1|	16038	16053	A	15	+	15	A
gi|514486632|gb|KE346360.1|	16225	16239	AAAAAG	14	-	2	TTTTTC
gi|514486632|gb|KE346360.1|	16387	16413	AAAC	26	-	6	TGTT
gi|514486632|gb|KE346360.1|	16624	16636	AATGAC	12	-	2	GTCATT
gi|514486632|gb|KE346360.1|	16904	16919	AAAC	15	-	3	TTTG
gi|514486632|gb|KE346360.1|	16995	17007	AACCAC	12	-	2	TGGTTG
gi|514486632|gb|KE346360.1|	17062	17074	AAAAT	12	+	2	AATAA
gi|514486632|gb|KE346360.1|	17113	17126	ACAGT	13	+	2	GTACA
gi|514486632|gb|KE346360.1|	17229	17247	AGC	18	-	6	TGC
gi|514486632|gb|KE346360.1|	17932	17946	AGC	14	-	4	TGC
gi|514486632|gb|KE346360.1|	18269	18281	AACTTC	12	+	2	CAACTT
gi|514486632|gb|KE346360.1|	18388	18402	AAAAC	14	+	2	AAAAC
gi|514486632|gb|KE346360.1|	18469	18481	AAGAGC	12	-	2	TGCTCT
gi|514486632|gb|KE346360.1|	18782	18794	AGCGGC	12	-	2	GCTGCC
gi|514486632|gb|KE346360.1|	19129	19141	AGCGCC	12	-	2	TGGCGC
gi|514486632|gb|KE346360.1|	21201	21218	AAAAAC	17	+	2	AACAAA
gi|514486632|gb|KE346360.1|	21235	21254	AAAC	19	+	4	AAAC
gi|514486632|gb|KE346360.1|	21248	21261	AAAAAC	13	+	2	AACAAA
gi|514486632|gb|KE346360.1|	21380	21408	AGC	28	-	9	GCT
gi|514486632|gb|KE346360.1|	21983	22033	AC	50	+	25	CA
gi|514486632|gb|KE346360.1|	22028	22040	ACACAT	12	+	2	ACACAT
gi|514486632|gb|KE346360.1|	22400	22436	AGC	36	-	12	CTG
gi|514486632|gb|KE346360.1|	22451	22463	AACGAG	12	-	2	CGTTCT
gi|514486632|gb|KE346360.1|	23264	23278	AACAGC	14	-	2	TGCTGT
gi|514486632|gb|KE346360.1|	23650	23662	CCCG	12	-	3	GGGC
gi|514486632|gb|KE346360.1|	24196	24208	ACGAGG	12	-	2	GTCCTC
gi|514486632|gb|KE346360.1|	24622	24652	AGC	30	+	10	CAG
gi|514486632|gb|KE346360.1|	24678	24691	ACGCCG	13	+	2	GACGCC
gi|514486632|gb|KE346360.1|	24844	24857	ACG	13	+	4	ACG
gi|514486632|gb|KE346360.1|	24971	24985	AGCAGG	14	-	2	TGCTCC
gi|514486632|gb|KE346360.1|	25004	25020	AGCAGG	16	-	2	TCCTGC
gi|514486632|gb|KE346360.1|	25048	25060	ACTCGG	12	+	2	CGGACT
gi|514486632|gb|KE346360.1|	25146	25159	AAATCC	13	+	2	CAAATC
gi|514486632|gb|KE346360.1|	25421	25435	AATGTC	14	+	2	GTCAAT
gi|514486632|gb|KE346360.1|	25564	25578	ACACAG	14	+	2	CACAGA
gi|514486632|gb|KE346360.1|	25655	25670	AAAC	15	+	3	AAAC
gi|514486632|gb|KE346360.1|	25735	25748	AAAGGG	13	+	2	AAAGGG
gi|514486632|gb|KE346360.1|	25925	25937	AGGGCC	12	+	2	GGGCCA
gi|514486632|gb|KE346360.1|	26483	26495	AATGAG	12	+	2	AGAATG
gi|514486632|gb|KE346360.1|	30085	30097	ACGTAG	12	+	2	GTAGAC
gi|514486632|gb|KE346360.1|	30665	30680	AAC	15	+	5	ACA
gi|514486632|gb|KE346360.1|	30789	30803	A	14	+	14	A
gi|514486632|gb|KE346360.1|	30831	30846	A	15	+	15	A
gi|514486632|gb|KE346360.1|	31274	31287	AAAAAT	13	+	2	AATAAA
gi|514486632|gb|KE346360.1|	31283	31295	AAAAC	12	+	2	AAAAC
gi|514486632|gb|KE346360.1|	31457	31470	A	13	+	13	A
gi|514486632|gb|KE346360.1|	31503	31515	A	12	+	12	A
gi|514486632|gb|KE346360.1|	31956	31975	A	19	-	19	T
gi|514486632|gb|KE346360.1|	32161	32178	A	17	+	17	A
gi|514486632|gb|KE346360.1|	32220	32232	AACG	12	-	3	GTTC
gi|514486632|gb|KE346360.1|	32603	32618	AGCGC	15	+	3	CAGCG
gi|514486632|gb|KE346360.1|	33285	33298	AAAC	13	-	3	TTGT
gi|514486632|gb|KE346360.1|	33435	33448	AAAC	13	-	3	TTGT
gi|514486632|gb|KE346360.1|	34023	34035	AAAAAG	12	+	2	AAAAAG
gi|514486632|gb|KE346360.1|	34131	34144	A	13	+	13	A
gi|514486632|gb|KE346360.1|	34408	34421	CCCCCG	13	-	2	GCGGGG
gi|514486632|gb|KE346360.1|	34707	34726	AAAGC	19	+	3	CAAAG
gi|514486632|gb|KE346360.1|	35000	35016	CCGCG	16	-	3	CGGCG
gi|514486632|gb|KE346360.1|	36415	36427	AACGGG	12	-	2	TCCCGT
gi|514486632|gb|KE346360.1|	36580	36592	ACGAGC	12	+	2	GCACGA
gi|514486632|gb|KE346360.1|	37304	37317	ACAGTG	13	-	2	CACTGT
gi|514486632|gb|KE346360.1|	37648	37661	AATGGT	13	-	2	CCATTA
gi|514486632|gb|KE346360.1|	38547	38559	ACG	12	+	4	GAC
gi|514486632|gb|KE346360.1|	38954	38966	AAGCAC	12	-	2	TGTGCT
gi|514486632|gb|KE346360.1|	39514	39526	AACGCC	12	+	2	CGCCAA
gi|514486632|gb|KE346360.1|	39970	39985	AAG	15	-	5	TTC
gi|514486632|gb|KE346360.1|	40234	40263	ACAGGC	29	+	4	CAGGCA
gi|514486632|gb|KE346360.1|	40260	40275	AGCGCC	15	-	2	GGCGCT
gi|514486632|gb|KE346360.1|	40409	40421	ACCCAG	12	-	2	TGGGTC
gi|514486632|gb|KE346360.1|	40869	40883	ACGATG	14	+	2	GATGAC
gi|514486632|gb|KE346360.1|	42334	42353	ACG	19	+	6	ACG
gi|514486632|gb|KE346360.1|	42550	42579	AC	29	-	14	GT
gi|514486632|gb|KE346360.1|	43263	43278	A	15	-	15	T
gi|514486632|gb|KE346360.1|	43606	43656	A	50	+	50	A
gi|514486632|gb|KE346360.1|	43665	43680	AAAACG	15	-	2	TTTCGT
gi|514486632|gb|KE346360.1|	43956	43972	AAAACG	16	+	2	AAACGA
gi|514486632|gb|KE346360.1|	43967	43981	AAAAAC	14	+	2	AAAACA
gi|514486632|gb|KE346360.1|	43983	43996	AAAAAC	13	+	2	AAAACA
gi|514486632|gb|KE346360.1|	44148	44163	AAAAC	15	+	3	AAAAC
gi|514486632|gb|KE346360.1|	44949	44966	A	17	-	17	T
gi|514486632|gb|KE346360.1|	45143	45157	AGCGCG	14	-	2	CGCGCT
gi|514486632|gb|KE346360.1|	45301	45316	A	15	-	15	T
gi|514486632|gb|KE346360.1|	45396	45408	AAG	12	-	4	TTC
gi|514486632|gb|KE346360.1|	45518	45535	A	17	-	17	T
gi|514486632|gb|KE346360.1|	45611	45624	AGGCGC	13	-	2	GCCTGC
gi|514486632|gb|KE346360.1|	45751	45779	ACG	28	+	9	ACG
gi|514486632|gb|KE346360.1|	47330	47343	ACTGG	13	+	2	TGGAC
gi|514486632|gb|KE346360.1|	47337	47350	ACTGGG	13	+	2	GACTGG
gi|514486632|gb|KE346360.1|	47879	47898	AGC	19	-	6	TGC
gi|514486632|gb|KE346360.1|	48138	48183	A	45	-	45	T
gi|514486632|gb|KE346360.1|	48255	48270	AG	15	-	7	TC
gi|514486632|gb|KE346360.1|	48278	48290	AAGAG	12	-	2	CTTCT
gi|514486632|gb|KE346360.1|	48485	48499	AG	14	+	7	AG
gi|514486632|gb|KE346360.1|	48848	48863	AAAAC	15	-	3	TTTGT
gi|514486632|gb|KE346360.1|	49631	49643	AAAAC	12	-	2	TTTTG
gi|514486632|gb|KE346360.1|	50071	50084	AAAAAC	13	+	2	CAAAAA
gi|514486632|gb|KE346360.1|	50566	50581	ACCC	15	+	3	CCCA
gi|514486632|gb|KE346360.1|	51883	51896	AATC	13	+	3	ATCA
gi|514486632|gb|KE346360.1|	52112	52125	AGC	13	-	4	CTG
gi|514486632|gb|KE346360.1|	52126	52142	AGC	16	-	5	GCT
gi|514486632|gb|KE346360.1|	52291	52304	ACCGGC	13	-	2	GTGCCG
gi|514486632|gb|KE346360.1|	52299	52315	AGCCGG	16	+	2	GCCGGA
gi|514486632|gb|KE346360.1|	52612	52625	AC	13	+	6	CA
gi|514486632|gb|KE346360.1|	53604	53617	AAACTG	13	-	2	GTTTCA
gi|514486632|gb|KE346360.1|	53686	53707	AAG	21	-	7	TTC
gi|514486632|gb|KE346360.1|	53831	53843	AATCCC	12	+	2	AATCCC
gi|514486632|gb|KE346360.1|	53889	53905	ACTGCT	16	-	2	TAGCAG
gi|514486632|gb|KE346360.1|	53990	54011	ATCC	21	+	5	TCCA
gi|514486632|gb|KE346360.1|	54362	54377	A	15	-	15	T
gi|514486632|gb|KE346360.1|	54383	54397	AAG	14	-	4	TCT
gi|514486632|gb|KE346360.1|	54449	54475	AAGAG	26	+	5	GAAGA
gi|514486632|gb|KE346360.1|	54693	54705	ACAGT	12	-	2	TGTAC
gi|514486632|gb|KE346360.1|	55022	55034	ATATCG	12	+	2	TCGATA
gi|514486632|gb|KE346360.1|	55253	55266	AACAAG	13	-	2	TTCTTG
gi|514486632|gb|KE346360.1|	56030	56043	ACGAGG	13	-	2	TCCTCG
gi|514486632|gb|KE346360.1|	56263	56276	AAAAAG	13	+	2	AAGAAA
gi|514486632|gb|KE346360.1|	56305	56353	A	48	+	48	A
gi|514486632|gb|KE346360.1|	57113	57131	AAGCC	18	+	3	CAAGC
gi|514486632|gb|KE346360.1|	57175	57193	A	18	+	18	A
gi|514486632|gb|KE346360.1|	57371	57400	A	29	+	29	A
gi|514486632|gb|KE346360.1|	57476	57489	AGC	13	+	4	AGC
gi|514486632|gb|KE346360.1|	57598	57618	A	20	+	20	A
gi|514486632|gb|KE346360.1|	58507	58523	A	16	-	16	T
gi|514486632|gb|KE346360.1|	58750	58763	AG	13	-	6	TC
gi|514486632|gb|KE346360.1|	58960	58973	A	13	-	13	T
gi|514486632|gb|KE346360.1|	59219	59232	AAATC	13	-	2	TTTGA
gi|514486632|gb|KE346360.1|	59442	59464	A	22	-	22	T
gi|514486632|gb|KE346360.1|	59660	59674	A	14	-	14	T
gi|514486632|gb|KE346360.1|	60510	60522	ACGTAG	12	-	2	GTCTAC
gi|514486632|gb|KE346360.1|	61173	61185	AGGGC	12	+	2	GCAGG
gi|514486632|gb|KE346360.1|	63241	63253	ACGCC	12	-	2	GCGTG
gi|514486632|gb|KE346360.1|	64231	64244	AACAGC	13	-	2	TGTTGC
gi|514486632|gb|KE346360.1|	64514	64527	ACGCGG	13	-	2	GTCCGC
gi|514486632|gb|KE346360.1|	66200	66212	AGAGAT	12	-	2	TCTCTA
gi|514486632|gb|KE346360.1|	67812	67824	AAGTGC	12	+	2	GCAAGT
gi|514486632|gb|KE346360.1|	68281	68294	A	13	+	13	A
gi|514486632|gb|KE346360.1|	68300	68314	AAAG	14	+	3	AAAG
gi|514486632|gb|KE346360.1|	68526	68539	C	13	-	13	G
gi|514486632|gb|KE346360.1|	68592	68604	AG	12	+	6	AG
gi|514486632|gb|KE346360.1|	68606	68623	AG	17	+	8	AG
gi|514486632|gb|KE346360.1|	68682	68698	AAAAT	16	+	3	AAATA
gi|514486632|gb|KE346360.1|	68829	68841	ACAGG	12	-	2	CTGTC
gi|514486632|gb|KE346360.1|	68952	68974	ACTC	22	+	5	ACTC
gi|514486632|gb|KE346360.1|	68968	68980	ACACTC	12	+	2	ACTCAC
gi|514486632|gb|KE346360.1|	71784	71796	AAGAGG	12	+	2	GAAGAG
gi|514486632|gb|KE346360.1|	72160	72176	ACGAGG	16	+	2	GAGGAC
gi|514486632|gb|KE346360.1|	72346	72359	AAGCTG	13	+	2	GAAGCT
gi|514486632|gb|KE346360.1|	72508	72527	AGC	19	+	6	GCA
gi|514486632|gb|KE346360.1|	72626	72639	AAG	13	+	4	AAG
gi|514486632|gb|KE346360.1|	73095	73112	AGCGCG	17	+	2	GAGCGC
gi|514486632|gb|KE346360.1|	73359	73371	AGCGCG	12	+	2	CGCGAG
gi|514486632|gb|KE346360.1|	73510	73524	AATC	14	-	3	TTGA
gi|514486632|gb|KE346360.1|	73558	73579	A	21	-	21	T
gi|514486632|gb|KE346360.1|	73661	73684	AGC	23	-	7	CTG
gi|514486632|gb|KE346360.1|	74080	74092	AATCGT	12	-	2	TTACGA
gi|514486632|gb|KE346360.1|	74254	74268	AAAAG	14	-	2	TTTTC
gi|514486632|gb|KE346360.1|	74332	74347	AAGTG	15	+	3	TGAAG
gi|514486632|gb|KE346360.1|	74489	74505	AAGGGG	16	-	2	CTTCCC
gi|514486632|gb|KE346360.1|	74506	74519	AAGGGG	13	-	2	CTTCCC
gi|514486632|gb|KE346360.1|	74594	74607	AAG	13	-	4	TTC
gi|514486632|gb|KE346360.1|	74608	74621	AAG	13	-	4	CTT
gi|514486632|gb|KE346360.1|	74635	74647	AAG	12	-	4	TTC
gi|514486632|gb|KE346360.1|	74650	74729	AAG	79	-	26	TTC
gi|514486632|gb|KE346360.1|	74734	74746	AACAGC	12	-	2	TGTTGC
gi|514486632|gb|KE346360.1|	74803	74817	AAC	14	-	4	TGT
gi|514486632|gb|KE346360.1|	74812	74824	AACAGC	12	-	2	TGTTGC
gi|514486632|gb|KE346360.1|	74885	74898	AGCCCC	13	-	2	GGGCTG
gi|514486632|gb|KE346360.1|	74960	74973	AGCCCC	13	-	2	GGGCTG
gi|514486632|gb|KE346360.1|	75841	75854	AAAAAC	13	+	2	AACAAA
gi|514486632|gb|KE346360.1|	76002	76018	A	16	-	16	T
gi|514486632|gb|KE346360.1|	77887	77899	ACGATG	12	+	2	CGATGA
gi|514486632|gb|KE346360.1|	77906	77922	ATC	16	-	5	GAT
gi|514486632|gb|KE346360.1|	78228	78241	AACGAC	13	-	2	GTCGTT
gi|514486632|gb|KE346360.1|	78552	78564	AGCCCC	12	-	2	TGGGGC
gi|514486632|gb|KE346360.1|	78585	78598	AATGGC	13	+	2	GCAATG
gi|514486632|gb|KE346360.1|	78612	78624	ACTCGG	12	+	2	GGACTC
gi|514486632|gb|KE346360.1|	78893	78906	AG	13	+	6	GA
gi|514486632|gb|KE346360.1|	79572	79591	AAG	19	+	6	AAG
gi|514486632|gb|KE346360.1|	79685	79697	A	12	-	12	T
gi|514486632|gb|KE346360.1|	80119	80131	AAGGCC	12	-	2	GGCCTT
gi|514486632|gb|KE346360.1|	80147	80159	AGGCCG	12	-	2	GCCTCG
gi|514486632|gb|KE346360.1|	80248	80260	AGGCCG	12	-	2	CTCGGC
gi|514486632|gb|KE346360.1|	80284	80296	AAGGAG	12	-	2	CTCCTT
gi|514486632|gb|KE346360.1|	80833	80847	ACTGCG	14	+	2	CTGCGA
gi|514486632|gb|KE346360.1|	81022	81034	ACCCAG	12	+	2	CCAGAC
gi|514486632|gb|KE346360.1|	81120	81132	AAAAAC	12	-	2	TTGTTT
gi|514486632|gb|KE346360.1|	81127	81140	AAACAC	13	-	2	TGTTTG
gi|514486632|gb|KE346360.1|	81232	81246	A	14	+	14	A
gi|514486632|gb|KE346360.1|	81286	81308	AAAACC	22	-	3	TTTTGG
gi|514486632|gb|KE346360.1|	81499	81512	A	13	+	13	A
gi|514486632|gb|KE346360.1|	81509	81524	AAAT	15	+	3	AAAT
gi|514486632|gb|KE346360.1|	81560	81574	AATG	14	-	3	CATT
gi|514486632|gb|KE346360.1|	81895	81907	AAATGC	12	+	2	TGCAAA
gi|514486632|gb|KE346360.1|	81919	81936	A	17	+	17	A
gi|514486632|gb|KE346360.1|	82043	82058	A	15	+	15	A
gi|514486632|gb|KE346360.1|	83620	83632	AGC	12	+	4	GCA
gi|514486632|gb|KE346360.1|	85138	85150	AATTC	12	-	2	ATTGA
gi|514486632|gb|KE346360.1|	85709	85722	ACTCTC	13	+	2	CTCTCA
gi|514486632|gb|KE346360.1|	86019	86032	AAAC	13	+	3	AAAC
gi|514486632|gb|KE346360.1|	87612	87624	ACGGGC	12	-	2	TGCCCG
gi|514486632|gb|KE346360.1|	89546	89567	ACGCCG	21	+	3	ACGCCG
gi|514486632|gb|KE346360.1|	90022	90034	AATGGG	12	-	2	CATTCC
gi|514486632|gb|KE346360.1|	90329	90359	AGC	30	+	10	AGC
gi|514486632|gb|KE346360.1|	93354	93366	AAACTC	12	-	2	TTTGAG
gi|514486632|gb|KE346360.1|	93654	93666	ACAG	12	+	3	ACAG
gi|514486632|gb|KE346360.1|	93772	93803	ATC	31	-	10	TGA
gi|514486632|gb|KE346360.1|	93829	93848	ACTC	19	-	4	GAGT
gi|514486632|gb|KE346360.1|	94189	94201	AGGCGC	12	-	2	GCCTGC
gi|514486632|gb|KE346360.1|	94536	94548	AGG	12	-	4	CTC
gi|514486632|gb|KE346360.1|	94589	94603	AAGCTC	14	+	2	TCAAGC
gi|514486632|gb|KE346360.1|	94687	94701	AACGCG	14	+	2	CGAACG
gi|514486632|gb|KE346360.1|	94892	94910	ACC	18	+	6	CAC
gi|514486632|gb|KE346360.1|	95335	95349	AGAGGG	14	-	2	CTCTCC
gi|514486632|gb|KE346360.1|	95790	95803	AAGACC	13	-	2	GGTCTT
gi|514486632|gb|KE346360.1|	96096	96122	AGC	26	-	8	CTG
gi|514486632|gb|KE346360.1|	96720	96733	ACCACG	13	+	2	CCACGA
gi|514486632|gb|KE346360.1|	98929	98941	ACTCCC	12	+	2	TCCCAC
gi|514486632|gb|KE346360.1|	98937	98962	ACC	25	+	8	CCA
gi|514486632|gb|KE346360.1|	99130	99144	AGCGCG	14	+	2	GCGAGC
gi|514486632|gb|KE346360.1|	99965	99977	AGC	12	-	4	GCT
gi|514486632|gb|KE346360.1|	99979	99997	AGG	18	-	6	TCC
gi|514486632|gb|KE346360.1|	100457	100476	AGC	19	+	6	AGC
gi|514486632|gb|KE346360.1|	100959	100971	ACTGCG	12	-	2	CAGTCG
gi|514486632|gb|KE346360.1|	101189	101202	AAAATG	13	-	2	TTTCAT
gi|514486632|gb|KE346360.1|	101511	101523	AAGCAG	12	+	2	AAGCAG
gi|514486632|gb|KE346360.1|	101555	101578	ACTGCC	23	+	3	CTGCCA
gi|514486632|gb|KE346360.1|	101691	101703	AATGGC	12	-	2	TTGCCA
gi|514486632|gb|KE346360.1|	104114	104128	ACAGT	14	+	2	AGTAC
gi|514486632|gb|KE346360.1|	104421	104433	AAAACC	12	+	2	CAAAAC
gi|514486632|gb|KE346360.1|	104557	104570	AAAC	13	-	3	TTGT
gi|514486632|gb|KE346360.1|	104575	104588	AAAC	13	-	3	TTGT
gi|514486632|gb|KE346360.1|	104708	104721	AAACAC	13	-	2	TGTTTG
gi|514486632|gb|KE346360.1|	104766	104783	AAAAAT	17	-	2	TTTTTA
gi|514486632|gb|KE346360.1|	104783	104803	AAT	20	-	6	TTA
gi|514486632|gb|KE346360.1|	104840	104858	A	18	-	18	T
gi|514486632|gb|KE346360.1|	104860	104872	AAAAG	12	-	2	TTTTC
gi|514486632|gb|KE346360.1|	105096	105109	AAC	13	+	4	CAA
gi|514486632|gb|KE346360.1|	105224	105239	ACC	15	+	5	CAC
gi|514486632|gb|KE346360.1|	105234	105251	AACCAC	17	+	2	ACCACA
gi|514486632|gb|KE346360.1|	105246	105258	ACC	12	+	4	ACC
gi|514486632|gb|KE346360.1|	105319	105347	ACG	28	-	9	CGT
gi|514486632|gb|KE346360.1|	105461	105474	AGC	13	+	4	CAG
gi|514486632|gb|KE346360.1|	105479	105491	AGCGGC	12	+	2	CGGCAG
gi|514486632|gb|KE346360.1|	105486	105507	ACTGCC	21	-	3	GGCAGT
gi|514486632|gb|KE346360.1|	105567	105582	ATCGCC	15	+	2	CCATCG
gi|514486632|gb|KE346360.1|	105669	105689	AGC	20	-	6	GCT
gi|514486632|gb|KE346360.1|	105760	105775	ACG	15	-	5	CGT
gi|514486632|gb|KE346360.1|	105795	105809	ACGGGG	14	-	2	CCGTCC
gi|514486632|gb|KE346360.1|	105923	105936	ACTCTC	13	-	2	GAGTGA
gi|514486632|gb|KE346360.1|	105930	105956	ACTC	26	-	6	AGTG
gi|514486632|gb|KE346360.1|	105986	105998	A	12	-	12	T
gi|514486632|gb|KE346360.1|	106010	106026	A	16	-	16	T
gi|514486632|gb|KE346360.1|	106036	106053	AAAAAG	17	-	2	TTTTTC
gi|514486632|gb|KE346360.1|	106057	106074	AG	17	-	8	TC
gi|514486632|gb|KE346360.1|	106295	106319	AAG	24	-	8	CTT
gi|514486632|gb|KE346360.1|	106410	106422	AAAAC	12	+	2	AAAAC
gi|514486632|gb|KE346360.1|	106649	106668	AAATGC	19	+	3	AATGCA
gi|514486632|gb|KE346360.1|	106708	106727	AACATC	19	-	3	TTGATG
gi|514486632|gb|KE346360.1|	106777	106791	AACAGC	14	+	2	CAACAG
gi|514486632|gb|KE346360.1|	106789	106803	AACAGC	14	+	2	CAGCAA
gi|514486632|gb|KE346360.1|	107000	107015	ACCTGG	15	-	2	CAGGTC
gi|514486632|gb|KE346360.1|	107010	107023	AGCTCC	13	+	2	TCCAGC
gi|514486632|gb|KE346360.1|	107047	107061	AACAGC	14	+	2	GCAACA
gi|514486632|gb|KE346360.1|	107986	108001	AAGAGG	15	-	2	CTTCCT
gi|514486632|gb|KE346360.1|	108799	108813	AAC	14	+	4	CAA
gi|514486632|gb|KE346360.1|	108822	108834	AACAGC	12	+	2	ACAGCA
gi|514486632|gb|KE346360.1|	108853	108867	AAC	14	+	4	CAA
gi|514486632|gb|KE346360.1|	108865	108879	AGC	14	+	4	CAG
gi|514486632|gb|KE346360.1|	108886	108898	AACACC	12	+	2	CAACAC
gi|514486632|gb|KE346360.1|	109484	109496	AAAACC	12	-	2	GGTTTT
gi|514486632|gb|KE346360.1|	112836	112848	AGGGGG	12	-	2	CCCTCC
gi|514486632|gb|KE346360.1|	113098	113112	A	14	-	14	T
gi|514486632|gb|KE346360.1|	113117	113130	A	13	-	13	T
gi|514486632|gb|KE346360.1|	113276	113288	A	12	+	12	A
gi|514486632|gb|KE346360.1|	113650	113667	AAGCAG	17	-	2	CTGCTT
gi|514486632|gb|KE346360.1|	114392	114411	AACAGC	19	-	3	TGTTGC
gi|514486632|gb|KE346360.1|	114941	114953	AATCAC	12	-	2	TGATTG
gi|514486632|gb|KE346360.1|	115087	115100	ACGGCG	13	+	2	GGCGAC
gi|514486632|gb|KE346360.1|	115154	115166	AAAAAC	12	-	2	GTTTTT
gi|514486632|gb|KE346360.1|	115811	115824	AGCGG	13	-	2	CTCCG
gi|514486632|gb|KE346360.1|	115831	115843	C	12	+	12	C
gi|514486632|gb|KE346360.1|	116102	116117	AGCCCG	15	-	2	TCGGGC
gi|514486632|gb|KE346360.1|	116126	116138	AGCAGG	12	-	2	CCTGCT
gi|514486632|gb|KE346360.1|	116572	116587	AGCGGC	15	-	2	TGCCGC
gi|514486632|gb|KE346360.1|	116691	116704	AAGAC	13	-	2	TTGTC
gi|514486632|gb|KE346360.1|	117251	117276	ACTC	25	+	6	TCAC
gi|514486632|gb|KE346360.1|	118965	118979	AAC	14	-	4	GTT
gi|514486632|gb|KE346360.1|	119938	119950	ACGAGG	12	-	2	TCGTCC
gi|514486632|gb|KE346360.1|	120617	120637	AACCAC	20	+	3	ACAACC
gi|514486632|gb|KE346360.1|	120687	120699	AACCGC	12	+	2	CAACCG
gi|514486632|gb|KE346360.1|	120767	120779	AGC	12	+	4	GCA
gi|514486632|gb|KE346360.1|	121235	121248	AGCCGC	13	-	2	CGGCTG
gi|514486632|gb|KE346360.1|	121255	121275	AACAGC	20	+	3	CAACAG
gi|514486632|gb|KE346360.1|	121270	121287	ACCAGC	17	+	2	CAGCAC
gi|514486632|gb|KE346360.1|	121282	121297	AACAGC	15	+	2	CAGCAA
gi|514486632|gb|KE346360.1|	121402	121415	AGC	13	-	4	GCT
gi|514486632|gb|KE346360.1|	122061	122073	AAACC	12	+	2	AAACC
gi|514486632|gb|KE346360.1|	123518	123530	ACAGTC	12	+	2	GTCACA
gi|514486632|gb|KE346360.1|	123680	123692	A	12	+	12	A
gi|514486632|gb|KE346360.1|	123701	123713	ACATGG	12	+	2	ACATGG
gi|514486632|gb|KE346360.1|	124108	124120	A	12	+	12	A
gi|514486632|gb|KE346360.1|	125948	125961	AGCC	13	-	3	TGGC
gi|514486632|gb|KE346360.1|	126281	126294	ATCGC	13	-	2	TGCGA
gi|514486632|gb|KE346360.1|	126663	126675	ACCTCG	12	-	2	CGAGGT
gi|514486632|gb|KE346360.1|	126927	126939	AATGTC	12	+	2	AATGTC
gi|514486632|gb|KE346360.1|	127907	127919	ACGAGC	12	+	2	AGCACG
gi|514486632|gb|KE346360.1|	129479	129491	AACATG	12	+	2	AACATG
gi|514486632|gb|KE346360.1|	130510	130525	ACTCC	15	+	3	CACTC
gi|514486632|gb|KE346360.1|	131665	131679	AAGACG	14	+	2	ACGAAG
gi|514486632|gb|KE346360.1|	132680	132692	AATCG	12	+	2	CGAAT
gi|514486632|gb|KE346360.1|	136139	136153	A	14	+	14	A
gi|514486632|gb|KE346360.1|	136603	136615	AAACCC	12	+	2	CAAACC
gi|514486632|gb|KE346360.1|	137107	137120	AAGTCC	13	-	2	GACTTG
gi|514486632|gb|KE346360.1|	138870	138884	AAAAAT	14	+	2	AAAAAT
gi|514486632|gb|KE346360.1|	138890	138902	AAAAT	12	+	2	AATAA
gi|514486632|gb|KE346360.1|	139057	139069	AAACGC	12	+	2	CAAACG
gi|514486632|gb|KE346360.1|	139256	139280	A	24	+	24	A
gi|514486632|gb|KE346360.1|	139336	139349	ACTGC	13	-	2	GCAGT
gi|514486632|gb|KE346360.1|	140034	140052	A	18	+	18	A
gi|514486632|gb|KE346360.1|	140624	140644	AAC	20	+	6	AAC
gi|514486632|gb|KE346360.1|	140736	140748	AAAAAC	12	+	2	CAAAAA
gi|514486632|gb|KE346360.1|	142237	142249	AAG	12	-	4	CTT
gi|514486632|gb|KE346360.1|	142261	142273	AAG	12	-	4	CTT
gi|514486632|gb|KE346360.1|	142871	142883	CCG	12	-	4	GGC
gi|514486632|gb|KE346360.1|	142903	142915	AGGCGG	12	+	2	AGGCGG
gi|514486632|gb|KE346360.1|	143050	143068	ACCAGC	18	-	3	TGGTGC
gi|514486632|gb|KE346360.1|	143063	143077	ACCGGC	14	-	2	GGTGCC
gi|514486632|gb|KE346360.1|	143423	143437	AGCCGC	14	+	2	GCAGCC
gi|514486632|gb|KE346360.1|	143447	143460	AGC	13	+	4	GCA
gi|514486632|gb|KE346360.1|	143470	143484	ACT	14	-	4	AGT
gi|514486632|gb|KE346360.1|	143867	143879	ACG	12	-	4	TCG
gi|514486632|gb|KE346360.1|	144050	144064	CCG	14	+	4	GCC
gi|514486632|gb|KE346360.1|	144525	144541	AG	16	-	8	CT
gi|514486632|gb|KE346360.1|	144578	144606	AAG	28	-	9	CTT
gi|514486632|gb|KE346360.1|	144608	144620	AACAC	12	-	2	GTTGT
gi|514486632|gb|KE346360.1|	144666	144678	AAACAC	12	+	2	AACACA
gi|514486632|gb|KE346360.1|	144694	144718	A	24	-	24	T
gi|514486632|gb|KE346360.1|	145032	145047	A	15	+	15	A
gi|514486632|gb|KE346360.1|	145048	145061	A	13	+	13	A
gi|514486632|gb|KE346360.1|	145271	145293	A	22	-	22	T
gi|514486632|gb|KE346360.1|	145443	145460	AAAAAT	17	+	2	AAAAAT
gi|514486632|gb|KE346360.1|	145482	145502	A	20	+	20	A
gi|514486632|gb|KE346360.1|	146461	146479	AG	18	+	9	AG
gi|514486632|gb|KE346360.1|	146690	146703	AAAATC	13	-	2	TTTTGA
gi|514486632|gb|KE346360.1|	146709	146727	A	18	-	18	T
gi|514486632|gb|KE346360.1|	146776	146788	AG	12	+	6	AG
gi|514486632|gb|KE346360.1|	148116	148133	AAAAAC	17	+	2	AACAAA
gi|514486632|gb|KE346360.1|	148640	148653	ACACC	13	-	2	GTGTG
gi|514486632|gb|KE346360.1|	149056	149070	C	14	-	14	G
gi|514486632|gb|KE346360.1|	149945	149957	AATATG	12	-	2	TATTCA
gi|514486632|gb|KE346360.1|	150515	150533	AAAAAC	18	+	3	AAAAAC
gi|514486632|gb|KE346360.1|	150530	150549	AACC	19	+	4	AACC
gi|514486632|gb|KE346360.1|	151048	151068	ATC	20	+	6	TCA
gi|514486632|gb|KE346360.1|	151327	151339	ATCGGC	12	+	2	GCATCG
gi|514486632|gb|KE346360.1|	153063	153076	AAGATG	13	+	2	GATGAA
gi|514486632|gb|KE346360.1|	153264	153277	AAAAGG	13	+	2	AGGAAA
gi|514486632|gb|KE346360.1|	153311	153325	AAACC	14	+	2	AAACC
gi|514486632|gb|KE346360.1|	153415	153427	ACGAGG	12	+	2	AGGACG
gi|514486632|gb|KE346360.1|	153443	153455	ACCCGG	12	+	2	CCGGAC
gi|514486632|gb|KE346360.1|	154066	154078	AG	12	+	6	GA
gi|514486632|gb|KE346360.1|	154780	154792	ACC	12	+	4	CCA
gi|514486632|gb|KE346360.1|	154790	154805	AGC	15	+	5	CAG
gi|514486632|gb|KE346360.1|	154869	154890	ACC	21	-	7	GTG
gi|514486632|gb|KE346360.1|	155014	155028	ACTC	14	-	3	AGTG
gi|514486632|gb|KE346360.1|	155261	155274	AAATCC	13	-	2	GATTTG
gi|514486632|gb|KE346360.1|	156347	156359	AACGG	12	-	2	CCGTT
gi|514486632|gb|KE346360.1|	156894	156913	AGCG	19	-	4	GCTC
gi|514486632|gb|KE346360.1|	156965	156977	AAAAT	12	-	2	TTATT
gi|514486632|gb|KE346360.1|	157548	157566	A	18	+	18	A
gi|514486632|gb|KE346360.1|	157924	157944	AG	20	+	10	AG
gi|514486632|gb|KE346360.1|	158017	158032	AAAAAC	15	+	2	AAAAAC
gi|514486632|gb|KE346360.1|	158116	158129	ACCCCC	13	-	2	GTGGGG
gi|514486632|gb|KE346360.1|	158221	158233	AAAAAC	12	-	2	TTTTTG
gi|514486632|gb|KE346360.1|	158323	158336	AAAAC	13	-	2	TGTTT
gi|514486632|gb|KE346360.1|	160091	160104	AGCGCG	13	+	2	CGCGAG
gi|514486632|gb|KE346360.1|	163936	163948	AGAGCC	12	-	2	GCTCTG
gi|514486632|gb|KE346360.1|	166840	166852	AGAGCC	12	-	2	GCTCTG
gi|514486632|gb|KE346360.1|	170377	170389	AGAGCC	12	-	2	GCTCTG
gi|514486632|gb|KE346360.1|	174049	174061	AGAGCC	12	-	2	GCTCTG
gi|514486632|gb|KE346360.1|	180711	180728	AACATC	17	-	2	ATGTTG
gi|514486632|gb|KE346360.1|	181044	181061	AGCCCC	17	-	2	CTGGGG
gi|514486632|gb|KE346360.1|	181062	181091	AGCCCC	29	-	4	CTGGGG
gi|514486632|gb|KE346360.1|	181385	181402	ACGAGG	17	+	2	GACGAG
gi|514486632|gb|KE346360.1|	181418	181430	ACG	12	+	4	GAC
gi|514486632|gb|KE346360.1|	183165	183177	AC	12	-	6	GT
gi|514486632|gb|KE346360.1|	183266	183293	A	27	-	27	T
gi|514486632|gb|KE346360.1|	183700	183712	AGAGC	12	-	2	TCTGC
gi|514486632|gb|KE346360.1|	183968	183986	AACCGC	18	+	3	GCAACC
gi|514486632|gb|KE346360.1|	184000	184012	ACAGCC	12	+	2	CACAGC
gi|514486632|gb|KE346360.1|	184167	184179	ACCAGC	12	+	2	CAGCAC
gi|514486632|gb|KE346360.1|	185838	185851	AAAC	13	+	3	CAAA
gi|514486632|gb|KE346360.1|	187195	187212	AAG	17	+	5	GAA
gi|514486632|gb|KE346360.1|	189240	189252	AAAAAG	12	+	2	GAAAAA
gi|514486632|gb|KE346360.1|	189353	189380	A	27	-	27	T
gi|514486632|gb|KE346360.1|	189453	189465	AAACCG	12	+	2	ACCGAA
gi|514486632|gb|KE346360.1|	189791	189804	AGCCCC	13	+	2	GCCCCA
gi|514486632|gb|KE346360.1|	189911	189942	A	31	+	31	A
gi|514486632|gb|KE346360.1|	189999	190013	A	14	+	14	A
gi|514486632|gb|KE346360.1|	190768	190780	AAAAC	12	+	2	AACAA
gi|514486632|gb|KE346360.1|	190805	190817	AACCAC	12	+	2	ACCACA
gi|514486632|gb|KE346360.1|	191183	191196	ACG	13	-	4	CGT
gi|514486632|gb|KE346360.1|	191454	191466	ACCGCC	12	-	2	GGCGGT
gi|514486632|gb|KE346360.1|	191671	191683	AAAC	12	+	3	AAAC
gi|514486632|gb|KE346360.1|	191992	192007	AAAC	15	+	3	AAAC
gi|514486632|gb|KE346360.1|	192496	192509	AACGCC	13	+	2	CCAACG
gi|514486632|gb|KE346360.1|	192528	192540	CCCG	12	+	3	CCGC
gi|514486632|gb|KE346360.1|	193788	193800	AGCGCC	12	+	2	CGCCAG
gi|514486632|gb|KE346360.1|	193799	193818	ACG	19	+	6	GAC
gi|514486632|gb|KE346360.1|	195414	195429	A	15	+	15	A
gi|514486632|gb|KE346360.1|	195433	195453	A	20	+	20	A
gi|514486632|gb|KE346360.1|	195474	195486	AAAAC	12	-	2	TTTGT
gi|514486632|gb|KE346360.1|	195547	195565	AG	18	-	9	TC
gi|514486632|gb|KE346360.1|	195931	195946	ACG	15	+	5	CGA
gi|514486632|gb|KE346360.1|	196050	196062	ACTCTG	12	-	2	CAGAGT
gi|514486632|gb|KE346360.1|	196066	196084	ACTCTC	18	-	3	AGAGTG
gi|514486632|gb|KE346360.1|	196118	196138	ACCAGC	20	-	3	GCTGGT
gi|514486632|gb|KE346360.1|	196144	196158	ACAGCG	14	-	2	CGCTGT
gi|514486632|gb|KE346360.1|	196200	196212	AATGC	12	-	2	GCATT
gi|514486632|gb|KE346360.1|	196253	196276	ATC	23	+	7	TCA
gi|514486632|gb|KE346360.1|	196313	196330	AGCATC	17	-	2	TGCTGA
gi|514486632|gb|KE346360.1|	196345	196357	AATAGC	12	-	2	ATTGCT
gi|514486632|gb|KE346360.1|	196389	196401	AACGCC	12	-	2	TGGCGT
gi|514486632|gb|KE346360.1|	196450	196483	ATC	33	+	11	ATC
gi|514486632|gb|KE346360.1|	196603	196618	AACGAC	15	+	2	AACGAC
gi|514486632|gb|KE346360.1|	196679	196691	AAACG	12	+	2	AACGA
gi|514486632|gb|KE346360.1|	196971	196985	ATC	14	+	4	CAT
gi|514486632|gb|KE346360.1|	197603	197621	AACAGC	18	+	3	CAACAG
gi|514486632|gb|KE346360.1|	197871	197899	ACG	28	+	9	ACG
gi|514486632|gb|KE346360.1|	199207	199219	AGGCGC	12	+	2	GCAGGC
gi|514486632|gb|KE346360.1|	199308	199336	A	28	-	28	T
gi|514486632|gb|KE346360.1|	200742	200757	AAGC	15	-	3	TGCT
gi|514486632|gb|KE346360.1|	201704	201717	AAC	13	-	4	GTT
gi|514486632|gb|KE346360.1|	201724	201737	ACACTC	13	+	2	CTCACA
gi|514486632|gb|KE346360.1|	201742	201759	AG	17	-	8	CT
gi|514486632|gb|KE346360.1|	203220	203235	AGAGGG	15	+	2	AGAGGG
gi|514486632|gb|KE346360.1|	203803	203815	ACCGTC	12	-	2	GACGGT
gi|514486632|gb|KE346360.1|	204152	204165	AACGAC	13	+	2	ACGACA
gi|514486632|gb|KE346360.1|	204378	204390	AAACTC	12	+	2	TCAAAC
gi|514486632|gb|KE346360.1|	204412	204426	AAGC	14	+	3	AAGC
gi|514486632|gb|KE346360.1|	204453	204470	ACTG	17	-	4	TCAG
gi|514486632|gb|KE346360.1|	204601	204614	ACACAG	13	+	2	ACACAG
gi|514486632|gb|KE346360.1|	204649	204670	CCG	21	-	7	GGC
gi|514486632|gb|KE346360.1|	204850	204862	ACATC	12	-	2	TGATG
gi|514486632|gb|KE346360.1|	204861	204873	ACTC	12	-	3	GTGA
gi|514486632|gb|KE346360.1|	205600	205613	AGAGG	13	-	2	TCCTC
gi|514486632|gb|KE346360.1|	205857	205870	AG	13	-	6	TC
gi|514486632|gb|KE346360.1|	205897	205911	AACGC	14	+	2	CGCAA
gi|514486632|gb|KE346360.1|	205954	205970	A	16	-	16	T
gi|514486632|gb|KE346360.1|	205972	205987	A	15	-	15	T
gi|514486632|gb|KE346360.1|	205988	206000	AAAAG	12	-	2	TTCTT
gi|514486632|gb|KE346360.1|	206051	206070	ACGCTG	19	+	3	CGCTGA
gi|514486632|gb|KE346360.1|	206195	206211	A	16	-	16	T
gi|514486632|gb|KE346360.1|	206268	206283	AACAC	15	-	3	GTTGT
gi|514486632|gb|KE346360.1|	206499	206513	AG	14	+	7	GA
gi|514486632|gb|KE346360.1|	206727	206739	AACAGC	12	-	2	CTGTTG
gi|514486632|gb|KE346360.1|	207152	207164	A	12	-	12	T
gi|514486632|gb|KE346360.1|	208476	208489	A	13	+	13	A
gi|514486632|gb|KE346360.1|	208491	208506	A	15	+	15	A
gi|514486632|gb|KE346360.1|	209056	209080	A	24	+	24	A
gi|514486632|gb|KE346360.1|	209256	209269	AAAAAC	13	-	2	GTTTTT
gi|514486632|gb|KE346360.1|	209278	209290	AGAGGG	12	-	2	TCTCCC
gi|514486632|gb|KE346360.1|	209297	209309	AC	12	+	6	AC
gi|514486632|gb|KE346360.1|	209336	209349	AAGATG	13	-	2	TCATCT
gi|514486632|gb|KE346360.1|	210510	210527	A	17	-	17	T
gi|514486632|gb|KE346360.1|	210523	210537	AAAAC	14	-	2	TTTTG
gi|514486632|gb|KE346360.1|	210533	210547	A	14	-	14	T
gi|514486632|gb|KE346360.1|	211846	211858	ACAGCG	12	+	2	CAGCGA
gi|514486632|gb|KE346360.1|	211855	211870	ACGAGG	15	+	2	CGAGGA
gi|514486632|gb|KE346360.1|	211892	211904	AACTC	12	+	2	ACTCA
gi|514486632|gb|KE346360.1|	212010	212024	AGCATC	14	+	2	CAGCAT
gi|514486632|gb|KE346360.1|	212028	212045	ATC	17	+	5	CAT
gi|514486632|gb|KE346360.1|	212043	212056	AACAGC	13	+	2	CAACAG
gi|514486632|gb|KE346360.1|	212765	212778	AATGGG	13	-	2	CCCATT
gi|514486632|gb|KE346360.1|	213127	213142	AGC	15	-	5	TGC
gi|514486632|gb|KE346360.1|	213302	213319	AGCGGC	17	-	2	GCCGCT
gi|514486632|gb|KE346360.1|	213907	213919	AAAAAG	12	-	2	TTTTTC
gi|514486632|gb|KE346360.1|	215561	215582	ACGC	21	+	5	CGCA
gi|514486632|gb|KE346360.1|	216175	216189	A	14	-	14	T
gi|514486632|gb|KE346360.1|	216193	216205	AAAAAG	12	-	2	TTCTTT
gi|514486632|gb|KE346360.1|	216252	216264	AAAAG	12	-	2	TTCTT
gi|514486632|gb|KE346360.1|	216280	216294	AAG	14	-	4	CTT
gi|514486632|gb|KE346360.1|	216354	216366	ACTC	12	+	3	CACT
gi|514486632|gb|KE346360.1|	216439	216452	AAAAAG	13	-	2	TTTTCT
gi|514486632|gb|KE346360.1|	217379	217412	ACT	33	+	11	ACT
gi|514486632|gb|KE346360.1|	217410	217423	AGC	13	-	4	CTG
gi|514486632|gb|KE346360.1|	218150	218164	ACG	14	-	4	TCG
gi|514486632|gb|KE346360.1|	218321	218333	ACGGAG	12	-	2	CCGTCT
gi|514486632|gb|KE346360.1|	218382	218394	ATC	12	+	4	TCA
gi|514486632|gb|KE346360.1|	218810	218822	AAAAG	12	-	2	TTTCT
gi|514486632|gb|KE346360.1|	219007	219025	ACAGAG	18	-	3	TCTCTG
gi|514486632|gb|KE346360.1|	219401	219414	AAAC	13	+	3	AACA
gi|514486632|gb|KE346360.1|	219594	219607	A	13	-	13	T
gi|514486632|gb|KE346360.1|	219760	219774	A	14	-	14	T
gi|514486632|gb|KE346360.1|	219863	219876	AG	13	+	6	GA
gi|514486632|gb|KE346360.1|	220392	220404	AAAAAC	12	-	2	GTTTTT
gi|514486632|gb|KE346360.1|	221015	221035	A	20	-	20	T
gi|514486632|gb|KE346360.1|	221075	221100	AG	25	-	12	CT
gi|514486632|gb|KE346360.1|	221185	221202	AAGG	17	+	4	GGAA
gi|514486632|gb|KE346360.1|	221260	221276	AG	16	-	8	CT
gi|514486632|gb|KE346360.1|	222649	222661	CCG	12	+	4	GCC
gi|514486632|gb|KE346360.1|	222965	222977	ACGACT	12	+	2	ACTACG
gi|514486632|gb|KE346360.1|	223907	223932	ATC	25	-	8	TGA
gi|514486632|gb|KE346360.1|	224309	224324	AG	15	+	7	AG
gi|514486632|gb|KE346360.1|	225599	225611	AAAAC	12	-	2	TTGTT
gi|514486632|gb|KE346360.1|	226107	226119	AACTTC	12	+	2	TTCAAC
gi|514486632|gb|KE346360.1|	226997	227016	AGCGCC	19	+	3	CAGCGC
gi|514486632|gb|KE346360.1|	227417	227429	AGCGGC	12	+	2	GGCAGC
gi|514486632|gb|KE346360.1|	228732	228744	ACG	12	-	4	GTC
gi|514486632|gb|KE346360.1|	229824	229836	AGAGGC	12	-	2	CTGCCT
gi|514486632|gb|KE346360.1|	229964	229978	AAAAAT	14	+	2	AATAAA
gi|514486632|gb|KE346360.1|	229975	230008	AAAAT	33	+	6	AAAAT
gi|514486632|gb|KE346360.1|	230021	230035	AAAAT	14	+	2	AAAAT
gi|514486632|gb|KE346360.1|	230231	230243	ATCC	12	-	3	ATGG
gi|514486632|gb|KE346360.1|	230350	230362	AACAC	12	+	2	AACAC
gi|514486632|gb|KE346360.1|	230422	230439	AAAAAT	17	+	2	AAAAAT
gi|514486632|gb|KE346360.1|	230435	230452	AAAAAT	17	+	2	AAAAAT
gi|514486632|gb|KE346360.1|	230488	230501	AAAAT	13	+	2	AAAAT
gi|514486632|gb|KE346360.1|	230643	230655	AAGCG	12	+	2	GAAGC
gi|514486632|gb|KE346360.1|	230698	230723	A	25	+	25	A
gi|514486632|gb|KE346360.1|	230790	230802	AGCGC	12	+	2	CGCAG
gi|514486632|gb|KE346360.1|	230849	230864	ACTCTC	15	-	2	GAGTGA
gi|514486632|gb|KE346360.1|	231076	231089	AAG	13	+	4	AAG
gi|514486632|gb|KE346360.1|	231742	231754	AAAACC	12	+	2	CAAAAC
gi|514486632|gb|KE346360.1|	232712	232724	AAC	12	+	4	ACA
gi|514486632|gb|KE346360.1|	234536	234642	AC	106	+	53	AC
gi|514486632|gb|KE346360.1|	235105	235123	AGC	18	-	6	GCT
gi|514486632|gb|KE346360.1|	235506	235518	AAAC	12	-	3	TTTG
gi|514486632|gb|KE346360.1|	235519	235533	AAAC	14	-	3	TTGT
gi|514486632|gb|KE346360.1|	235706	235724	AACGCC	18	+	3	CGCCAA
gi|514486632|gb|KE346360.1|	237043	237057	AC	14	+	7	CA
gi|514486632|gb|KE346360.1|	237205	237217	AGGATG	12	-	2	CATCCT
gi|514486632|gb|KE346360.1|	237390	237408	ATC	18	+	6	TCA
gi|514486632|gb|KE346360.1|	237483	237495	AAAAT	12	-	2	TTATT
gi|514486632|gb|KE346360.1|	237642	237659	AC	17	-	8	GT
gi|514486632|gb|KE346360.1|	237724	237741	ACTCCC	17	+	2	CACTCC
gi|514486632|gb|KE346360.1|	237846	237868	A	22	+	22	A
gi|514486632|gb|KE346360.1|	237993	238010	AGGGGG	17	+	2	GGGGAG
gi|514486632|gb|KE346360.1|	238226	238238	AAGACC	12	+	2	CCAAGA
gi|514486632|gb|KE346360.1|	238404	238418	AACTTG	14	-	2	AAGTTC
gi|514486632|gb|KE346360.1|	238544	238561	A	17	-	17	T
gi|514486632|gb|KE346360.1|	239601	239616	AAAAAT	15	-	2	TTTATT
gi|514486632|gb|KE346360.1|	239904	239916	AAAAAG	12	+	2	AAAGAA
gi|514486632|gb|KE346360.1|	239974	239987	AAAACC	13	+	2	CAAAAC
gi|514486632|gb|KE346360.1|	239987	239999	AATCTC	12	+	2	TCTCAA
gi|514486632|gb|KE346360.1|	241477	241489	ACGATG	12	-	2	CGTCAT
gi|514486632|gb|KE346360.1|	241790	241802	AGCGC	12	+	2	CGCAG
gi|514486632|gb|KE346360.1|	242096	242108	AACAGC	12	-	2	CTGTTG
gi|514486632|gb|KE346360.1|	242127	242144	AGC	17	-	5	TGC
gi|514486632|gb|KE346360.1|	242183	242209	ACGATG	26	-	4	GTCATC
gi|514486632|gb|KE346360.1|	242871	242888	AAC	17	-	5	TGT
gi|514486632|gb|KE346360.1|	242892	242905	AGCTCG	13	+	2	CTCGAG
gi|514486632|gb|KE346360.1|	243141	243179	ACTGCT	38	+	6	CTGCTA
gi|514486632|gb|KE346360.1|	243342	243357	AGC	15	+	5	GCA
gi|514486632|gb|KE346360.1|	243379	243392	AAAGCC	13	-	2	TTGGCT
gi|514486632|gb|KE346360.1|	243436	243449	ACG	13	-	4	CGT
gi|514486632|gb|KE346360.1|	243958	243972	ACG	14	+	4	ACG
gi|514486632|gb|KE346360.1|	244257	244269	AAAAAC	12	+	2	CAAAAA
gi|514486632|gb|KE346360.1|	244299	244313	AG	14	+	7	AG
gi|514486632|gb|KE346360.1|	244907	244919	AAAAAT	12	+	2	ATAAAA
gi|514486632|gb|KE346360.1|	245452	245466	AGC	14	-	4	GCT
gi|514486632|gb|KE346360.1|	245591	245608	AAAGGC	17	+	2	GCAAAG
gi|514486632|gb|KE346360.1|	246042	246055	AATCC	13	+	2	CAATC
gi|514486632|gb|KE346360.1|	247941	247956	A	15	-	15	T
gi|514486632|gb|KE346360.1|	248374	248396	AAC	22	+	7	ACA
gi|514486632|gb|KE346360.1|	249607	249620	AC	13	-	6	TG
gi|514486632|gb|KE346360.1|	249619	249632	AAACC	13	-	2	TTGGT
gi|514486632|gb|KE346360.1|	249935	249950	ACG	15	-	5	TCG
gi|514486632|gb|KE346360.1|	250022	250039	ACGATG	17	-	2	TCATCG
gi|514486632|gb|KE346360.1|	250040	250054	ACG	14	-	4	TCG
gi|514486632|gb|KE346360.1|	250386	250401	AGC	15	+	5	CAG
gi|514486632|gb|KE346360.1|	250432	250445	AATGTC	13	-	2	GACATT
gi|514486632|gb|KE346360.1|	250457	250469	ACGATG	12	-	2	TCGTCA
gi|514486632|gb|KE346360.1|	250497	250510	ACTCTG	13	-	2	CAGAGT
gi|514486632|gb|KE346360.1|	250643	250656	AGCC	13	-	3	TGGC
gi|514486632|gb|KE346360.1|	250720	250734	AGC	14	-	4	GCT
gi|514486632|gb|KE346360.1|	250745	250769	ACG	24	-	8	TCG
gi|514486632|gb|KE346360.1|	252131	252144	CCG	13	-	4	CGG
gi|514486632|gb|KE346360.1|	252724	252737	AAAAAC	13	+	2	ACAAAA
gi|514486632|gb|KE346360.1|	253377	253390	ACAGCC	13	+	2	CAGCCA
gi|514486632|gb|KE346360.1|	253430	253444	AAC	14	-	4	TGT
gi|514486632|gb|KE346360.1|	253483	253495	ACGCTG	12	-	2	GTCAGC
gi|514486632|gb|KE346360.1|	254000	254012	AAAAAC	12	-	2	TGTTTT
gi|514486632|gb|KE346360.1|	254370	254383	AGAGC	13	+	2	CAGAG
gi|514486632|gb|KE346360.1|	254400	254415	AATC	15	+	3	TCAA
gi|514486632|gb|KE346360.1|	254461	254473	AAAAC	12	+	2	AAAAC
gi|514486632|gb|KE346360.1|	254874	254890	AC	16	+	8	CA
gi|514486632|gb|KE346360.1|	255170	255182	AAGATC	12	-	2	TCTTGA
gi|514486632|gb|KE346360.1|	256056	256070	ACG	14	+	4	GAC
gi|514486632|gb|KE346360.1|	256071	256084	ACG	13	+	4	GAC
gi|514486632|gb|KE346360.1|	256896	256940	A	44	+	44	A
gi|514486632|gb|KE346360.1|	257583	257602	AAAAAC	19	+	3	AAAACA
gi|514486632|gb|KE346360.1|	257597	257611	AAC	14	+	4	AAC
gi|514486632|gb|KE346360.1|	257869	257882	AGCC	13	-	3	TGGC
gi|514486632|gb|KE346360.1|	258124	258136	AATCC	12	+	2	CAATC
gi|514486632|gb|KE346360.1|	258197	258215	ACGATG	18	+	3	ACGATG
gi|514486632|gb|KE346360.1|	260282	260294	AGCGG	12	+	2	GCGGA
gi|514486632|gb|KE346360.1|	260724	260737	AACTCG	13	-	2	AGTTCG
gi|514486632|gb|KE346360.1|	261472	261484	ACCATC	12	+	2	TCACCA
gi|514486632|gb|KE346360.1|	262125	262137	ACAGCG	12	+	2	CAGCGA
gi|514486632|gb|KE346360.1|	262471	262485	AAGGAG	14	-	2	TCCTTC
gi|514486632|gb|KE346360.1|	262494	262506	AACGCG	12	+	2	GCGAAC
gi|514486632|gb|KE346360.1|	263271	263289	ACG	18	-	6	GTC
gi|514486632|gb|KE346360.1|	263295	263307	ACG	12	-	4	GTC
gi|514486632|gb|KE346360.1|	263584	263604	AAGACG	20	-	3	TCTTCG
gi|514486632|gb|KE346360.1|	263599	263615	ACG	16	-	5	TCG
gi|514486632|gb|KE346360.1|	263610	263624	AACGAC	14	-	2	GTCGTT
gi|514486632|gb|KE346360.1|	264231	264245	ATC	14	+	4	TCA
gi|514486632|gb|KE346360.1|	264323	264338	ACTC	15	+	3	CTCA
gi|514486632|gb|KE346360.1|	264348	264360	ACTC	12	+	3	CACT
gi|514486632|gb|KE346360.1|	264360	264382	ACTC	22	+	5	ACTC
gi|514486632|gb|KE346360.1|	264452	264464	AAG	12	-	4	CTT
gi|514486632|gb|KE346360.1|	264465	264485	AGC	20	-	6	TGC
gi|514486632|gb|KE346360.1|	264576	264595	ACG	19	-	6	TCG
gi|514486632|gb|KE346360.1|	264661	264674	ACG	13	-	4	CGT
gi|514486632|gb|KE346360.1|	264726	264746	AGC	20	+	6	GCA
gi|514486632|gb|KE346360.1|	265390	265402	AGCGCG	12	+	2	CGAGCG
gi|514486632|gb|KE346360.1|	268759	268774	AC	15	-	7	TG
gi|514486632|gb|KE346360.1|	268981	269004	A	23	-	23	T
gi|514486632|gb|KE346360.1|	269037	269049	AAG	12	+	4	GAA
gi|514486632|gb|KE346360.1|	269428	269452	A	24	+	24	A
gi|514486632|gb|KE346360.1|	270951	270964	AAAACC	13	-	2	GGTTTT
gi|514486632|gb|KE346360.1|	271077	271089	AAGAC	12	+	2	AAGAC
gi|514486632|gb|KE346360.1|	271121	271134	AGG	13	-	4	CCT
gi|514486632|gb|KE346360.1|	271409	271422	AAAAAC	13	-	2	TTTGTT
gi|514486632|gb|KE346360.1|	271633	271645	AAATCG	12	-	2	TTTCGA
gi|514486632|gb|KE346360.1|	271664	271685	AG	21	-	10	TC
gi|514486632|gb|KE346360.1|	271861	271873	AGATCC	12	+	2	ATCCAG
gi|514486632|gb|KE346360.1|	271913	271928	AC	15	+	7	CA
gi|514486632|gb|KE346360.1|	272001	272013	AAC	12	+	4	ACA
gi|514486632|gb|KE346360.1|	272253	272268	AGC	15	+	5	CAG
gi|514486632|gb|KE346360.1|	272480	272502	AGC	22	+	7	GCA
gi|514486632|gb|KE346360.1|	272809	272838	ACCAGC	29	-	4	TGCTGG
gi|514486632|gb|KE346360.1|	274272	274288	AAAC	16	-	4	TTTG
gi|514486632|gb|KE346360.1|	275919	275931	AGCCGG	12	+	2	GCCGGA
gi|514486632|gb|KE346360.1|	276222	276234	AGGCGG	12	-	2	GCCTCC
gi|514486632|gb|KE346360.1|	276692	276710	AAAAG	18	-	3	TTTTC
gi|514486632|gb|KE346360.1|	276879	276892	AAGGCC	13	+	2	CAAGGC
gi|514486632|gb|KE346360.1|	277271	277283	AAACTG	12	-	2	GTTTCA
gi|514486632|gb|KE346360.1|	278334	278346	AACGGC	12	-	2	GTTGCC
gi|514486632|gb|KE346360.1|	278616	278628	AACGGC	12	-	2	CCGTTG
gi|514486632|gb|KE346360.1|	278825	278839	AGC	14	+	4	AGC
gi|514486632|gb|KE346360.1|	278865	278889	CCG	24	+	8	CCG
gi|514486632|gb|KE346360.1|	280160	280175	AGGCGG	15	-	2	TCCGCC
gi|514486632|gb|KE346360.1|	280848	280860	AAAAAC	12	+	2	ACAAAA
gi|514486632|gb|KE346360.1|	282235	282247	AATGAG	12	+	2	GAATGA
gi|514486632|gb|KE346360.1|	282637	282650	AAATG	13	+	2	AAATG
gi|514486632|gb|KE346360.1|	283348	283362	ACTGGC	14	-	2	CCAGTG
gi|514486632|gb|KE346360.1|	283363	283380	AGCCGG	17	+	2	GAGCCG
gi|514486632|gb|KE346360.1|	283513	283526	AGC	13	+	4	GCA
gi|514486632|gb|KE346360.1|	283678	283704	A	26	+	26	A
gi|514486632|gb|KE346360.1|	284760	284773	ACAGCC	13	+	2	CAGCCA
gi|514486632|gb|KE346360.1|	284921	284935	AGCATC	14	+	2	CATCAG
gi|514486632|gb|KE346360.1|	285530	285542	AGGATC	12	+	2	GATCAG
gi|514486632|gb|KE346360.1|	285706	285740	A	34	-	34	T
gi|514486632|gb|KE346360.1|	286131	286150	A	19	+	19	A
gi|514486632|gb|KE346360.1|	286276	286302	AAG	26	-	8	CTT
gi|514486632|gb|KE346360.1|	286464	286476	AAATG	12	+	2	AAATG
gi|514486632|gb|KE346360.1|	286512	286525	A	13	+	13	A
gi|514486632|gb|KE346360.1|	288203	288215	AAGACG	12	+	2	AGACGA
gi|514486632|gb|KE346360.1|	288582	288594	AAAATC	12	+	2	TCAAAA
gi|514486632|gb|KE346360.1|	288879	288892	A	13	-	13	T
gi|514486632|gb|KE346360.1|	289303	289315	AGCTCG	12	+	2	CGAGCT
gi|514486632|gb|KE346360.1|	291227	291239	AAAAGC	12	+	2	AGCAAA
gi|514486632|gb|KE346360.1|	291461	291482	ACGATG	21	+	3	GACGAT
gi|514486632|gb|KE346360.1|	291506	291532	ATC	26	-	8	GAT
gi|514486632|gb|KE346360.1|	291693	291716	A	23	-	23	T
gi|514486632|gb|KE346360.1|	291982	291996	AACGAG	14	+	2	GAGAAC
gi|514486632|gb|KE346360.1|	292070	292082	AAACC	12	-	2	GTTTG
gi|514486632|gb|KE346360.1|	292133	292149	AAGG	16	-	4	TTCC
gi|514486632|gb|KE346360.1|	292168	292185	AGC	17	-	5	GCT
gi|514486632|gb|KE346360.1|	292433	292446	ACTGCG	13	-	2	CAGTCG
gi|514486632|gb|KE346360.1|	292448	292465	AGC	17	-	5	CTG
gi|514486632|gb|KE346360.1|	292565	292577	ACTGG	12	-	2	TCCAG
gi|514486632|gb|KE346360.1|	294568	294581	A	13	-	13	T
gi|514486632|gb|KE346360.1|	294585	294597	A	12	-	12	T
gi|514486632|gb|KE346360.1|	294606	294626	ACG	20	-	6	TCG
gi|514486632|gb|KE346360.1|	294791	294804	ACTCCC	13	+	2	CCCACT
gi|514486632|gb|KE346360.1|	294997	295009	AAC	12	-	4	GTT
gi|514486632|gb|KE346360.1|	295454	295471	AACGAC	17	-	2	GTTGTC
gi|514486632|gb|KE346360.1|	295635	295647	AATTCC	12	+	2	CAATTC
gi|514486632|gb|KE346360.1|	295877	295889	ACTCG	12	+	2	ACTCG
gi|514486632|gb|KE346360.1|	296073	296086	AGCCCC	13	+	2	CCAGCC
gi|514486632|gb|KE346360.1|	297107	297121	AAAC	14	-	3	TTGT
gi|514486632|gb|KE346360.1|	297130	297144	AAAC	14	-	3	GTTT
gi|514486632|gb|KE346360.1|	299834	299848	AACAGC	14	-	2	TGTTGC
gi|514486632|gb|KE346360.1|	299852	299872	AAC	20	-	6	TGT
gi|514486632|gb|KE346360.1|	299867	299881	AACAGC	14	-	2	TGTTGC
gi|514486632|gb|KE346360.1|	300306	300318	ACTGCG	12	+	2	GCGACT
gi|514486632|gb|KE346360.1|	300688	300700	ACGGCG	12	+	2	CGACGG
gi|514486632|gb|KE346360.1|	300992	301009	AAGCTC	17	-	2	GCTTGA
gi|514486632|gb|KE346360.1|	301017	301033	AAGCTC	16	-	2	CTTGAG
gi|514486632|gb|KE346360.1|	301237	301282	A	45	+	45	A
gi|514486632|gb|KE346360.1|	301293	301313	A	20	+	20	A
gi|514486632|gb|KE346360.1|	302262	302277	AC	15	-	7	TG
gi|514486632|gb|KE346360.1|	302689	302701	AAACC	12	-	2	GTTTG
gi|514486632|gb|KE346360.1|	304685	304699	ACGTCC	14	+	2	CACGTC
gi|514486632|gb|KE346360.1|	304841	304853	ACGATC	12	-	2	CGTGAT
gi|514486632|gb|KE346360.1|	305222	305234	AATGCC	12	-	2	TTGGCA
gi|514486632|gb|KE346360.1|	305877	305889	AATCC	12	+	2	AATCC
gi|514486632|gb|KE346360.1|	307735	307747	ATCCG	12	+	2	GATCC
gi|514486632|gb|KE346360.1|	308038	308050	ACGCGC	12	+	2	GCGCAC
gi|514486632|gb|KE346360.1|	308322	308334	CCG	12	-	4	CGG
gi|514486632|gb|KE346360.1|	309878	309896	ACTGCT	18	-	3	AGCAGT
gi|514486632|gb|KE346360.1|	309891	309907	ACTGCC	16	-	2	GCAGTG
gi|514486632|gb|KE346360.1|	310412	310432	ACTGAG	20	-	3	TCTCAG
gi|514486632|gb|KE346360.1|	312177	312189	AAAGCC	12	-	2	GCTTTG
gi|514486632|gb|KE346360.1|	312339	312352	AATCC	13	-	2	GGATT
gi|514486632|gb|KE346360.1|	312500	312515	A	15	+	15	A
gi|514486632|gb|KE346360.1|	315957	315970	A	13	-	13	T
gi|514486632|gb|KE346360.1|	316297	316310	A	13	-	13	T
gi|514486632|gb|KE346360.1|	316704	316716	AAGCC	12	-	2	TGGCT
gi|514486632|gb|KE346360.1|	316751	316763	AAAACG	12	-	2	GTTTTC
gi|514486632|gb|KE346360.1|	316842	316854	ACATC	12	-	2	TGATG
gi|514486632|gb|KE346360.1|	317671	317685	A	14	-	14	T
gi|514486632|gb|KE346360.1|	318859	318880	ACAG	21	-	5	GTCT
gi|514486632|gb|KE346360.1|	318892	318904	AACAGC	12	-	2	TTGCTG
gi|514486632|gb|KE346360.1|	319158	319173	AAGCCG	15	+	2	GCCGAA
gi|514486632|gb|KE346360.1|	319724	319742	AAG	18	-	6	CTT
gi|514486632|gb|KE346360.1|	320422	320434	A	12	-	12	T
gi|514486632|gb|KE346360.1|	320956	320968	A	12	-	12	T
gi|514486632|gb|KE346360.1|	320993	321010	AG	17	-	8	CT
gi|514486632|gb|KE346360.1|	321311	321323	ATCCC	12	+	2	TCCCA
gi|514486632|gb|KE346360.1|	321644	321656	ACCACG	12	+	2	GACCAC
gi|514486632|gb|KE346360.1|	321663	321680	AGCGGC	17	-	2	GCTGCC
gi|514486632|gb|KE346360.1|	322408	322422	AGC	14	+	4	CAG
gi|514486632|gb|KE346360.1|	322519	322539	ACC	20	+	6	CCA
gi|514486632|gb|KE346360.1|	323037	323049	AAAAAC	12	-	2	TTGTTT
gi|514486632|gb|KE346360.1|	323106	323118	AGATCT	12	+	2	TAGATC
gi|514486632|gb|KE346360.1|	323536	323548	AACATC	12	-	2	ATGTTG
gi|514486632|gb|KE346360.1|	325009	325021	ACCTCG	12	-	2	CGAGGT
gi|514486632|gb|KE346360.1|	325384	325399	AGC	15	+	5	CAG
gi|514486632|gb|KE346360.1|	325584	325596	AC	12	-	6	GT
gi|514486632|gb|KE346360.1|	325678	325697	ACTCT	19	-	3	GTAGA
gi|514486632|gb|KE346360.1|	325797	325809	ACACGC	12	+	2	CACGCA
gi|514486632|gb|KE346360.1|	325883	325897	AG	14	+	7	GA
gi|514486632|gb|KE346360.1|	325916	325935	AAAAAG	19	+	3	AGAAAA
gi|514486632|gb|KE346360.1|	326963	326977	AAAAAC	14	-	2	TTTTGT
gi|514486632|gb|KE346360.1|	326983	326995	AAAAAC	12	-	2	TTGTTT
gi|514486632|gb|KE346360.1|	327001	327013	AAAAAC	12	-	2	TTGTTT
gi|514486632|gb|KE346360.1|	327047	327060	CCCCCG	13	-	2	GGGGGC
gi|514486632|gb|KE346360.1|	327709	327730	A	21	-	21	T
gi|514486632|gb|KE346360.1|	327742	327779	A	37	-	37	T
gi|514486632|gb|KE346360.1|	327804	327818	AAGGGG	14	-	2	CCTTCC
gi|514486632|gb|KE346360.1|	330605	330617	AACTTC	12	-	2	AGTTGA
gi|514486632|gb|KE346360.1|	332826	332842	AACGAC	16	-	2	TCGTTG
gi|514486632|gb|KE346360.1|	332837	332855	ACCACG	18	-	3	GTCGTG
gi|514486632|gb|KE346360.1|	333165	333178	AGCG	13	+	3	GAGC
gi|514486632|gb|KE346360.1|	333343	333355	AAGCG	12	-	2	CGCTT
gi|514486632|gb|KE346360.1|	333528	333542	AGC	14	+	4	CAG
gi|514486632|gb|KE346360.1|	333648	333661	AGC	13	+	4	GCA
gi|514486632|gb|KE346360.1|	333788	333800	ACTGCC	12	-	2	TGGCAG
gi|514486632|gb|KE346360.1|	334026	334041	AAAC	15	+	3	AAAC
gi|514486632|gb|KE346360.1|	334286	334298	AG	12	+	6	GA
gi|514486632|gb|KE346360.1|	334876	334888	AACCGC	12	-	2	GTTGCG
gi|514486632|gb|KE346360.1|	335093	335105	AAC	12	-	4	TTG
gi|514486632|gb|KE346360.1|	335173	335274	AG	101	-	50	TC
gi|514486632|gb|KE346360.1|	335275	335302	AG	27	-	13	TC
gi|514486632|gb|KE346360.1|	336893	336921	AAG	28	-	9	TCT
gi|514486632|gb|KE346360.1|	337097	337110	AAGCAG	13	-	2	CTGCTT
gi|514486632|gb|KE346360.1|	337237	337250	AG	13	-	6	CT
gi|514486632|gb|KE346360.1|	337385	337397	A	12	-	12	T
gi|514486632|gb|KE346360.1|	337959	338019	AC	60	-	30	TG
gi|514486632|gb|KE346360.1|	340120	340134	AAGACG	14	-	2	CTTCGT
gi|514486632|gb|KE346360.1|	340294	340306	A	12	-	12	T
gi|514486632|gb|KE346360.1|	340459	340471	ACCCGC	12	+	2	CGCACC
gi|514486632|gb|KE346360.1|	340587	340599	AAAAG	12	-	2	TTTTC
gi|514486632|gb|KE346360.1|	340603	340617	AAAAAC	14	-	2	TTTTTG
gi|514486632|gb|KE346360.1|	340775	340788	AAACG	13	+	2	AAACG
gi|514486632|gb|KE346360.1|	341482	341495	AAGGTC	13	-	2	GACCTT
gi|514486632|gb|KE346360.1|	342226	342240	AGGGGG	14	-	2	CCCCCT
gi|514486632|gb|KE346360.1|	343223	343235	AACTC	12	-	2	AGTTG
gi|514486632|gb|KE346360.1|	343277	343289	AGAGGC	12	+	2	CAGAGG
gi|514486632|gb|KE346360.1|	343359	343371	AATGGC	12	+	2	AATGGC
gi|514486632|gb|KE346360.1|	344606	344618	AGAGGG	12	+	2	GAGAGG
gi|514486632|gb|KE346360.1|	344855	344875	A	20	+	20	A
gi|514486632|gb|KE346360.1|	344888	344900	AATCCC	12	+	2	AATCCC
gi|514486632|gb|KE346360.1|	346235	346248	ACAGCG	13	-	2	TGTCGC
gi|514486632|gb|KE346360.1|	346388	346400	ACGAGC	12	+	2	CGAGCA
gi|514486632|gb|KE346360.1|	348058	348070	AACAG	12	+	2	ACAGA
gi|514486632|gb|KE346360.1|	351013	351026	AATCG	13	-	2	CGATT
gi|514486632|gb|KE346360.1|	353283	353297	AAC	14	+	4	ACA
gi|514486632|gb|KE346360.1|	353629	353643	A	14	+	14	A
gi|514486632|gb|KE346360.1|	353891	353910	AAAC	19	-	4	TTTG
gi|514486632|gb|KE346360.1|	353964	353976	AACGCC	12	+	2	GCCAAC
gi|514486632|gb|KE346360.1|	354857	354870	AAAAAC	13	+	2	AAACAA
gi|514486632|gb|KE346360.1|	355575	355589	AGAGGC	14	-	2	CTCTGC
gi|514486632|gb|KE346360.1|	356180	356192	AGGCCG	12	-	2	GGCCTC
gi|514486632|gb|KE346360.1|	356411	356423	AAAAAT	12	+	2	AAATAA
gi|514486632|gb|KE346360.1|	356495	356510	ACCATC	15	+	2	CCATCA
gi|514486632|gb|KE346360.1|	356537	356551	AAG	14	-	4	TTC
gi|514486632|gb|KE346360.1|	356797	356843	A	46	+	46	A
gi|514486632|gb|KE346360.1|	357057	357080	ACTC	23	+	5	CACT
gi|514486632|gb|KE346360.1|	357074	357086	ACACTC	12	+	2	ACTCAC
gi|514486632|gb|KE346360.1|	357080	357098	ACTC	18	+	4	ACTC
gi|514486632|gb|KE346360.1|	357092	357104	ACACTC	12	+	2	ACTCAC
gi|514486632|gb|KE346360.1|	357140	357157	ACG	17	-	5	CGT
gi|514486632|gb|KE346360.1|	357342	357354	AATTCC	12	-	2	TGGAAT
gi|514486632|gb|KE346360.1|	357679	357692	AATG	13	-	3	ATTC
gi|514486632|gb|KE346360.1|	357905	357917	AGGGGG	12	-	2	CCCCTC
gi|514486632|gb|KE346360.1|	357912	357926	AGAGGG	14	-	2	CCCTCT
gi|514486632|gb|KE346360.1|	358140	358155	AAAC	15	-	3	GTTT
gi|514486632|gb|KE346360.1|	358268	358286	ACG	18	-	6	CGT
gi|514486632|gb|KE346360.1|	359789	359803	A	14	+	14	A
gi|514486632|gb|KE346360.1|	360267	360279	AGATC	12	+	2	GATCA
gi|514486632|gb|KE346360.1|	361141	361155	AAAC	14	-	3	TGTT
gi|514486632|gb|KE346360.1|	361980	361993	AATCAG	13	-	2	TGATTC
gi|514486632|gb|KE346360.1|	362194	362220	AGC	26	-	8	CTG
gi|514486632|gb|KE346360.1|	363721	363733	ACACCG	12	-	2	GTGTCG
gi|514486632|gb|KE346360.1|	363847	363859	AATGTC	12	-	2	ACATTG
gi|514486632|gb|KE346360.1|	366133	366146	A	13	+	13	A
gi|514486632|gb|KE346360.1|	366520	366534	A	14	-	14	T
gi|514486632|gb|KE346360.1|	366590	366602	AGCTCG	12	+	2	AGCTCG
gi|514486632|gb|KE346360.1|	366661	366673	AAGTGG	12	-	2	CCACTT
gi|514486632|gb|KE346360.1|	366967	366982	A	15	-	15	T
gi|514486632|gb|KE346360.1|	367657	367669	A	12	+	12	A
gi|514486632|gb|KE346360.1|	368176	368188	AATCG	12	-	2	TTCGA
gi|514486632|gb|KE346360.1|	368420	368433	ACCATG	13	+	2	ACCATG
gi|514486632|gb|KE346360.1|	368581	368593	ACTGGG	12	+	2	GACTGG
gi|514486632|gb|KE346360.1|	370139	370252	ACC	113	+	37	CAC
gi|514486632|gb|KE346360.1|	370265	370278	ACC	13	+	4	CAC
gi|514486632|gb|KE346360.1|	370279	370292	ACC	13	+	4	CCA
gi|514486632|gb|KE346360.1|	371345	371359	ATC	14	-	4	GAT
gi|514486632|gb|KE346360.1|	371553	371571	ATC	18	+	6	CAT
gi|514486632|gb|KE346360.1|	371583	371596	AG	13	+	6	GA
gi|514486632|gb|KE346360.1|	372470	372482	ACAGCC	12	-	2	GTGGCT
gi|514486632|gb|KE346360.1|	372656	372679	A	23	+	23	A
gi|514486632|gb|KE346360.1|	372814	372828	ACC	14	+	4	CAC
gi|514486632|gb|KE346360.1|	373172	373192	CCG	20	-	6	GCG
gi|514486632|gb|KE346360.1|	373380	373392	ACCGAG	12	-	2	CGGTCT
gi|514486632|gb|KE346360.1|	373408	373420	ACAGCC	12	-	2	TGGCTG
gi|514486632|gb|KE346360.1|	373538	373552	ATC	14	+	4	TCA
gi|514486632|gb|KE346360.1|	373550	373576	ACG	26	-	8	TCG
gi|514486632|gb|KE346360.1|	373571	373585	AAGACG	14	-	2	TCGTCT
gi|514486632|gb|KE346360.1|	373664	373678	ACAGTG	14	-	2	TCACTG
gi|514486632|gb|KE346360.1|	373781	373793	ACGAGC	12	-	2	TGCTCG
gi|514486632|gb|KE346360.1|	374803	374815	AGCCCG	12	+	2	GAGCCC
gi|514486632|gb|KE346360.1|	374953	374965	ATGGCC	12	+	2	CATGGC
gi|514486632|gb|KE346360.1|	375282	375294	AACAGC	12	-	2	CTGTTG
gi|514486632|gb|KE346360.1|	375309	375321	AACAGC	12	-	2	CTGTTG
gi|514486632|gb|KE346360.1|	375411	375435	AGC	24	-	8	TGC
gi|514486632|gb|KE346360.1|	375500	375512	A	12	+	12	A
gi|514486632|gb|KE346360.1|	377547	377559	ACGAGT	12	-	2	ACTCGT
gi|514486632|gb|KE346360.1|	377903	377915	ACATGT	12	+	2	GTACAT
gi|514486632|gb|KE346360.1|	378424	378437	AAAAC	13	+	2	AAACA
gi|514486632|gb|KE346360.1|	378433	378452	A	19	+	19	A
gi|514486632|gb|KE346360.1|	378453	378468	A	15	+	15	A
gi|514486632|gb|KE346360.1|	379409	379422	AAG	13	+	4	AGA
gi|514486632|gb|KE346360.1|	380990	381004	ACC	14	+	4	CAC
gi|514486632|gb|KE346360.1|	381157	381180	AGCGGC	23	-	3	GCCGCT
gi|514486632|gb|KE346360.1|	381215	381228	ACGAGG	13	-	2	CGTCCT
gi|514486632|gb|KE346360.1|	381486	381501	A	15	+	15	A
gi|514486632|gb|KE346360.1|	381598	381616	A	18	-	18	T
gi|514486632|gb|KE346360.1|	381660	381672	AAAGGC	12	-	2	TTGCCT
gi|514486632|gb|KE346360.1|	381796	381814	A	18	+	18	A
gi|514486632|gb|KE346360.1|	382019	382031	AAACC	12	-	2	TTTGG
gi|514486632|gb|KE346360.1|	382116	382153	AG	37	+	18	GA
gi|514486632|gb|KE346360.1|	382152	382187	AC	35	-	17	GT
gi|514486632|gb|KE346360.1|	382186	382199	ACTCTC	13	-	2	GAGTGA
gi|514486632|gb|KE346360.1|	382193	382207	ACTC	14	-	3	AGTG
gi|514486632|gb|KE346360.1|	382210	382222	AGCG	12	+	3	GCGA
gi|514486632|gb|KE346360.1|	382995	383015	ACAG	20	-	5	TCTG
gi|514486632|gb|KE346360.1|	383098	383113	AGATG	15	-	3	CATCT
gi|514486632|gb|KE346360.1|	383632	383644	ACC	12	+	4	CCA
gi|514486632|gb|KE346360.1|	385711	385728	AAAAC	17	+	3	AAAAC
gi|514486632|gb|KE346360.1|	385729	385741	AAAAAC	12	+	2	AACAAA
gi|514486632|gb|KE346360.1|	386218	386234	ACACC	16	-	3	TGGTG
gi|514486632|gb|KE346360.1|	386929	386942	AAATGG	13	-	2	TTCCAT
gi|514486632|gb|KE346360.1|	387054	387142	AAG	88	-	29	CTT
gi|514486632|gb|KE346360.1|	387460	387474	A	14	-	14	T
gi|514486632|gb|KE346360.1|	388594	388614	AATG	20	-	5	ATTC
gi|514486632|gb|KE346360.1|	388629	388650	A	21	-	21	T
gi|514486632|gb|KE346360.1|	388770	388783	ACC	13	-	4	TGG
gi|514486632|gb|KE346360.1|	388784	388798	CCG	14	-	4	GCG
gi|514486632|gb|KE346360.1|	388793	388809	AGCGGC	16	+	2	GCGGCA
gi|514486632|gb|KE346360.1|	388895	388909	AGC	14	+	4	GCA
gi|514486632|gb|KE346360.1|	389050	389066	AGC	16	+	5	GCA
gi|514486632|gb|KE346360.1|	389396	389408	AGC	12	+	4	GCA
gi|514486632|gb|KE346360.1|	389494	389512	AC	18	-	9	TG
gi|514486632|gb|KE346360.1|	389547	389562	ACACC	15	-	3	TGTGG
gi|514486632|gb|KE346360.1|	389643	389655	AAGAGG	12	-	2	CTCTTC
gi|514486632|gb|KE346360.1|	389733	389748	A	15	+	15	A
gi|514486632|gb|KE346360.1|	389962	389979	A	17	-	17	T
gi|514486632|gb|KE346360.1|	390516	390529	ACCTCC	13	+	2	CCTCCA
gi|514486632|gb|KE346360.1|	390873	390887	AGC	14	-	4	TGC
gi|514486632|gb|KE346360.1|	391494	391506	ACATGT	12	+	2	TGTACA
gi|514486632|gb|KE346360.1|	391544	391556	AAGATG	12	-	2	TTCATC
gi|514486632|gb|KE346360.1|	392564	392579	AAAAAC	15	-	2	TGTTTT
gi|514486632|gb|KE346360.1|	393093	393105	AAAAAG	12	-	2	TTTTTC
gi|514486632|gb|KE346360.1|	393130	393144	A	14	-	14	T
gi|514486632|gb|KE346360.1|	393551	393600	A	49	-	49	T
gi|514486632|gb|KE346360.1|	393884	393896	ACGAGC	12	+	2	CACGAG
gi|514486632|gb|KE346360.1|	394015	394038	A	23	+	23	A
gi|514486632|gb|KE346360.1|	394793	394814	AG	21	+	10	GA
gi|514486632|gb|KE346360.1|	397280	397296	AAC	16	-	5	TTG
gi|514486632|gb|KE346360.1|	397338	397363	AAG	25	-	8	TCT
gi|514486632|gb|KE346360.1|	398247	398259	AG	12	-	6	TC
gi|514486632|gb|KE346360.1|	398350	398364	AAGGGG	14	-	2	CCCCTT
gi|514486632|gb|KE346360.1|	398825	398837	AAAAAC	12	+	2	AAAAAC
gi|514486632|gb|KE346360.1|	400340	400353	CCG	13	-	4	GCG
gi|514486632|gb|KE346360.1|	400378	400393	AGC	15	+	5	CAG
gi|514486632|gb|KE346360.1|	400634	400652	AGC	18	+	6	AGC
gi|514486632|gb|KE346360.1|	401038	401055	AAATC	17	-	3	GATTT
gi|514486632|gb|KE346360.1|	401161	401173	ACACTC	12	+	2	TCACAC
gi|514486632|gb|KE346360.1|	401348	401367	AG	19	+	9	GA
gi|514486632|gb|KE346360.1|	401513	401527	AAAGTC	14	-	2	TTTGAC
gi|514486632|gb|KE346360.1|	401610	401627	AAAAAG	17	+	2	AAAAAG
gi|514486632|gb|KE346360.1|	401839	401876	A	37	-	37	T
gi|514486632|gb|KE346360.1|	402031	402043	AATCTC	12	-	2	TTGAGA
gi|514486632|gb|KE346360.1|	402103	402125	AATCTC	22	+	3	TCTCAA
gi|514486632|gb|KE346360.1|	402251	402265	AAAAAC	14	-	2	TTTTTG
gi|514486632|gb|KE346360.1|	402267	402279	AAAAGC	12	+	2	GCAAAA
gi|514486632|gb|KE346360.1|	402379	402393	A	14	+	14	A
gi|514486632|gb|KE346360.1|	402593	402614	A	21	+	21	A
gi|514486632|gb|KE346360.1|	402767	402779	AAAATC	12	-	2	TTTTGA
gi|514486632|gb|KE346360.1|	402979	402993	AAGC	14	-	3	TTGC
gi|514486632|gb|KE346360.1|	403244	403257	ACG	13	-	4	GTC
gi|514486632|gb|KE346360.1|	404295	404309	ACGGCC	14	-	2	GCCGTG
gi|514486632|gb|KE346360.1|	406326	406338	ACCGTC	12	+	2	GTCACC
gi|514486632|gb|KE346360.1|	407995	408032	AGC	37	-	12	CTG
gi|514486632|gb|KE346360.1|	408695	408709	AAGCGG	14	-	2	CTTCCG
gi|514486632|gb|KE346360.1|	408927	408939	ACCCCG	12	+	2	CCCGAC
gi|514486632|gb|KE346360.1|	409282	409294	AGAGCG	12	+	2	GCGAGA
gi|514486632|gb|KE346360.1|	409347	409360	ATGCCC	13	-	2	GGCATG
gi|514486632|gb|KE346360.1|	410277	410290	AATGG	13	-	2	CCATT
gi|514486632|gb|KE346360.1|	410685	410697	AAGCTC	12	+	2	CTCAAG
gi|514486632|gb|KE346360.1|	410857	410870	ACCTGC	13	+	2	CTGCAC
gi|514486632|gb|KE346360.1|	410865	410888	ACCCGC	23	+	3	GCACCC
gi|514486632|gb|KE346360.1|	411447	411464	AGC	17	-	5	GCT
gi|514486632|gb|KE346360.1|	411574	411586	AAGCTC	12	+	2	TCAAGC
gi|514486632|gb|KE346360.1|	412757	412769	AAGTGG	12	-	2	TTCCAC
gi|514486632|gb|KE346360.1|	415820	415832	ACTGGC	12	+	2	TGGCAC
gi|514486632|gb|KE346360.1|	416123	416136	AAAGCC	13	-	2	CTTTGG
gi|514486632|gb|KE346360.1|	416483	416496	ACCTCG	13	+	2	CTCGAC
gi|514486632|gb|KE346360.1|	417194	417206	AATGTC	12	-	2	CATTGA
gi|514486632|gb|KE346360.1|	417691	417703	ACGCAG	12	+	2	CGCAGA
gi|514486632|gb|KE346360.1|	417942	417954	AAAAAC	12	-	2	TTTTGT
gi|514486632|gb|KE346360.1|	418028	418052	AC	24	+	12	AC
gi|514486632|gb|KE346360.1|	419659	419671	ACAGCC	12	-	2	GTGGCT
gi|514486632|gb|KE346360.1|	420097	420109	AAGCAC	12	+	2	CAAGCA
gi|514486632|gb|KE346360.1|	420770	420782	ATCGGC	12	+	2	TCGGCA
gi|514486632|gb|KE346360.1|	421344	421356	AACACC	12	-	2	TGGTGT
gi|514486632|gb|KE346360.1|	421973	421989	ACTGCG	16	-	2	GTCGCA
gi|514486632|gb|KE346360.1|	422035	422066	AGC	31	+	10	CAG
gi|514486632|gb|KE346360.1|	422080	422092	ATCGGC	12	+	2	CGGCAT
gi|514486632|gb|KE346360.1|	422271	422289	A	18	+	18	A
gi|514486632|gb|KE346360.1|	422298	422312	AAC	14	+	4	AAC
gi|514486632|gb|KE346360.1|	422417	422432	A	15	-	15	T
gi|514486632|gb|KE346360.1|	422598	422611	AGAGCG	13	+	2	AGCGAG
gi|514486632|gb|KE346360.1|	422707	422720	ACACT	13	-	2	GTGTA
gi|514486632|gb|KE346360.1|	422796	422812	AAACGG	16	-	2	TTTCCG
gi|514486632|gb|KE346360.1|	422978	422991	AAAT	13	-	3	TTAT
gi|514486632|gb|KE346360.1|	423017	423044	A	27	-	27	T
gi|514486632|gb|KE346360.1|	423061	423074	AAAAAC	13	-	2	TTTGTT
gi|514486632|gb|KE346360.1|	423135	423148	CCCCCG	13	+	2	CCCCCG
gi|514486632|gb|KE346360.1|	423190	423202	A	12	+	12	A
gi|514486632|gb|KE346360.1|	423241	423255	AAAAAT	14	+	2	AAAAAT
gi|514486632|gb|KE346360.1|	424694	424708	AGC	14	-	4	GCT
gi|514486632|gb|KE346360.1|	424973	424986	A	13	-	13	T
gi|514486632|gb|KE346360.1|	425460	425473	ACTGAG	13	-	2	CAGTCT
gi|514486632|gb|KE346360.1|	427105	427119	AAAAGC	14	-	2	CTTTTG
gi|514486632|gb|KE346360.1|	427339	427360	ACC	21	+	7	CCA
gi|514486632|gb|KE346360.1|	427397	427410	AGC	13	+	4	CAG
gi|514486632|gb|KE346360.1|	427486	427499	AAGAGG	13	-	2	CTTCCT
gi|514486632|gb|KE346360.1|	427541	427555	AAC	14	+	4	CAA
gi|514486632|gb|KE346360.1|	427566	427578	AACAGC	12	+	2	AACAGC
gi|514486632|gb|KE346360.1|	427667	427683	ACCAGT	16	+	2	CCAGTA
gi|514486632|gb|KE346360.1|	427680	427707	AGC	27	+	9	CAG
gi|514486632|gb|KE346360.1|	427709	427721	CCCCCG	12	+	2	CCGCCC
gi|514486632|gb|KE346360.1|	429525	429537	AATGGG	12	-	2	TTCCCA
gi|514486632|gb|KE346360.1|	430080	430092	A	12	-	12	T
gi|514486632|gb|KE346360.1|	431258	431270	AGC	12	-	4	GCT
gi|514486632|gb|KE346360.1|	431547	431559	ACAGTG	12	-	2	CACTGT
gi|514486632|gb|KE346360.1|	433812	433824	AAAAAG	12	+	2	AAGAAA
gi|514486632|gb|KE346360.1|	433827	433844	AAAC	17	+	4	ACAA
gi|514486632|gb|KE346360.1|	433841	433853	A	12	+	12	A
gi|514486632|gb|KE346360.1|	434444	434457	AATCG	13	+	2	CGAAT
gi|514486632|gb|KE346360.1|	436368	436381	ACGAGG	13	-	2	TCGTCC
gi|514486632|gb|KE346360.1|	437721	437739	AAAG	18	+	4	AAGA
gi|514486632|gb|KE346360.1|	438080	438093	AGC	13	+	4	GCA
gi|514486632|gb|KE346360.1|	438583	438595	ACGAGG	12	+	2	GACGAG
gi|514486632|gb|KE346360.1|	439147	439160	AAAAAG	13	-	2	TCTTTT
gi|514486632|gb|KE346360.1|	439308	439321	ATC	13	+	4	CAT
gi|514486632|gb|KE346360.1|	439322	439334	ATC	12	+	4	TCA
gi|514486632|gb|KE346360.1|	439532	439545	AAGCC	13	+	2	CCAAG
gi|514486632|gb|KE346360.1|	441370	441385	AGG	15	+	5	AGG
gi|514486632|gb|KE346360.1|	441509	441523	ACC	14	+	4	CAC
gi|514486632|gb|KE346360.1|	441575	441590	AAAAAC	15	+	2	AACAAA
gi|514486632|gb|KE346360.1|	441604	441627	CCG	23	+	7	CCG
gi|514486632|gb|KE346360.1|	443611	443625	AGC	14	+	4	CAG
gi|514486632|gb|KE346360.1|	444296	444308	ACTCAG	12	+	2	CAGACT
gi|514486632|gb|KE346360.1|	444597	444621	A	24	-	24	T
gi|514486632|gb|KE346360.1|	444852	444868	A	16	-	16	T
gi|514486632|gb|KE346360.1|	445001	445015	ATC	14	+	4	CAT
gi|514486632|gb|KE346360.1|	445070	445082	CCG	12	+	4	GCC
gi|514486632|gb|KE346360.1|	445243	445256	A	13	-	13	T
gi|514486632|gb|KE346360.1|	445351	445372	AAGAGG	21	+	3	GAGGAA
gi|514486632|gb|KE346360.1|	445367	445384	AAAGAG	17	+	2	AAGAGA
gi|514486632|gb|KE346360.1|	445864	445876	ACCC	12	+	3	ACCC
gi|514486632|gb|KE346360.1|	447236	447248	AAAC	12	-	3	TTTG
gi|514486632|gb|KE346360.1|	447400	447413	AAAAC	13	-	2	TTTTG
gi|514486632|gb|KE346360.1|	447439	447451	AAAC	12	-	3	TTTG
gi|514486632|gb|KE346360.1|	448315	448327	AAACC	12	-	2	TGGTT
gi|514486632|gb|KE346360.1|	448333	448348	AAAC	15	-	3	TTTG
gi|514486632|gb|KE346360.1|	448613	448625	AAATGC	12	-	2	TTTGCA
gi|514486632|gb|KE346360.1|	449454	449467	AAAAAC	13	+	2	AAAAAC
gi|514486632|gb|KE346360.1|	449827	449947	AG	120	-	60	CT
gi|514486632|gb|KE346360.1|	450363	450376	ACACAG	13	-	2	TGTGTC
gi|514486632|gb|KE346360.1|	450476	450647	AC	171	-	85	TG
gi|514486632|gb|KE346360.1|	450642	450665	ACACAT	23	-	3	TGTGTA
gi|514486632|gb|KE346360.1|	450660	450679	AC	19	-	9	TG
gi|514486632|gb|KE346360.1|	452381	452400	A	19	-	19	T
gi|514486632|gb|KE346360.1|	452472	452484	AAAAAG	12	-	2	TTTTTC
gi|514486632|gb|KE346360.1|	452726	452738	AGAGC	12	-	2	GCTCT
gi|514486632|gb|KE346360.1|	453491	453508	AAC	17	-	5	GTT
gi|514486632|gb|KE346360.1|	453738	453750	AACCAG	12	+	2	CAGAAC
gi|514486632|gb|KE346360.1|	454211	454225	AAGCGC	14	-	2	CTTGCG
gi|514486632|gb|KE346360.1|	454455	454471	AGC	16	+	5	CAG
gi|514486632|gb|KE346360.1|	454663	454677	AC	14	+	7	CA
gi|514486632|gb|KE346360.1|	455102	455119	ATCCC	17	+	3	ATCCC
gi|514486632|gb|KE346360.1|	455365	455380	AAAAAG	15	+	2	AAGAAA
gi|514486632|gb|KE346360.1|	455908	455920	AAAAAC	12	-	2	TTTTTG
gi|514486632|gb|KE346360.1|	456173	456193	ACCTCC	20	+	3	CCTCCA
gi|514486632|gb|KE346360.1|	456244	456257	AGCGC	13	-	2	CTGCG
gi|514486632|gb|KE346360.1|	457426	457438	ACGAGG	12	+	2	CGAGGA
gi|514486632|gb|KE346360.1|	457536	457601	AAGG	65	+	16	AAGG
gi|514486632|gb|KE346360.1|	457684	457697	AC	13	+	6	AC
gi|514486632|gb|KE346360.1|	457807	457820	ACACGT	13	+	2	GTACAC
gi|514486632|gb|KE346360.1|	458940	458953	CCCCCG	13	-	2	GGGGGC
gi|514486632|gb|KE346360.1|	459249	459283	A	34	+	34	A
gi|514486632|gb|KE346360.1|	459302	459316	AATTC	14	+	2	CAATT
gi|514486632|gb|KE346360.1|	460572	460584	ACACG	12	-	2	TGTCG
gi|514486632|gb|KE346360.1|	461344	461356	CCCCG	12	-	2	CGGGG
gi|514486632|gb|KE346360.1|	461375	461387	AATTGC	12	+	2	TTGCAA
gi|514486632|gb|KE346360.1|	462132	462147	AAAAAG	15	-	2	TTTTTC
gi|514486632|gb|KE346360.1|	462208	462220	AACG	12	+	3	GAAC
gi|514486632|gb|KE346360.1|	462334	462346	ACTCTC	12	-	2	GAGAGT
gi|514486632|gb|KE346360.1|	462427	462439	AGGGG	12	-	2	CCTCC
gi|514486632|gb|KE346360.1|	462446	462459	AACAC	13	+	2	AACAC
gi|514486632|gb|KE346360.1|	462467	462479	AAACTG	12	+	2	GAAACT
gi|514486632|gb|KE346360.1|	462613	462625	AAAGC	12	+	2	AGCAA
gi|514486632|gb|KE346360.1|	462847	462862	AAACTG	15	+	2	GAAACT
gi|514486632|gb|KE346360.1|	462913	462934	AG	21	+	10	AG
gi|514486632|gb|KE346360.1|	464566	464581	AACGAC	15	+	2	ACAACG
gi|514486632|gb|KE346360.1|	464617	464629	AG	12	+	6	AG
gi|514486632|gb|KE346360.1|	464966	464979	AACAAG	13	-	2	GTTCTT
gi|514486632|gb|KE346360.1|	465561	465574	A	13	+	13	A
gi|514486632|gb|KE346360.1|	465967	465979	AACAGC	12	+	2	AGCAAC
gi|514486632|gb|KE346360.1|	467294	467318	A	24	-	24	T
gi|514486632|gb|KE346360.1|	467629	467642	AATAT	13	-	2	TATAT
gi|514486632|gb|KE346360.1|	467854	467868	AGGGGG	14	+	2	GGGAGG
gi|514486632|gb|KE346360.1|	468018	468030	AAAAAT	12	+	2	AAAAAT
gi|514486632|gb|KE346360.1|	468036	468053	AGCCG	17	-	3	GCTCG
gi|514486632|gb|KE346360.1|	468500	468512	AAAACG	12	-	2	GTTTTC
gi|514486632|gb|KE346360.1|	468547	468559	AAATG	12	-	2	TTTCA
gi|514486632|gb|KE346360.1|	468755	468767	ACG	12	-	4	GTC
gi|514486632|gb|KE346360.1|	470026	470038	AAATTG	12	+	2	GAAATT
gi|514486632|gb|KE346360.1|	470332	470344	AAATTG	12	+	2	GAAATT
gi|514486632|gb|KE346360.1|	470690	470703	AATCGC	13	+	2	GCAATC
gi|514486632|gb|KE346360.1|	470732	470745	AATCGC	13	+	2	GCAATC
gi|514486632|gb|KE346360.1|	471067	471084	AGCTCC	17	+	2	GCTCCA
gi|514486632|gb|KE346360.1|	471079	471091	AGCCGG	12	-	2	GCTCCG
gi|514486632|gb|KE346360.1|	473101	473113	AAATTG	12	-	2	CAATTT
gi|514486632|gb|KE346360.1|	475317	475334	AGCCG	17	+	3	GCCGA
gi|514486632|gb|KE346360.1|	475340	475352	AAAAAT	12	-	2	ATTTTT
gi|514486632|gb|KE346360.1|	475871	475884	AATAT	13	+	2	ATAAT
gi|514486632|gb|KE346360.1|	476096	476113	A	17	-	17	T
gi|514486632|gb|KE346360.1|	476373	476386	AAAAC	13	-	2	TTTTG
gi|514486632|gb|KE346360.1|	476380	476394	AAAC	14	-	3	TTGT
gi|514486632|gb|KE346360.1|	476580	476592	A	12	-	12	T
gi|514486632|gb|KE346360.1|	476804	476825	A	21	+	21	A
gi|514486632|gb|KE346360.1|	476828	476841	AATCAG	13	-	2	CTGATT
gi|514486632|gb|KE346360.1|	476908	476920	AACCAC	12	-	2	TGTGGT
gi|514486632|gb|KE346360.1|	477020	477034	AAAAT	14	-	2	TTTTA
gi|514486632|gb|KE346360.1|	477049	477074	AAAAT	25	-	5	ATTTT
gi|514486632|gb|KE346360.1|	478261	478273	AAGACG	12	-	2	TCTTCG
gi|514486632|gb|KE346360.1|	479060	479073	CCCGCG	13	+	2	CGCCCG
gi|514486632|gb|KE346360.1|	479185	479199	AGC	14	+	4	CAG
gi|514486632|gb|KE346360.1|	479194	479211	ACCAGC	17	+	2	CAGCAC
gi|514486632|gb|KE346360.1|	479256	479271	AATTAC	15	+	2	ACAATT
gi|514486632|gb|KE346360.1|	479268	479280	AACAGC	12	+	2	ACAGCA
gi|514486632|gb|KE346360.1|	479330	479346	AGC	16	+	5	AGC
gi|514486632|gb|KE346360.1|	479344	479363	AAC	19	+	6	CAA
gi|514486632|gb|KE346360.1|	479364	479385	AACATC	21	+	3	ACATCA
gi|514486632|gb|KE346360.1|	480422	480454	AAAC	32	-	8	GTTT
gi|514486632|gb|KE346360.1|	480464	480593	AAC	129	-	43	GTT
gi|514486632|gb|KE346360.1|	480667	480680	AAAAAC	13	-	2	TTTTTG
gi|514486632|gb|KE346360.1|	480681	480706	AAAC	25	-	6	TGTT
gi|514486632|gb|KE346360.1|	482547	482570	A	23	+	23	A
gi|514486632|gb|KE346360.1|	482806	482818	AATTAC	12	-	2	TAATTG
gi|514486632|gb|KE346360.1|	483539	483551	ATC	12	-	4	TGA
gi|514486632|gb|KE346360.1|	483567	483595	AGC	28	+	9	GCA
gi|514486632|gb|KE346360.1|	484331	484343	AAGAGC	12	+	2	AAGAGC
gi|514486632|gb|KE346360.1|	484676	484689	ACCGAG	13	-	2	GTCTCG
gi|514486632|gb|KE346360.1|	484879	484892	AAAGTG	13	-	2	TCACTT
gi|514486632|gb|KE346360.1|	485046	485069	A	23	-	23	T
gi|514486632|gb|KE346360.1|	486018	486031	ACAGCG	13	-	2	TGTCGC
gi|514486632|gb|KE346360.1|	486171	486183	ACGAGC	12	+	2	CGAGCA
gi|514486632|gb|KE346360.1|	488060	488073	AACGAG	13	+	2	GAACGA
gi|514486632|gb|KE346360.1|	488116	488128	C	12	+	12	C
gi|514486632|gb|KE346360.1|	488134	488152	AGCATG	18	-	3	CATGCT
gi|514486632|gb|KE346360.1|	488445	488460	AGC	15	+	5	CAG
gi|514486632|gb|KE346360.1|	488509	488521	ACCCC	12	-	2	GGGGT
gi|514486632|gb|KE346360.1|	488815	488830	AAAACG	15	-	2	CGTTTT
gi|514486632|gb|KE346360.1|	488852	488864	AACCAC	12	+	2	AACCAC
gi|514486632|gb|KE346360.1|	491047	491111	AAAC	64	-	16	GTTT
gi|514486632|gb|KE346360.1|	491105	491122	AAAAC	17	-	3	TTGTT
gi|514486632|gb|KE346360.1|	492238	492254	AAC	16	-	5	TTG
gi|514486632|gb|KE346360.1|	493997	494011	AAATC	14	+	2	AATCA
gi|514486632|gb|KE346360.1|	494453	494465	AATCC	12	+	2	TCCAA
gi|514486632|gb|KE346360.1|	495121	495138	AAC	17	+	5	AAC
gi|514486632|gb|KE346360.1|	495304	495316	AGGG	12	-	3	CTCC
gi|514486632|gb|KE346360.1|	495414	495426	AGC	12	+	4	GCA
gi|514486632|gb|KE346360.1|	495454	495467	ACGAGC	13	-	2	GCTCGT
gi|514486632|gb|KE346360.1|	495478	495492	ACTCGC	14	+	2	TCGCAC
gi|514486632|gb|KE346360.1|	499398	499581	AG	183	-	91	TC
gi|514486632|gb|KE346360.1|	499582	499611	AG	29	-	14	TC
gi|514486632|gb|KE346360.1|	499954	499966	AAGGCG	12	-	2	CTTCGC
gi|514486632|gb|KE346360.1|	499964	499976	AAGC	12	+	3	GCAA
gi|514486632|gb|KE346360.1|	500472	500490	AGCAGG	18	-	3	TCCTGC
gi|514486632|gb|KE346360.1|	500852	500864	AAGAGG	12	-	2	CTTCCT
gi|514486632|gb|KE346360.1|	501029	501042	AGAT	13	-	3	TATC
gi|514486632|gb|KE346360.1|	501525	501540	ACACAG	15	-	2	GTGTCT
gi|514486632|gb|KE346360.1|	501582	501594	ACACAT	12	-	2	ATGTGT
gi|514486632|gb|KE346360.1|	501597	501609	AC	12	-	6	TG
gi|514486632|gb|KE346360.1|	501817	501829	AAC	12	+	4	AAC
gi|514486632|gb|KE346360.1|	503139	503155	AGG	16	+	5	AGG
gi|514486632|gb|KE346360.1|	503315	503329	AGC	14	+	4	CAG
gi|514486632|gb|KE346360.1|	503378	503391	AAC	13	+	4	CAA
gi|514486632|gb|KE346360.1|	503659	503672	AAAAAC	13	-	2	TTTTTG
gi|514486632|gb|KE346360.1|	503958	503974	AGCGC	16	+	3	AGCGC
gi|514486632|gb|KE346360.1|	504450	504489	ACT	39	+	13	ACT
gi|514486632|gb|KE346360.1|	505141	505154	ACGAGG	13	+	2	ACGAGG
gi|514486632|gb|KE346360.1|	506495	506513	AAAAC	18	-	3	TTTTG
gi|514486632|gb|KE346360.1|	507498	507510	AGCCCC	12	+	2	CCAGCC
gi|514486632|gb|KE346360.1|	507622	507635	AAACAC	13	+	2	ACAAAC
gi|514486632|gb|KE346360.1|	507938	507951	AATCTG	13	+	2	GAATCT
gi|514486632|gb|KE346360.1|	508110	508134	A	24	-	24	T
gi|514486632|gb|KE346360.1|	508807	508819	AGCGGC	12	+	2	GGCAGC
gi|514486632|gb|KE346360.1|	508814	508826	AGC	12	+	4	GCA
gi|514486632|gb|KE346360.1|	508830	508844	AGC	14	+	4	CAG
gi|514486632|gb|KE346360.1|	509048	509072	A	24	-	24	T
gi|514486632|gb|KE346360.1|	511761	511774	ATCCGC	13	-	2	TGCGGA
gi|514486632|gb|KE346360.1|	513135	513148	A	13	-	13	T
gi|514486632|gb|KE346360.1|	513150	513165	AAAAAG	15	-	2	TTTTTC
gi|514486632|gb|KE346360.1|	514228	514240	AATGTC	12	-	2	TTGACA
gi|514486632|gb|KE346360.1|	515005	515018	ACAGCG	13	-	2	TGTCGC
gi|514486632|gb|KE346360.1|	515158	515170	ACGAGC	12	+	2	CGAGCA
gi|514486632|gb|KE346360.1|	516816	516828	AACAG	12	+	2	ACAGA
gi|514486632|gb|KE346360.1|	517418	517433	ATC	15	+	5	CAT
gi|514486632|gb|KE346360.1|	517987	518022	A	35	-	35	T
gi|514486632|gb|KE346360.1|	518563	518578	AAATC	15	-	3	GATTT
gi|514486632|gb|KE346360.1|	519883	519896	AAAAC	13	-	2	TTTTG
gi|514486632|gb|KE346360.1|	520494	520507	AAATAC	13	-	2	TTTGTA
gi|514486632|gb|KE346360.1|	521267	521283	AAC	16	+	5	ACA
gi|514486632|gb|KE346360.1|	521289	521302	AAC	13	+	4	CAA
gi|514486632|gb|KE346360.1|	521303	521318	AAC	15	+	5	ACA
gi|514486632|gb|KE346360.1|	521577	521596	AAG	19	-	6	TCT
gi|514486632|gb|KE346360.1|	523193	523206	AAAAGC	13	-	2	TTGCTT
gi|514486632|gb|KE346360.1|	523315	523328	AAG	13	+	4	GAA
gi|514486632|gb|KE346360.1|	523544	523558	ACG	14	-	4	GTC
gi|514486632|gb|KE346360.1|	523590	523605	A	15	-	15	T
gi|514486632|gb|KE346360.1|	523973	523992	A	19	-	19	T
gi|514486632|gb|KE346360.1|	523996	524008	AAAC	12	-	3	TTTG
gi|514486632|gb|KE346360.1|	524209	524232	A	23	-	23	T
gi|514486632|gb|KE346360.1|	524415	524427	A	12	+	12	A
gi|514486632|gb|KE346360.1|	524588	524601	A	13	-	13	T
gi|514486632|gb|KE346360.1|	524882	524895	AAC	13	-	4	TGT
gi|514486632|gb|KE346360.1|	526140	526155	AAGGCC	15	+	2	GCCAAG
gi|514486632|gb|KE346360.1|	526934	526946	AAG	12	-	4	TTC
gi|514486632|gb|KE346360.1|	527229	527241	ACCAG	12	+	2	GACCA
gi|514486632|gb|KE346360.1|	528702	528715	A	13	-	13	T
gi|514486632|gb|KE346360.1|	530444	530458	A	14	-	14	T
gi|514486632|gb|KE346360.1|	530455	530478	AAAC	23	-	5	TTTG
gi|514486632|gb|KE346360.1|	531075	531088	AAAC	13	-	3	TTGT
gi|514486632|gb|KE346360.1|	531234	531247	A	13	-	13	T
gi|514486632|gb|KE346360.1|	531311	531324	AAGTAC	13	+	2	CAAGTA
gi|514486632|gb|KE346360.1|	531583	531602	A	19	-	19	T
gi|514486632|gb|KE346360.1|	531685	531714	ACATCG	29	+	4	TCGACA
gi|514486632|gb|KE346360.1|	531718	531730	C	12	+	12	C
gi|514486632|gb|KE346360.1|	532401	532414	AAAATC	13	+	2	TCAAAA
gi|514486632|gb|KE346360.1|	532999	533011	AACC	12	-	3	GTTG
gi|514486632|gb|KE346360.1|	533501	533515	AC	14	-	7	GT
gi|514486632|gb|KE346360.1|	534778	534793	AAC	15	+	5	ACA
gi|514486632|gb|KE346360.1|	534989	535003	AAAAAC	14	+	2	AAAACA
gi|514486632|gb|KE346360.1|	535509	535521	ATCATG	12	+	2	TGATCA
gi|514486632|gb|KE346360.1|	535948	535967	AC	19	-	9	GT
gi|514486632|gb|KE346360.1|	535994	536007	AAAAAG	13	+	2	AGAAAA
gi|514486632|gb|KE346360.1|	536009	536021	AGAGGC	12	+	2	AGGCAG
gi|514486632|gb|KE346360.1|	536386	536399	AAGCCG	13	+	2	GAAGCC
gi|514486632|gb|KE346360.1|	536436	536449	AGC	13	-	4	GCT
gi|514486632|gb|KE346360.1|	536617	536629	AGC	12	-	4	TGC
gi|514486632|gb|KE346360.1|	536744	536770	AGC	26	-	8	GCT
gi|514486632|gb|KE346360.1|	537358	537370	AG	12	-	6	TC
gi|514486632|gb|KE346360.1|	537522	537537	A	15	-	15	T
gi|514486632|gb|KE346360.1|	537648	537664	ATCATG	16	+	2	ATCATG
gi|514486632|gb|KE346360.1|	537821	537834	AACC	13	-	3	TGGT
gi|514486632|gb|KE346360.1|	537966	537978	A	12	-	12	T
gi|514486632|gb|KE346360.1|	537985	538002	A	17	-	17	T
gi|514486632|gb|KE346360.1|	538436	538449	AAT	13	-	4	TTA
gi|514486632|gb|KE346360.1|	538643	538660	A	17	-	17	T
gi|514486632|gb|KE346360.1|	538656	538670	AAAAC	14	-	2	TTTTG
gi|514486632|gb|KE346360.1|	538708	538720	AACGGC	12	+	2	ACGGCA
gi|514486632|gb|KE346360.1|	539168	539180	AACGAG	12	+	2	GAACGA
gi|514486632|gb|KE346360.1|	540432	540444	ACGCTG	12	+	2	GACGCT
gi|514486632|gb|KE346360.1|	540641	540659	AAAAC	18	+	3	AAAAC
gi|514486632|gb|KE346360.1|	540653	540667	AAAC	14	+	3	AACA
gi|514486632|gb|KE346360.1|	540802	540814	A	12	+	12	A
gi|514486632|gb|KE346360.1|	540846	540858	AAAAC	12	+	2	CAAAA
gi|514486632|gb|KE346360.1|	541187	541201	AAC	14	+	4	AAC
gi|514486632|gb|KE346360.1|	541196	541209	AAAAAC	13	+	2	AACAAA
gi|514486632|gb|KE346360.1|	541374	541399	AAC	25	+	8	ACA
gi|514486632|gb|KE346360.1|	541815	541827	ACGGCC	12	-	2	TGGCCG
gi|514486632|gb|KE346360.1|	542659	542675	A	16	+	16	A
gi|514486632|gb|KE346360.1|	542837	542851	AGGATG	14	-	2	TCCTCA
gi|514486632|gb|KE346360.1|	542862	542875	AGGATG	13	-	2	CATCCT
gi|514486632|gb|KE346360.1|	543319	543340	AAAACC	21	-	3	TTTTGG
gi|514486632|gb|KE346360.1|	543459	543473	AGC	14	+	4	AGC
gi|514486632|gb|KE346360.1|	543630	543644	AGATGC	14	+	2	AGATGC
gi|514486632|gb|KE346360.1|	543915	543930	A	15	+	15	A
gi|514486632|gb|KE346360.1|	543931	543944	A	13	+	13	A
gi|514486632|gb|KE346360.1|	544298	544313	AAC	15	-	5	GTT
gi|514486632|gb|KE346360.1|	544646	544658	AATG	12	+	3	ATGA
gi|514486632|gb|KE346360.1|	544658	544673	AC	15	-	7	GT
gi|514486632|gb|KE346360.1|	544686	544700	ACTC	14	-	3	GAGT
gi|514486632|gb|KE346360.1|	544756	544778	A	22	+	22	A
gi|514486632|gb|KE346360.1|	545069	545082	ACTGGC	13	-	2	GTGCCA
gi|514486632|gb|KE346360.1|	545710	545722	ACTGCC	12	+	2	CACTGC
gi|514486632|gb|KE346360.1|	547806	547818	AAGTC	12	-	2	TTGAC
gi|514486632|gb|KE346360.1|	549665	549677	CCG	12	+	4	CCG
gi|514486632|gb|KE346360.1|	550493	550570	AGG	77	-	25	CTC
gi|514486632|gb|KE346360.1|	551184	551198	ATCGCC	14	+	2	TCGCCA
gi|514486632|gb|KE346360.1|	551302	551314	AGC	12	-	4	TGC
gi|514486632|gb|KE346360.1|	551661	551676	ACGGCG	15	+	2	GACGGC
gi|514486632|gb|KE346360.1|	551915	551932	AACGAC	17	-	2	GTCGTT
gi|514486632|gb|KE346360.1|	552170	552189	ACG	19	+	6	CGA
gi|514486632|gb|KE346360.1|	552200	552212	AAGAGC	12	-	2	CTTGCT
gi|514486632|gb|KE346360.1|	552281	552301	ACG	20	+	6	CGA
gi|514486632|gb|KE346360.1|	552442	552454	AAAAGG	12	+	2	AAAGGA
gi|514486632|gb|KE346360.1|	552582	552596	ACTGAG	14	-	2	CTCAGT
gi|514486632|gb|KE346360.1|	552843	552856	ACTGCT	13	+	2	CTGCTA
gi|514486632|gb|KE346360.1|	552901	552919	ACG	18	-	6	GTC
gi|514486632|gb|KE346360.1|	553084	553097	ACTGGC	13	-	2	TGCCAG
gi|514486632|gb|KE346360.1|	553591	553604	A	13	-	13	T
gi|514486632|gb|KE346360.1|	553601	553613	AAAC	12	-	3	TTTG
gi|514486632|gb|KE346360.1|	554192	554230	AAC	38	+	12	AAC
gi|514486632|gb|KE346360.1|	554428	554440	AC	12	+	6	AC
gi|514486632|gb|KE346360.1|	555071	555083	AAAAAG	12	+	2	GAAAAA
gi|514486632|gb|KE346360.1|	555078	555091	A	13	+	13	A
gi|514486632|gb|KE346360.1|	557123	557135	AGCCCG	12	-	2	CTCGGG
gi|514486632|gb|KE346360.1|	557298	557313	AGG	15	-	5	CTC
gi|514486632|gb|KE346360.1|	557333	557347	AAGCTG	14	-	2	GCTTCA
gi|514486632|gb|KE346360.1|	557817	557835	AG	18	-	9	TC
gi|514486632|gb|KE346360.1|	557977	557999	AAC	22	+	7	CAA
gi|514486632|gb|KE346360.1|	557995	558010	AACGTC	15	+	2	CAACGT
gi|514486632|gb|KE346360.1|	558105	558135	A	30	-	30	T
gi|514486632|gb|KE346360.1|	558314	558328	A	14	-	14	T
gi|514486632|gb|KE346360.1|	559313	559327	ACTG	14	+	3	CTGA
gi|514486632|gb|KE346360.1|	559911	559923	AGAGC	12	+	2	CAGAG
gi|514486632|gb|KE346360.1|	560054	560066	AAGTAC	12	+	2	TACAAG
gi|514486632|gb|KE346360.1|	560277	560289	AAAAAC	12	+	2	AAAAAC
gi|514486632|gb|KE346360.1|	560289	560304	AAAAC	15	+	3	CAAAA
gi|514486632|gb|KE346360.1|	560306	560321	AAAAC	15	+	3	CAAAA
gi|514486632|gb|KE346360.1|	560315	560331	AAAAAC	16	+	2	ACAAAA
gi|514486632|gb|KE346360.1|	560654	560672	ACACGG	18	-	3	TGTCCG
gi|514486632|gb|KE346360.1|	560894	560906	ACGGCC	12	-	2	CGTGGC
gi|514486632|gb|KE346360.1|	561543	561555	AGC	12	+	4	AGC
gi|514486632|gb|KE346360.1|	562059	562071	AAAGGC	12	+	2	GGCAAA
gi|514486632|gb|KE346360.1|	562617	562671	AC	54	-	27	TG
gi|514486632|gb|KE346360.1|	562862	562874	AAAAAC	12	-	2	TTTGTT
gi|514486632|gb|KE346360.1|	562985	563005	A	20	-	20	T
gi|514486632|gb|KE346360.1|	563220	563232	ACTC	12	-	3	GAGT
gi|514486632|gb|KE346360.1|	563354	563367	ACTCTC	13	+	2	CTCACT
gi|514486632|gb|KE346360.1|	563361	563375	ACTC	14	+	3	TCAC
gi|514486632|gb|KE346360.1|	563539	563553	ACG	14	+	4	GAC
gi|514486632|gb|KE346360.1|	563565	563578	ATC	13	+	4	ATC
gi|514486632|gb|KE346360.1|	563649	563665	A	16	+	16	A
gi|514486632|gb|KE346360.1|	563666	563682	A	16	+	16	A
gi|514486632|gb|KE346360.1|	564167	564179	AGGGGG	12	-	2	CCCCTC
gi|514486632|gb|KE346360.1|	565806	565823	AAAAAC	17	+	2	AAAAAC
gi|514486632|gb|KE346360.1|	566685	566697	AAC	12	+	4	CAA
gi|514486632|gb|KE346360.1|	567512	567527	AAGAG	15	+	3	AGAGA
gi|514486632|gb|KE346360.1|	567636	567658	ACTCC	22	+	4	CACTC
gi|514486632|gb|KE346360.1|	567677	567691	ACACGT	14	-	2	GTACGT
gi|514486632|gb|KE346360.1|	567822	567834	AGC	12	-	4	CTG
gi|514486632|gb|KE346360.1|	567835	567850	AGC	15	-	5	TGC
gi|514486632|gb|KE346360.1|	568007	568022	AACAGC	15	+	2	GCAACA
gi|514486632|gb|KE346360.1|	568062	568077	AGC	15	+	5	CAG
gi|514486632|gb|KE346360.1|	568184	568196	ACCAGC	12	+	2	GCACCA
gi|514486632|gb|KE346360.1|	568198	568217	ACCAGC	19	+	3	ACCAGC
gi|514486632|gb|KE346360.1|	568411	568433	AGC	22	-	7	CTG
gi|514486632|gb|KE346360.1|	568544	568556	ACCTCC	12	+	2	CTCCAC
gi|514486632|gb|KE346360.1|	569058	569075	AGCGAT	17	-	2	ATCGCT
gi|514486632|gb|KE346360.1|	569137	569149	AAC	12	-	4	GTT
gi|514486632|gb|KE346360.1|	570763	570782	A	19	+	19	A
gi|514486632|gb|KE346360.1|	571289	571302	AATCTC	13	-	2	GAGATT
gi|514486632|gb|KE346360.1|	572417	572431	AAGGCG	14	-	2	CGCCTT
gi|514486632|gb|KE346360.1|	573276	573314	AAC	38	-	12	TTG
gi|514486632|gb|KE346360.1|	573309	573323	AAAAC	14	-	2	TTGTT
gi|514486632|gb|KE346360.1|	573594	573619	AAG	25	-	8	CTT
gi|514486632|gb|KE346360.1|	573726	573738	AACAAG	12	+	2	AACAAG
gi|514486632|gb|KE346360.1|	573933	573948	A	15	-	15	T
gi|514486632|gb|KE346360.1|	574699	574711	A	12	-	12	T
gi|514486632|gb|KE346360.1|	574712	574724	A	12	-	12	T
gi|514486632|gb|KE346360.1|	575280	575303	A	23	-	23	T
gi|514486632|gb|KE346360.1|	575379	575391	AAAAC	12	+	2	AACAA
gi|514486632|gb|KE346360.1|	576257	576269	ACTCAG	12	-	2	GTCTGA
gi|514486632|gb|KE346360.1|	576856	576873	A	17	-	17	T
gi|514486632|gb|KE346360.1|	577093	577105	ACCAGC	12	+	2	CACCAG
gi|514486632|gb|KE346360.1|	577291	577306	AGGGGG	15	+	2	GGGAGG
gi|514486632|gb|KE346360.1|	577412	577434	A	22	+	22	A
gi|514486632|gb|KE346360.1|	577478	577493	AAAAG	15	-	3	TTTTC
gi|514486632|gb|KE346360.1|	577644	577661	A	17	-	17	T
gi|514486632|gb|KE346360.1|	578018	578036	A	18	+	18	A
gi|514486632|gb|KE346360.1|	578225	578238	A	13	-	13	T
gi|514486632|gb|KE346360.1|	578376	578390	ACCAGC	14	-	2	TGCTGG
gi|514486632|gb|KE346360.1|	578503	578520	A	17	+	17	A
gi|514486632|gb|KE346360.1|	578887	578899	AAC	12	+	4	CAA
gi|514486632|gb|KE346360.1|	579039	579053	AAAAC	14	-	2	TTTTG
gi|514486632|gb|KE346360.1|	579047	579060	AAAAAC	13	-	2	TGTTTT
gi|514486632|gb|KE346360.1|	579174	579193	AC	19	+	9	CA
gi|514486632|gb|KE346360.1|	579656	579673	AG	17	+	8	GA
gi|514486632|gb|KE346360.1|	579675	579688	AGAGCG	13	+	2	CGAGAG
gi|514486632|gb|KE346360.1|	580760	580773	AGGGG	13	-	2	CTCCC
gi|514486632|gb|KE346360.1|	580970	580984	ACGAT	14	+	2	TACGA
gi|514486632|gb|KE346360.1|	581488	581501	ACCCCC	13	-	2	GGGGGT
gi|514486632|gb|KE346360.1|	581658	581674	ATCGCC	16	-	2	GGCGAT
gi|514486632|gb|KE346360.1|	581845	581870	AAAC	25	-	6	GTTT
gi|514486632|gb|KE346360.1|	582350	582379	AGCCCG	29	-	4	GGCTCG
gi|514486632|gb|KE346360.1|	582410	582424	AGG	14	+	4	GAG
gi|514486632|gb|KE346360.1|	583173	583186	AAAC	13	+	3	AACA
gi|514486632|gb|KE346360.1|	583773	583787	AAC	14	-	4	TTG
gi|514486632|gb|KE346360.1|	583846	583865	A	19	-	19	T
gi|514486632|gb|KE346360.1|	584086	584107	A	21	-	21	T
gi|514486632|gb|KE346360.1|	584140	584162	A	22	-	22	T
gi|514486632|gb|KE346360.1|	584180	584206	A	26	-	26	T
gi|514486632|gb|KE346360.1|	584202	584215	AAAAC	13	-	2	TTTTG
gi|514486632|gb|KE346360.1|	584566	584583	AGC	17	-	5	CTG
gi|514486632|gb|KE346360.1|	584615	584635	ACCGCC	20	-	3	CGGTGG
gi|514486632|gb|KE346360.1|	584630	584647	AGCGCC	17	-	2	TGGCGC
gi|514486632|gb|KE346360.1|	584653	584666	ATC	13	+	4	CAT
gi|514486632|gb|KE346360.1|	585783	585795	ATC	12	+	4	CAT
gi|514486632|gb|KE346360.1|	586046	586058	ACCATG	12	+	2	GACCAT
gi|514486632|gb|KE346360.1|	586607	586619	AATCAG	12	+	2	TCAGAA
gi|514486632|gb|KE346360.1|	586651	586667	AGC	16	-	5	CTG
gi|514486632|gb|KE346360.1|	586662	586674	AGCGGC	12	-	2	GCTGCC
gi|514486632|gb|KE346360.1|	587088	587108	AAAAC	20	+	4	AAAAC
gi|514486632|gb|KE346360.1|	587417	587431	ACTCGG	14	-	2	TCCGAG
gi|514486632|gb|KE346360.1|	587560	587572	AAGGAG	12	-	2	CTCCTT
gi|514486632|gb|KE346360.1|	588741	588758	AGC	17	-	5	GCT
gi|514486632|gb|KE346360.1|	588841	588857	ATCGGC	16	+	2	CATCGG
gi|514486632|gb|KE346360.1|	588968	588982	AATGTC	14	+	2	GTCAAT
gi|514486632|gb|KE346360.1|	589682	589707	AAC	25	-	8	GTT
gi|514486632|gb|KE346360.1|	589786	589799	AACCGC	13	-	2	TTGCGG
gi|514486632|gb|KE346360.1|	589922	589935	AAGGAC	13	-	2	GTCCTT
gi|514486632|gb|KE346360.1|	590274	590290	ACG	16	-	5	GTC
gi|514486632|gb|KE346360.1|	590302	590315	AAC	13	-	4	TTG
gi|514486632|gb|KE346360.1|	590332	590345	AAAAAC	13	-	2	TTTTTG
gi|514486632|gb|KE346360.1|	590547	590564	AAT	17	+	5	AAT
gi|514486632|gb|KE346360.1|	591965	591977	ACTCAG	12	-	2	CTGAGT
gi|514486632|gb|KE346360.1|	592038	592050	AAAAAT	12	-	2	TTTATT
gi|514486632|gb|KE346360.1|	592217	592240	A	23	-	23	T
gi|514486632|gb|KE346360.1|	592355	592377	ATC	22	+	7	ATC
gi|514486632|gb|KE346360.1|	592423	592437	AAAAAG	14	-	2	TTCTTT
gi|514486632|gb|KE346360.1|	592456	592485	AAAAT	29	-	5	TTTTA
gi|514486632|gb|KE346360.1|	592652	592667	A	15	+	15	A
gi|514486632|gb|KE346360.1|	592825	592840	A	15	+	15	A
gi|514486632|gb|KE346360.1|	592914	592941	AGC	27	+	9	GCA
gi|514486632|gb|KE346360.1|	593065	593077	AAAGC	12	-	2	GCTTT
gi|514486632|gb|KE346360.1|	593183	593197	A	14	-	14	T
gi|514486632|gb|KE346360.1|	593737	593756	A	19	-	19	T
gi|514486632|gb|KE346360.1|	593898	593938	A	40	-	40	T
gi|514486632|gb|KE346360.1|	594159	594179	A	20	+	20	A
gi|514486632|gb|KE346360.1|	595127	595139	AACAC	12	+	2	ACACA
gi|514486632|gb|KE346360.1|	596013	596026	AAACAG	13	-	2	CTGTTT
gi|514486632|gb|KE346360.1|	596261	596281	A	20	-	20	T
gi|514486632|gb|KE346360.1|	596870	596891	AAAC	21	+	5	ACAA
gi|514486632|gb|KE346360.1|	598537	598551	ACATGG	14	+	2	TGGACA
gi|514486632|gb|KE346360.1|	598970	598982	ACGCCG	12	-	2	GTCGGC
gi|514486632|gb|KE346360.1|	599993	600016	A	23	+	23	A
gi|514486632|gb|KE346360.1|	600075	600087	AAT	12	+	4	AAT
gi|514486632|gb|KE346360.1|	600760	600772	A	12	-	12	T
gi|514486632|gb|KE346360.1|	600774	600787	A	13	-	13	T
gi|514486632|gb|KE346360.1|	600829	600841	C	12	+	12	C
gi|514486632|gb|KE346360.1|	600985	601006	A	21	+	21	A
gi|514486632|gb|KE346360.1|	601019	601037	A	18	+	18	A
gi|514486632|gb|KE346360.1|	603337	603354	A	17	+	17	A
gi|514486632|gb|KE346360.1|	603480	603494	A	14	-	14	T
gi|514486632|gb|KE346360.1|	603496	603513	A	17	-	17	T
gi|514486632|gb|KE346360.1|	603551	603563	AACGCG	12	-	2	TTCGCG
gi|514486632|gb|KE346360.1|	603730	603742	AATGTC	12	-	2	ACATTG
gi|514486632|gb|KE346360.1|	604054	604066	AAAAAC	12	+	2	CAAAAA
gi|514486632|gb|KE346360.1|	604108	604136	A	28	-	28	T
gi|514486632|gb|KE346360.1|	604501	604516	ACGAGG	15	+	2	GAGGAC
gi|514486632|gb|KE346360.1|	605085	605098	ATC	13	-	4	GAT
gi|514486632|gb|KE346360.1|	605109	605122	ACGATG	13	+	2	GACGAT
gi|514486632|gb|KE346360.1|	605836	605849	ACGATG	13	+	2	ATGACG
gi|514486632|gb|KE346360.1|	606974	606988	AAC	14	-	4	TGT
gi|514486632|gb|KE346360.1|	607624	607639	AAAAAC	15	+	2	AAAACA
gi|514486632|gb|KE346360.1|	608073	608086	AAGCC	13	-	2	TGGCT
gi|514486632|gb|KE346360.1|	608200	608217	AGC	17	-	5	CTG
gi|514486632|gb|KE346360.1|	608425	608438	AAATCC	13	+	2	AAATCC
gi|514486632|gb|KE346360.1|	608844	608857	AGCAGG	13	-	2	CTGCTC
gi|514486632|gb|KE346360.1|	608870	608882	ACG	12	+	4	ACG
gi|514486632|gb|KE346360.1|	608977	608995	ACG	18	-	6	GTC
gi|514486632|gb|KE346360.1|	609213	609225	ATCGGC	12	-	2	TGCCGA
gi|514486632|gb|KE346360.1|	609376	609388	AAAGCC	12	+	2	AAAGCC
gi|514486632|gb|KE346360.1|	610179	610191	AACAGC	12	-	2	TGTTGC
gi|514486632|gb|KE346360.1|	610911	610923	AAACC	12	-	2	TTGGT
gi|514486632|gb|KE346360.1|	611489	611506	ACG	17	+	5	GAC
gi|514486632|gb|KE346360.1|	611504	611521	ATC	17	-	5	GAT
gi|514486632|gb|KE346360.1|	611899	611911	ACG	12	+	4	CGA
gi|514486632|gb|KE346360.1|	612680	612692	AAAACG	12	-	2	TTCGTT
gi|514486632|gb|KE346360.1|	612880	612892	AAGAGC	12	-	2	TCTTGC
gi|514486632|gb|KE346360.1|	613019	613057	AAAAC	38	-	7	TTTTG
gi|514486632|gb|KE346360.1|	613088	613100	AAACAC	12	-	2	TGTTTG
gi|514486632|gb|KE346360.1|	613218	613236	AAG	18	-	6	TTC
gi|514486632|gb|KE346360.1|	613345	613368	AG	23	-	11	TC
gi|514486632|gb|KE346360.1|	613472	613498	A	26	-	26	T
gi|514486632|gb|KE346360.1|	613662	613682	A	20	-	20	T
gi|514486632|gb|KE346360.1|	613762	613785	AATG	23	-	5	ATTC
gi|514486632|gb|KE346360.1|	613855	613867	A	12	-	12	T
gi|514486632|gb|KE346360.1|	613868	613880	A	12	-	12	T
gi|514486632|gb|KE346360.1|	614693	614710	ACGGGG	17	-	2	CCCCGT
gi|514486632|gb|KE346360.1|	614997	615010	AC	13	-	6	TG
gi|514486632|gb|KE346360.1|	615016	615032	A	16	-	16	T
gi|514486632|gb|KE346360.1|	615172	615186	AAAAAC	14	-	2	TTGTTT
gi|514486632|gb|KE346360.1|	615519	615536	A	17	-	17	T
gi|514486632|gb|KE346360.1|	615533	615548	AAAC	15	-	3	TTTG
gi|514486632|gb|KE346360.1|	616544	616567	A	23	-	23	T
gi|514486632|gb|KE346360.1|	617004	617016	ACTCCG	12	+	2	TCCGAC
gi|514486632|gb|KE346360.1|	617078	617090	AACCG	12	+	2	GAACC
gi|514486632|gb|KE346360.1|	617094	617106	AAAAAG	12	-	2	TTTTTC
gi|514486632|gb|KE346360.1|	617201	617217	AGGGGG	16	-	2	CCCCTC
gi|514486632|gb|KE346360.1|	617261	617273	AG	12	-	6	TC
gi|514486632|gb|KE346360.1|	617309	617331	A	22	-	22	T
gi|514486632|gb|KE346360.1|	617367	617387	A	20	-	20	T
gi|514486632|gb|KE346360.1|	617559	617577	A	18	-	18	T
gi|514486632|gb|KE346360.1|	617603	617616	A	13	-	13	T
gi|514486632|gb|KE346360.1|	617641	617663	A	22	-	22	T
gi|514486632|gb|KE346360.1|	617682	617694	AAGGAG	12	-	2	CCTTCT
gi|514486632|gb|KE346360.1|	618017	618035	AAC	18	+	6	CAA
gi|514486632|gb|KE346360.1|	618167	618179	AACAGC	12	+	2	ACAGCA
gi|514486632|gb|KE346360.1|	618174	618190	ACCAGC	16	+	2	CAGCAC
gi|514486632|gb|KE346360.1|	618521	618533	ATCCCC	12	+	2	CATCCC
gi|514486632|gb|KE346360.1|	618549	618561	AATGGG	12	-	2	ATTCCC
gi|514486632|gb|KE346360.1|	618651	618668	ACCAGC	17	+	2	CAGCAC
gi|514486632|gb|KE346360.1|	618666	618679	AAC	13	+	4	CAA
gi|514486632|gb|KE346360.1|	619235	619248	ACGCGG	13	-	2	CCGCGT
gi|514486632|gb|KE346360.1|	620816	620829	AAAAC	13	-	2	TGTTT
gi|514486632|gb|KE346360.1|	621015	621028	AAC	13	+	4	CAA
gi|514486632|gb|KE346360.1|	622521	622535	ACGCCC	14	+	2	GCCCAC
gi|514486632|gb|KE346360.1|	623507	623519	AAGGCC	12	-	2	CTTGGC
gi|514486632|gb|KE346360.1|	623831	623843	AACG	12	+	3	CGAA
gi|514486632|gb|KE346360.1|	624112	624124	ACCCCC	12	-	2	GGGGTG
gi|514486632|gb|KE346360.1|	624150	624167	AAAAAT	17	+	2	AAAAAT
gi|514486632|gb|KE346360.1|	626333	626354	A	21	+	21	A
gi|514486632|gb|KE346360.1|	626795	626813	A	18	-	18	T
gi|514486632|gb|KE346360.1|	627457	627477	ACGGCG	20	+	3	CGGCGA
gi|514486632|gb|KE346360.1|	627489	627501	ACGCGG	12	+	2	CGGACG
gi|514486632|gb|KE346360.1|	629510	629524	AAGGCC	14	+	2	GCCAAG
gi|514486632|gb|KE346360.1|	630276	630289	AAAGCC	13	-	2	TTGGCT
gi|514486632|gb|KE346360.1|	631346	631359	A	13	-	13	T
gi|514486632|gb|KE346360.1|	631356	631378	AAAG	22	-	5	TTTC
gi|514486632|gb|KE346360.1|	631463	631476	AC	13	-	6	TG
gi|514486632|gb|KE346360.1|	631628	631641	ACGATG	13	+	2	CGATGA
gi|514486632|gb|KE346360.1|	631663	631676	AGATCG	13	+	2	ATCGAG
gi|514486632|gb|KE346360.1|	631672	631690	ACGGAG	18	+	3	GAGACG
gi|514486632|gb|KE346360.1|	632100	632131	AG	31	+	15	AG
gi|514486632|gb|KE346360.1|	632132	632187	AG	55	+	27	AG
gi|514486632|gb|KE346360.1|	633702	633714	AGCCG	12	-	2	GGCTC
gi|514486632|gb|KE346360.1|	633733	633745	AAACGC	12	+	2	ACGCAA
gi|514486632|gb|KE346360.1|	634029	634042	AATCT	13	-	2	TTAGA
gi|514486632|gb|KE346360.1|	634541	634556	AATGGT	15	+	2	ATGGTA
gi|514486632|gb|KE346360.1|	634642	634654	AAAGTG	12	+	2	GTGAAA
gi|514486632|gb|KE346360.1|	634963	634975	A	12	-	12	T
gi|514486632|gb|KE346360.1|	635218	635240	A	22	+	22	A
gi|514486632|gb|KE346360.1|	635409	635422	ATC	13	+	4	ATC
gi|514486632|gb|KE346360.1|	635474	635486	AATGTC	12	+	2	GTCAAT
gi|514486632|gb|KE346360.1|	635500	635512	AATAG	12	-	2	TTCTA
gi|514486632|gb|KE346360.1|	635652	635666	AG	14	-	7	TC
gi|514486632|gb|KE346360.1|	636165	636177	A	12	-	12	T
gi|514486632|gb|KE346360.1|	636583	636595	AACCGC	12	+	2	GCAACC
gi|514486632|gb|KE346360.1|	637467	637479	ACGAGG	12	+	2	GAGGAC
gi|514486632|gb|KE346360.1|	640194	640206	ACTGCG	12	-	2	CGCAGT
gi|514486632|gb|KE346360.1|	640215	640232	AACCGC	17	-	2	TTGCGG
gi|514486632|gb|KE346360.1|	640420	640453	AGAGCC	33	+	5	CCAGAG
gi|514486632|gb|KE346360.1|	640581	640595	AACTGC	14	+	2	ACTGCA
gi|514486632|gb|KE346360.1|	641727	641755	ATC	28	-	9	GAT
gi|514486632|gb|KE346360.1|	641863	641875	CCGCG	12	+	2	GCGCC
gi|514486632|gb|KE346360.1|	642118	642134	ACCCCC	16	-	2	GGGGGT
gi|514486632|gb|KE346360.1|	642220	642243	ACTGAG	23	-	3	CTCAGT
gi|514486632|gb|KE346360.1|	642304	642317	A	13	-	13	T
gi|514486632|gb|KE346360.1|	642359	642374	AG	15	-	7	CT
gi|514486632|gb|KE346360.1|	642379	642392	AG	13	-	6	TC
gi|514486632|gb|KE346360.1|	642533	642547	AGC	14	-	4	CTG
gi|514486632|gb|KE346360.1|	642691	642704	AGAGG	13	-	2	TCCTC
gi|514486632|gb|KE346360.1|	642784	642798	AGGGGG	14	-	2	CCCCCT
gi|514486632|gb|KE346360.1|	643195	643208	AGCGCG	13	-	2	GCGCTC
gi|514486632|gb|KE346360.1|	643591	643603	AAAAAC	12	-	2	TTGTTT
gi|514486632|gb|KE346360.1|	644002	644014	ACGC	12	-	3	GCGT
gi|514486632|gb|KE346360.1|	645870	645882	AAATGC	12	-	2	CATTTG
gi|514486632|gb|KE346360.1|	645897	645913	ACCTGC	16	+	2	CTGCAC
gi|514486632|gb|KE346360.1|	645963	645986	AACTGC	23	+	3	CTGCAA
gi|514486632|gb|KE346360.1|	646326	646338	AAATGC	12	-	2	CATTTG
gi|514486632|gb|KE346360.1|	646353	646369	ACCTGC	16	+	2	CTGCAC
gi|514486632|gb|KE346360.1|	646382	646399	ACCTGC	17	+	2	CCTGCA
gi|514486632|gb|KE346360.1|	646400	646430	ACCTGC	30	+	5	CCTGCA
gi|514486632|gb|KE346360.1|	646737	646749	AAATGC	12	-	2	CATTTG
gi|514486632|gb|KE346360.1|	646764	646780	ACCTGC	16	+	2	CTGCAC
gi|514486632|gb|KE346360.1|	646793	646810	ACCTGC	17	+	2	CCTGCA
gi|514486632|gb|KE346360.1|	646818	646835	AACTGC	17	+	2	CTGCAA
gi|514486632|gb|KE346360.1|	646830	646864	ACCTGC	34	+	5	CTGCAC
gi|514486632|gb|KE346360.1|	647154	647166	AAATGC	12	-	2	CATTTG
gi|514486632|gb|KE346360.1|	647856	647881	ACC	25	+	8	CCA
gi|514486632|gb|KE346360.1|	651996	652015	AGC	19	+	6	GCA
gi|514486632|gb|KE346360.1|	652822	652837	AAGAT	15	+	3	TAAGA
gi|514486632|gb|KE346360.1|	653028	653042	AGCGGC	14	+	2	GCGGCA
gi|514486632|gb|KE346360.1|	653049	653063	AGC	14	+	4	GCA
gi|514486632|gb|KE346360.1|	653067	653086	AGC	19	+	6	GCA
gi|514486632|gb|KE346360.1|	653130	653147	AATGGG	17	-	2	CCATTC
gi|514486632|gb|KE346360.1|	653203	653215	ATCGCC	12	-	2	CGATGG
gi|514486632|gb|KE346360.1|	653221	653234	ACC	13	-	4	TGG
gi|514486632|gb|KE346360.1|	653407	653421	ACCAGC	14	+	2	CACCAG
gi|514486632|gb|KE346360.1|	653438	653450	CCG	12	+	4	GCC
gi|514486632|gb|KE346360.1|	653547	653567	AACATC	20	-	3	TGTTGA
gi|514486632|gb|KE346360.1|	653645	653657	ACG	12	-	4	GTC
gi|514486632|gb|KE346360.1|	654249	654263	AAC	14	+	4	CAA
gi|514486632|gb|KE346360.1|	654270	654284	AACATC	14	+	2	CATCAA
gi|514486632|gb|KE346360.1|	654279	654293	AACAGC	14	+	2	CAACAG
gi|514486632|gb|KE346360.1|	654404	654417	ACTC	13	+	3	ACTC
gi|514486632|gb|KE346360.1|	654422	654438	ACACAT	16	-	2	GTGTAT
gi|514486632|gb|KE346360.1|	654433	654449	AC	16	-	8	TG
gi|514486632|gb|KE346360.1|	654810	654823	AAAAAC	13	-	2	TTTGTT
gi|514486632|gb|KE346360.1|	654817	654829	AAAC	12	-	3	TTGT
gi|514486632|gb|KE346360.1|	655271	655283	AACGAC	12	+	2	ACGACA
gi|514486632|gb|KE346360.1|	656509	656521	AAGC	12	+	3	AGCA
gi|514486632|gb|KE346360.1|	657117	657132	ACCGCC	15	+	2	CACCGC
gi|514486632|gb|KE346360.1|	657157	657174	ACAGCC	17	+	2	GCCACA
gi|514486632|gb|KE346360.1|	657171	657184	ACCAGC	13	+	2	CACCAG
gi|514486632|gb|KE346360.1|	657206	657237	AAC	31	+	10	ACA
gi|514486632|gb|KE346360.1|	659220	659234	AAC	14	+	4	AAC
gi|514486632|gb|KE346360.1|	659229	659247	AAAC	18	+	4	AACA
gi|514486632|gb|KE346360.1|	660680	660696	AAC	16	+	5	ACA
gi|514486632|gb|KE346360.1|	661811	661830	AAAAC	19	+	3	AAAAC
gi|514486632|gb|KE346360.1|	661835	661847	AACAGC	12	+	2	CAACAG
gi|514486632|gb|KE346360.1|	662584	662598	AAG	14	-	4	TTC
gi|514486632|gb|KE346360.1|	662599	662611	AAGACG	12	-	2	TCGTCT
gi|514486632|gb|KE346360.1|	663737	663753	ACCCC	16	-	3	GGGGT
gi|514486632|gb|KE346360.1|	663804	663819	AAAC	15	+	3	AAAC
gi|514486632|gb|KE346360.1|	663968	663980	AACAAG	12	-	2	CTTGTT
gi|514486632|gb|KE346360.1|	664316	664331	AC	15	+	7	AC
gi|514486632|gb|KE346360.1|	664454	664466	AAAAAC	12	-	2	TTTTTG
gi|514486632|gb|KE346360.1|	664470	664482	AATAG	12	-	2	TTCTA
gi|514486632|gb|KE346360.1|	664814	664834	A	20	-	20	T
gi|514486632|gb|KE346360.1|	665177	665194	AAG	17	+	5	AAG
gi|514486632|gb|KE346360.1|	665203	665215	A	12	+	12	A
gi|514486632|gb|KE346360.1|	665224	665239	AATG	15	-	3	TCAT
gi|514486632|gb|KE346360.1|	665253	665270	AAGC	17	+	4	AGCA
gi|514486632|gb|KE346360.1|	665686	665709	AATCTG	23	-	3	TCAGAT
gi|514486632|gb|KE346360.1|	665756	665768	ACGCGC	12	-	2	GCGTGC
gi|514486632|gb|KE346360.1|	667156	667169	AC	13	+	6	AC
gi|514486632|gb|KE346360.1|	667170	667187	AC	17	+	8	AC
gi|514486632|gb|KE346360.1|	668066	668078	AAAC	12	-	3	GTTT
gi|514486632|gb|KE346360.1|	668247	668259	A	12	-	12	T
gi|514486632|gb|KE346360.1|	668673	668685	AC	12	-	6	TG
gi|514486632|gb|KE346360.1|	669163	669180	AAG	17	+	5	GAA
gi|514486632|gb|KE346360.1|	669252	669265	AACTGG	13	+	2	GAACTG
gi|514486632|gb|KE346360.1|	669498	669510	AAAAC	12	+	2	AACAA
gi|514486632|gb|KE346360.1|	669504	669517	AAAAAC	13	+	2	ACAAAA
gi|514486632|gb|KE346360.1|	670149	670161	AGC	12	+	4	CAG
gi|514486632|gb|KE346360.1|	670552	670590	ACCAGG	38	+	6	ACCAGG
gi|514486632|gb|KE346360.1|	670681	670695	AAATGC	14	-	2	TTTGCA
gi|514486632|gb|KE346360.1|	671774	671787	AAAGAG	13	+	2	AGAAAG
gi|514486632|gb|KE346360.1|	671781	671796	AAAG	15	+	3	GAAA
gi|514486632|gb|KE346360.1|	672077	672097	AGATGG	20	-	3	CATCTC
gi|514486632|gb|KE346360.1|	672335	672347	ACGATG	12	-	2	TCGTCA
gi|514486632|gb|KE346360.1|	672570	672586	AAC	16	+	5	CAA
gi|514486632|gb|KE346360.1|	672581	672598	AACCAC	17	+	2	ACAACC
gi|514486632|gb|KE346360.1|	672791	672819	ACCAGC	28	+	4	CACCAG
gi|514486632|gb|KE346360.1|	673247	673263	CCG	16	+	5	GCC
gi|514486632|gb|KE346360.1|	673787	673804	AACAGC	17	+	2	CAGCAA
gi|514486632|gb|KE346360.1|	673928	673945	AGC	17	+	5	CAG
gi|514486632|gb|KE346360.1|	673957	673971	ACC	14	+	4	ACC
gi|514486632|gb|KE346360.1|	674000	674017	AACAGC	17	+	2	CAACAG
gi|514486632|gb|KE346360.1|	674601	674613	AGGCC	12	-	2	CTGGC
gi|514486632|gb|KE346360.1|	674850	674862	ACGCGC	12	+	2	GCACGC
gi|514486632|gb|KE346360.1|	675311	675325	AAAAG	14	+	2	AAAAG
gi|514486632|gb|KE346360.1|	675428	675446	AAC	18	+	6	AAC
gi|514486632|gb|KE346360.1|	675465	675480	A	15	+	15	A
gi|514486632|gb|KE346360.1|	675664	675676	ACGAGC	12	-	2	GCTCGT
gi|514486632|gb|KE346360.1|	675823	675835	AGCTGC	12	+	2	GCAGCT
gi|514486632|gb|KE346360.1|	676866	676878	AAGCTC	12	-	2	GCTTGA
gi|514486632|gb|KE346360.1|	677187	677207	AACGC	20	+	4	ACGCA
gi|514486632|gb|KE346360.1|	677206	677222	AAAC	16	+	4	ACAA
gi|514486632|gb|KE346360.1|	677835	677855	A	20	+	20	A
gi|514486632|gb|KE346360.1|	678058	678070	AAAC	12	+	3	CAAA
gi|514486632|gb|KE346360.1|	678067	678089	A	22	+	22	A
gi|514486632|gb|KE346360.1|	678133	678145	AAAAAC	12	+	2	CAAAAA
gi|514486632|gb|KE346360.1|	678148	678162	AAAAAT	14	+	2	AAAAAT
gi|514486632|gb|KE346360.1|	678288	678301	AAGGG	13	-	2	CCCTT
gi|514486632|gb|KE346360.1|	678301	678320	ATC	19	+	6	CAT
gi|514486632|gb|KE346360.1|	678334	678360	A	26	+	26	A
gi|514486632|gb|KE346360.1|	678611	678623	AGAGCG	12	-	2	TCGCTC
gi|514486632|gb|KE346360.1|	678757	678775	AGC	18	-	6	GCT
gi|514486632|gb|KE346360.1|	678836	678860	AG	24	+	12	AG
gi|514486632|gb|KE346360.1|	679124	679137	A	13	+	13	A
gi|514486632|gb|KE346360.1|	679139	679152	A	13	+	13	A
gi|514486632|gb|KE346360.1|	679153	679165	A	12	+	12	A
gi|514486632|gb|KE346360.1|	679332	679345	A	13	+	13	A
gi|514486632|gb|KE346360.1|	679438	679455	A	17	+	17	A
gi|514486632|gb|KE346360.1|	679672	679688	AAAAAC	16	+	2	AAAAAC
gi|514486632|gb|KE346360.1|	680090	680103	AGGC	13	+	3	GCAG
gi|514486632|gb|KE346360.1|	680466	680489	AAAAAC	23	+	3	AAAAAC
gi|514486632|gb|KE346360.1|	681478	681496	AG	18	+	9	GA
gi|514486632|gb|KE346360.1|	682262	682274	AAAAAG	12	+	2	AAAAAG
gi|514486632|gb|KE346360.1|	682603	682619	AGAGAT	16	+	2	GAGATA
gi|514486632|gb|KE346360.1|	682705	682717	AGGG	12	+	3	GAGG
gi|514486632|gb|KE346360.1|	682725	682739	AATGAG	14	+	2	ATGAGA
gi|514486632|gb|KE346360.1|	683006	683018	C	12	-	12	G
gi|514486632|gb|KE346360.1|	684124	684137	A	13	+	13	A
gi|514486632|gb|KE346360.1|	684314	684326	AACAG	12	+	2	AACAG
gi|514486632|gb|KE346360.1|	684326	684341	AG	15	+	7	AG
gi|514486632|gb|KE346360.1|	684340	684353	A	13	+	13	A
gi|514486632|gb|KE346360.1|	684491	684509	A	18	+	18	A
gi|514486632|gb|KE346360.1|	684848	684872	AACG	24	+	6	ACGA
gi|514486632|gb|KE346360.1|	685328	685341	ACCAGC	13	-	2	TGCTGG
gi|514486632|gb|KE346360.1|	685349	685362	AGAGG	13	+	2	GGAGA
gi|514486632|gb|KE346360.1|	685420	685432	AAAAAC	12	-	2	TTTTGT
gi|514486632|gb|KE346360.1|	685578	685594	A	16	-	16	T
gi|514486632|gb|KE346360.1|	685796	685811	A	15	-	15	T
gi|514486632|gb|KE346360.1|	686207	686220	ACGAG	13	-	2	TCGTC
gi|514486632|gb|KE346360.1|	686237	686250	C	13	-	13	G
gi|514486632|gb|KE346360.1|	687636	687653	AGC	17	+	5	GCA
gi|514486632|gb|KE346360.1|	687798	687810	AGCGCC	12	+	2	CGCCAG
gi|514486632|gb|KE346360.1|	688836	688848	AAG	12	+	4	AAG
gi|514486632|gb|KE346360.1|	689464	689476	AAACTC	12	+	2	ACTCAA
gi|514486632|gb|KE346360.1|	690014	690026	ACGAGC	12	+	2	AGCACG
gi|514486632|gb|KE346360.1|	690134	690150	A	16	-	16	T
gi|514486632|gb|KE346360.1|	690149	690163	AC	14	-	7	TG
gi|514486632|gb|KE346360.1|	690257	690269	ACTGCG	12	-	2	TCGCAG
gi|514486632|gb|KE346360.1|	690415	690427	C	12	-	12	G
gi|514486632|gb|KE346360.1|	690503	690528	A	25	-	25	T
gi|514486632|gb|KE346360.1|	690862	690879	A	17	+	17	A
gi|514486632|gb|KE346360.1|	691159	691174	ACGATG	15	+	2	TGACGA
gi|514486632|gb|KE346360.1|	691324	691340	AGC	16	-	5	TGC
gi|514486632|gb|KE346360.1|	693008	693025	AAAAC	17	-	3	TTTGT
gi|514486632|gb|KE346360.1|	693019	693032	AAAC	13	-	3	TTGT
gi|514486632|gb|KE346360.1|	693153	693169	A	16	+	16	A
gi|514486632|gb|KE346360.1|	693371	693384	ATCGCC	13	-	2	GATGGC
gi|514486632|gb|KE346360.1|	694040	694053	AAAACC	13	+	2	CCAAAA
gi|514486632|gb|KE346360.1|	694169	694181	ATCCCG	12	-	2	CGGGAT
gi|514486632|gb|KE346360.1|	694483	694496	ACATCG	13	-	2	GTCGAT
gi|514486632|gb|KE346360.1|	694601	694621	AGC	20	-	6	CTG
gi|514486632|gb|KE346360.1|	695596	695621	ACG	25	-	8	TCG
gi|514486632|gb|KE346360.1|	696310	696326	AAG	16	+	5	GAA
gi|514486632|gb|KE346360.1|	696418	696430	AGC	12	-	4	CTG
gi|514486632|gb|KE346360.1|	696751	696768	AGC	17	-	5	GCT
gi|514486632|gb|KE346360.1|	696874	696891	A	17	+	17	A
gi|514486632|gb|KE346360.1|	696922	696935	A	13	+	13	A
gi|514486632|gb|KE346360.1|	697032	697046	AC	14	-	7	GT
gi|514486632|gb|KE346360.1|	697147	697160	A	13	+	13	A
gi|514486632|gb|KE346360.1|	697257	697273	AACGC	16	+	3	CAACG
gi|514486632|gb|KE346360.1|	698166	698184	ACC	18	-	6	TGG
gi|514486632|gb|KE346360.1|	699510	699522	AAACC	12	-	2	TGGTT
gi|514486632|gb|KE346360.1|	701081	701094	ACGCAG	13	+	2	CAGACG
gi|514486632|gb|KE346360.1|	701406	701422	ATCCCC	16	-	2	TGGGGA
gi|514486632|gb|KE346360.1|	702176	702191	AAAAAC	15	+	2	AAAAAC
gi|514486632|gb|KE346360.1|	702372	702386	AG	14	+	7	AG
gi|514486632|gb|KE346360.1|	702574	702586	AAAAC	12	-	2	TTGTT
gi|514486632|gb|KE346360.1|	702646	702659	AG	13	-	6	TC
gi|514486632|gb|KE346360.1|	702944	702958	A	14	+	14	A
gi|514486632|gb|KE346360.1|	703204	703216	AAAAAC	12	-	2	TTTTTG
gi|514486632|gb|KE346360.1|	703380	703392	AGCGCG	12	-	2	CTCGCG
gi|514486632|gb|KE346360.1|	703598	703611	AAC	13	-	4	TGT
gi|514486632|gb|KE346360.1|	703616	703628	ATCGGC	12	+	2	CATCGG
gi|514486632|gb|KE346360.1|	703679	703695	AAAAAT	16	-	2	ATTTTT
gi|514486632|gb|KE346360.1|	704003	704023	AAGAGG	20	-	3	TCCTCT
gi|514486632|gb|KE346360.1|	704126	704140	AAAAAC	14	-	2	TTGTTT
gi|514486632|gb|KE346360.1|	704443	704457	AC	14	+	7	CA
gi|514486632|gb|KE346360.1|	704706	704718	AGCC	12	-	3	GGCT
gi|514486632|gb|KE346360.1|	704728	704742	AAACTC	14	-	2	GAGTTT
gi|514486632|gb|KE346360.1|	704866	704879	AGGCCG	13	+	2	GCCGAG
gi|514486632|gb|KE346360.1|	706869	706881	AACGGC	12	-	2	GCCGTT
gi|514486632|gb|KE346360.1|	707081	707094	A	13	+	13	A
gi|514486632|gb|KE346360.1|	707381	707398	AAGAGG	17	+	2	GAGGAA
gi|514486632|gb|KE346360.1|	707393	707408	AGG	15	+	5	GAG
gi|514486632|gb|KE346360.1|	707562	707577	A	15	+	15	A
gi|514486632|gb|KE346360.1|	708228	708240	AATG	12	+	3	TGAA
gi|514486632|gb|KE346360.1|	708405	708435	AC	30	+	15	AC
gi|514486632|gb|KE346360.1|	710205	710226	ACGGGC	21	+	3	GGCACG
gi|514486632|gb|KE346360.1|	710680	710692	AAACC	12	-	2	TGGTT
gi|514486632|gb|KE346360.1|	710737	710750	AATAC	13	+	2	CAATA
gi|514486632|gb|KE346360.1|	711105	711117	AAGG	12	+	3	GGAA
gi|514486632|gb|KE346360.1|	711143	711166	A	23	-	23	T
gi|514486632|gb|KE346360.1|	712929	712942	AAC	13	+	4	ACA
gi|514486632|gb|KE346360.1|	713385	713397	A	12	+	12	A
gi|514486632|gb|KE346360.1|	713817	713833	AAGCAC	16	-	2	CTTGTG
gi|514486632|gb|KE346360.1|	714293	714306	AAACC	13	+	2	CAAAC
gi|514486632|gb|KE346360.1|	714730	714742	A	12	+	12	A
gi|514486632|gb|KE346360.1|	714890	714915	A	25	+	25	A
gi|514486632|gb|KE346360.1|	715100	715116	A	16	+	16	A
gi|514486632|gb|KE346360.1|	715162	715178	AACTG	16	+	3	TGAAC
gi|514486632|gb|KE346360.1|	715475	715487	AAAAAC	12	+	2	CAAAAA
gi|514486632|gb|KE346360.1|	716398	716416	A	18	+	18	A
gi|514486632|gb|KE346360.1|	716527	716539	ACC	12	-	4	GGT
gi|514486632|gb|KE346360.1|	716918	716932	ACGG	14	-	3	GTCC
gi|514486632|gb|KE346360.1|	717066	717085	A	19	+	19	A
gi|514486632|gb|KE346360.1|	717112	717130	A	18	+	18	A
gi|514486632|gb|KE346360.1|	717944	717958	AAAAC	14	-	2	TTTTG
gi|514486632|gb|KE346360.1|	717966	717980	A	14	-	14	T
gi|514486632|gb|KE346360.1|	718171	718183	AAAAC	12	-	2	TGTTT
gi|514486632|gb|KE346360.1|	718186	718206	A	20	-	20	T
gi|514486632|gb|KE346360.1|	718697	718715	A	18	-	18	T
gi|514486632|gb|KE346360.1|	718803	718816	AG	13	-	6	CT
gi|514486632|gb|KE346360.1|	718890	718903	A	13	+	13	A
gi|514486632|gb|KE346360.1|	721435	721447	ACGGGG	12	+	2	GGACGG
gi|514486632|gb|KE346360.1|	722284	722296	AC	12	-	6	TG
gi|514486632|gb|KE346360.1|	722301	722321	AC	20	-	10	GT
gi|514486632|gb|KE346360.1|	723270	723282	AGC	12	-	4	CTG
gi|514486632|gb|KE346360.1|	724161	724173	ATGCCC	12	-	2	GGCATG
gi|514486632|gb|KE346360.1|	724271	724283	A	12	-	12	T
gi|514486632|gb|KE346360.1|	724305	724317	AGGGGG	12	-	2	CTCCCC
gi|514486632|gb|KE346360.1|	725381	725415	AAAC	34	+	8	AACA
gi|514486632|gb|KE346360.1|	725409	725421	AAAAAC	12	+	2	AACAAA
gi|514486632|gb|KE346360.1|	725868	725880	ACCGCC	12	+	2	CCGCCA
gi|514486632|gb|KE346360.1|	725905	725922	ACG	17	-	5	CGT
gi|514486632|gb|KE346360.1|	728499	728513	ACC	14	+	4	CCA
gi|514486632|gb|KE346360.1|	729300	729312	AAAATC	12	+	2	AAAATC
gi|514486632|gb|KE346360.1|	730271	730283	A	12	-	12	T
gi|514486632|gb|KE346360.1|	730903	730918	AAAAAC	15	-	2	TTGTTT
gi|514486632|gb|KE346360.1|	731400	731412	AAAATC	12	-	2	TTTGAT
gi|514486632|gb|KE346360.1|	732040	732055	A	15	-	15	T
gi|514486632|gb|KE346360.1|	732095	732107	ATC	12	+	4	CAT
gi|514486632|gb|KE346360.1|	733473	733485	AACTAC	12	+	2	TACAAC
gi|514486632|gb|KE346360.1|	733571	733586	AAAAAC	15	+	2	AAAAAC
gi|514486632|gb|KE346360.1|	734657	734669	ATGCGC	12	+	2	TGCGCA
gi|514486632|gb|KE346360.1|	734678	734691	AAC	13	-	4	GTT
gi|514486632|gb|KE346360.1|	736831	736843	AGGCG	12	+	2	GGCGA
gi|514486632|gb|KE346360.1|	737422	737434	ACATCC	12	+	2	CATCCA
gi|514486632|gb|KE346360.1|	737550	737567	AAC	17	+	5	CAA
gi|514486632|gb|KE346360.1|	738005	738018	AGC	13	-	4	TGC
gi|514486632|gb|KE346360.1|	738840	738871	AGC	31	+	10	AGC
gi|514486632|gb|KE346360.1|	738902	738917	AGC	15	+	5	CAG
gi|514486632|gb|KE346360.1|	739111	739127	AGCGGC	16	+	2	GCAGCG
gi|514486632|gb|KE346360.1|	739122	739134	AGAGGC	12	+	2	GGCAGA
gi|514486632|gb|KE346360.1|	739228	739254	AGC	26	-	8	CTG
gi|514486632|gb|KE346360.1|	739643	739656	ACCAGC	13	-	2	TGCTGG
gi|514486632|gb|KE346360.1|	739660	739672	ACCAGC	12	-	2	GTGCTG
gi|514486632|gb|KE346360.1|	739861	739878	AGC	17	-	5	GCT
gi|514486632|gb|KE346360.1|	739917	739932	CCG	15	-	5	GGC
gi|514486632|gb|KE346360.1|	739996	740022	AGC	26	-	8	TGC
gi|514486632|gb|KE346360.1|	740140	740157	A	17	+	17	A
gi|514486632|gb|KE346360.1|	741647	741660	AACGAC	13	+	2	GACAAC
gi|514486632|gb|KE346360.1|	742177	742189	A	12	-	12	T
gi|514486632|gb|KE346360.1|	742843	742860	AGCTCC	17	-	2	GCTGGA
gi|514486632|gb|KE346360.1|	743276	743292	ACG	16	+	5	ACG
gi|514486632|gb|KE346360.1|	744745	744757	AGCGGG	12	+	2	GAGCGG
gi|514486632|gb|KE346360.1|	745478	745491	ATC	13	+	4	CAT
gi|514486632|gb|KE346360.1|	745820	745832	ACTGG	12	-	2	CAGTC
gi|514486632|gb|KE346360.1|	747011	747025	AGC	14	+	4	GCA
gi|514486632|gb|KE346360.1|	748087	748109	AACAGC	22	+	3	CAGCAA
gi|514486632|gb|KE346360.1|	748318	748338	AGC	20	+	6	CAG
gi|514486632|gb|KE346360.1|	749108	749121	AGC	13	+	4	AGC
gi|514486632|gb|KE346360.1|	749135	749154	AGC	19	+	6	AGC
gi|514486632|gb|KE346360.1|	749152	749169	AAC	17	+	5	CAA
gi|514486632|gb|KE346360.1|	749167	749190	AGC	23	+	7	CAG
gi|514486632|gb|KE346360.1|	750814	750829	AGC	15	+	5	CAG
gi|514486632|gb|KE346360.1|	751425	751443	AGC	18	+	6	GCA
gi|514486632|gb|KE346360.1|	751700	751712	AATTAC	12	-	2	AATTGT
gi|514486632|gb|KE346360.1|	752077	752091	AGC	14	-	4	GCT
gi|514486632|gb|KE346360.1|	752089	752103	CCG	14	+	4	GCC
gi|514486632|gb|KE346360.1|	752119	752142	ATC	23	+	7	TCA
gi|514486632|gb|KE346360.1|	752357	752371	AAAGCC	14	-	2	TGGCTT
gi|514486632|gb|KE346360.1|	752381	752395	AAAGCC	14	-	2	TTGGCT
gi|514486632|gb|KE346360.1|	752871	752884	A	13	-	13	T
gi|514486632|gb|KE346360.1|	753325	753348	A	23	-	23	T
gi|514486632|gb|KE346360.1|	753556	753568	AAAGAC	12	-	2	CTTTGT
gi|514486632|gb|KE346360.1|	754066	754078	AAAGAC	12	-	2	CTTTGT
gi|514486632|gb|KE346360.1|	754576	754588	AAGGAG	12	-	2	TCCTTC
gi|514486632|gb|KE346360.1|	754615	754627	A	12	-	12	T
gi|514486632|gb|KE346360.1|	754623	754636	AAAAGC	13	-	2	TTTTGC
gi|514486632|gb|KE346360.1|	756568	756593	AGC	25	-	8	CTG
gi|514486632|gb|KE346360.1|	757172	757196	AGC	24	-	8	TGC
gi|514486632|gb|KE346360.1|	758286	758298	ACCTCG	12	-	2	GAGGTC
gi|514486632|gb|KE346360.1|	759095	759113	AACAGC	18	+	3	GCAACA
gi|514486632|gb|KE346360.1|	759114	759137	AACAGC	23	+	3	CAACAG
gi|514486632|gb|KE346360.1|	761411	761423	ATC	12	-	4	TGA
gi|514486632|gb|KE346360.1|	761470	761482	ACG	12	+	4	CGA
gi|514486632|gb|KE346360.1|	761480	761498	ATC	18	-	6	GAT
gi|514486632|gb|KE346360.1|	761926	761941	ACG	15	-	5	GTC
gi|514486632|gb|KE346360.1|	762198	762217	AGC	19	-	6	CTG
gi|514486632|gb|KE346360.1|	763876	763892	AGC	16	-	5	GCT
gi|514486632|gb|KE346360.1|	763967	763986	AGC	19	+	6	AGC
gi|514486632|gb|KE346360.1|	764093	764106	ACGC	13	+	3	GCAC
gi|514486632|gb|KE346360.1|	764510	764525	AAGAGG	15	-	2	TCTTCC
gi|514486632|gb|KE346360.1|	764601	764615	AAGTC	14	-	2	TTGAC
gi|514486632|gb|KE346360.1|	764981	764995	AACTCT	14	+	2	CTCTAA
gi|514486632|gb|KE346360.1|	764999	765019	AG	20	-	10	TC
gi|514486632|gb|KE346360.1|	765275	765287	A	12	-	12	T
gi|514486632|gb|KE346360.1|	765283	765297	AAAAC	14	-	2	TTTTG
gi|514486632|gb|KE346360.1|	765581	765596	A	15	-	15	T
gi|514486632|gb|KE346360.1|	766135	766147	AG	12	+	6	GA
gi|514486632|gb|KE346360.1|	766525	766537	AAGAC	12	+	2	AAGAC
gi|514486632|gb|KE346360.1|	767669	767682	AAAGCG	13	+	2	GCGAAA
gi|514486632|gb|KE346360.1|	767836	767862	A	26	-	26	T
gi|514486632|gb|KE346360.1|	767999	768023	A	24	+	24	A
gi|514486632|gb|KE346360.1|	768304	768316	AGGGGG	12	+	2	GGAGGG
gi|514486632|gb|KE346360.1|	771845	771857	AAAACC	12	+	2	AAAACC
gi|514486632|gb|KE346360.1|	772192	772205	AAACCT	13	+	2	CTAAAC
gi|514486632|gb|KE346360.1|	772975	772989	ACGGCG	14	+	2	CGGCGA
gi|514486632|gb|KE346360.1|	773308	773324	ATC	16	-	5	TGA
gi|514486632|gb|KE346360.1|	773426	773442	ACCCCC	16	+	2	CCCCAC
gi|514486632|gb|KE346360.1|	773879	773893	ACG	14	+	4	GAC
gi|514486632|gb|KE346360.1|	774484	774501	AGGGGG	17	-	2	TCCCCC
gi|514486632|gb|KE346360.1|	775006	775018	CCCCCG	12	+	2	CCGCCC
gi|514486632|gb|KE346360.1|	775219	775240	AC	21	+	10	AC
gi|514486632|gb|KE346360.1|	775246	775261	A	15	+	15	A
gi|514486632|gb|KE346360.1|	776072	776085	AGCTGC	13	+	2	CAGCTG
gi|514486632|gb|KE346360.1|	776809	776821	ACACC	12	-	2	GTGTG
gi|514486632|gb|KE346360.1|	776832	776845	AATC	13	+	3	TCAA
gi|514486632|gb|KE346360.1|	777926	777938	AGCGGC	12	-	2	CCGCTG
gi|514486632|gb|KE346360.1|	778718	778732	AGC	14	-	4	TGC
gi|514486632|gb|KE346360.1|	778727	778741	AACAGC	14	-	2	TGCTGT
gi|514486632|gb|KE346360.1|	778858	778877	AGC	19	+	6	AGC
gi|514486632|gb|KE346360.1|	779055	779068	AGCC	13	-	3	GCTG
gi|514486632|gb|KE346360.1|	779252	779277	A	25	+	25	A
gi|514486632|gb|KE346360.1|	779316	779330	A	14	+	14	A
gi|514486632|gb|KE346360.1|	779393	779405	A	12	+	12	A
gi|514486632|gb|KE346360.1|	779461	779474	A	13	+	13	A
gi|514486632|gb|KE346360.1|	779649	779664	AAAAG	15	+	3	AAAAG
gi|514486632|gb|KE346360.1|	779835	779847	AAAGCC	12	+	2	CCAAAG
gi|514486632|gb|KE346360.1|	780434	780446	ACGAGG	12	+	2	ACGAGG
gi|514486632|gb|KE346360.1|	780499	780511	AGCGCC	12	+	2	GCCAGC
gi|514486632|gb|KE346360.1|	780742	780756	AC	14	+	7	CA
gi|514486632|gb|KE346360.1|	780786	780799	AAAG	13	+	3	AGAA
gi|514486632|gb|KE346360.1|	781340	781352	AAACGC	12	-	2	GTTTGC
gi|514486632|gb|KE346360.1|	782598	782610	AAAAC	12	+	2	AACAA
gi|514486632|gb|KE346360.1|	784809	784832	A	23	+	23	A
gi|514486632|gb|KE346360.1|	785175	785198	A	23	+	23	A
gi|514486632|gb|KE346360.1|	785229	785242	A	13	+	13	A
gi|514486632|gb|KE346360.1|	785392	785409	AG	17	+	8	AG
gi|514486632|gb|KE346360.1|	786158	786176	ACG	18	+	6	GAC
gi|514486632|gb|KE346360.1|	786211	786224	AAAGCC	13	-	2	TGGCTT
gi|514486632|gb|KE346360.1|	787854	787866	AACGCC	12	+	2	ACGCCA
gi|514486632|gb|KE346360.1|	788369	788383	AGCCGC	14	+	2	GCAGCC
gi|514486632|gb|KE346360.1|	788810	788822	AAGCTG	12	-	2	CAGCTT
gi|514486632|gb|KE346360.1|	788940	788959	AACGAC	19	+	3	ACAACG
gi|514486632|gb|KE346360.1|	790062	790079	A	17	-	17	T
gi|514486632|gb|KE346360.1|	790100	790114	A	14	+	14	A
gi|514486632|gb|KE346360.1|	790377	790389	A	12	+	12	A
gi|514486632|gb|KE346360.1|	791081	791094	AAATAC	13	+	2	ACAAAT
gi|514486632|gb|KE346360.1|	793563	793576	AAGGAC	13	-	2	GTCCTT
gi|514486632|gb|KE346360.1|	794718	794730	ACTC	12	-	3	GAGT
gi|514486632|gb|KE346360.1|	794791	794806	ATCGC	15	-	3	GATGC
gi|514486632|gb|KE346360.1|	795109	795135	AGC	26	-	8	GCT
gi|514486632|gb|KE346360.1|	795367	795384	AACCAC	17	+	2	AACCAC
gi|514486632|gb|KE346360.1|	795412	795424	CCGCG	12	-	2	CGCGG
gi|514486632|gb|KE346360.1|	795486	795498	AGGCGG	12	+	2	GGCGGA
gi|514486632|gb|KE346360.1|	797190	797205	ACACGC	15	-	2	TGTGCG
gi|514486632|gb|KE346360.1|	797289	797303	A	14	-	14	T
gi|514486632|gb|KE346360.1|	798335	798348	ACGCGT	13	+	2	ACGCGT
gi|514486632|gb|KE346360.1|	798528	798540	AACAGC	12	-	2	TGCTGT
gi|514486632|gb|KE346360.1|	798916	798929	AGATGC	13	-	2	TGCATC
gi|514486632|gb|KE346360.1|	799454	799467	AAATAG	13	-	2	TCTATT
gi|514486632|gb|KE346360.1|	799679	799693	ACG	14	-	4	CGT
gi|514486632|gb|KE346360.1|	799759	799772	AGCCG	13	-	2	GGCTC
gi|514486632|gb|KE346360.1|	802271	802306	AAC	35	+	11	CAA
gi|514486632|gb|KE346360.1|	802805	802835	A	30	-	30	T
gi|514486632|gb|KE346360.1|	803271	803285	ACG	14	+	4	CGA
gi|514486632|gb|KE346360.1|	803322	803334	ACACTG	12	+	2	TGACAC
gi|514486632|gb|KE346360.1|	803330	803486	AC	156	+	78	AC
gi|514486632|gb|KE346360.1|	803741	803753	AAGCC	12	+	2	CCAAG
gi|514486632|gb|KE346360.1|	805078	805092	AGC	14	+	4	CAG
gi|514486632|gb|KE346360.1|	805268	805280	AACAAG	12	+	2	ACAAGA
gi|514486632|gb|KE346360.1|	807796	807810	AAAAC	14	-	2	GTTTT
gi|514486632|gb|KE346360.1|	808298	808310	ACGCTC	12	+	2	CGCTCA
gi|514486632|gb|KE346360.1|	808585	808600	AAAAC	15	-	3	GTTTT
gi|514486632|gb|KE346360.1|	809263	809276	ACGCTG	13	-	2	GTCAGC
gi|514486632|gb|KE346360.1|	809276	809288	AATGGC	12	-	2	CATTGC
gi|514486632|gb|KE346360.1|	811549	811561	AATGC	12	-	2	TGCAT
gi|514486632|gb|KE346360.1|	812354	812370	ACTCGG	16	+	2	CTCGGA
gi|514486632|gb|KE346360.1|	812459	812471	ACGCGC	12	-	2	GCGTGC
gi|514486632|gb|KE346360.1|	813640	813653	AAAAC	13	+	2	AAAAC
gi|514486632|gb|KE346360.1|	813659	813671	AAAAAC	12	+	2	CAAAAA
gi|514486632|gb|KE346360.1|	813937	813953	AAGAC	16	-	3	GTCTT
gi|514486632|gb|KE346360.1|	814260	814275	C	15	+	15	C
gi|514486632|gb|KE346360.1|	814407	814419	AAC	12	-	4	TTG
gi|514486632|gb|KE346360.1|	814438	814460	AC	22	-	11	TG
gi|514486632|gb|KE346360.1|	814666	814678	AAACG	12	-	2	CGTTT
gi|514486632|gb|KE346360.1|	814755	814767	AACTTG	12	-	2	TCAAGT
gi|514486632|gb|KE346360.1|	816048	816061	A	13	+	13	A
gi|514486632|gb|KE346360.1|	817362	817378	A	16	+	16	A
gi|514486632|gb|KE346360.1|	819315	819330	ACGATG	15	-	2	TCATCG
gi|514486632|gb|KE346360.1|	819501	819522	ACG	21	+	7	GAC
gi|514486632|gb|KE346360.1|	819617	819629	ACCGAG	12	-	2	TCGGTC
gi|514486632|gb|KE346360.1|	819686	819699	AGCATG	13	-	2	CTCATG
gi|514486632|gb|KE346360.1|	820028	820040	AGATCG	12	+	2	TCGAGA
gi|514486632|gb|KE346360.1|	820063	820076	AG	13	+	6	GA
gi|514486632|gb|KE346360.1|	820075	820094	AC	19	-	9	GT
gi|514486632|gb|KE346360.1|	820195	820208	AAGTGC	13	-	2	TGCACT
gi|514486632|gb|KE346360.1|	820288	820300	AGC	12	-	4	CTG
gi|514486632|gb|KE346360.1|	820643	820661	AAC	18	-	6	GTT
gi|514486632|gb|KE346360.1|	820813	820825	AGCGGC	12	-	2	TGCCGC
gi|514486632|gb|KE346360.1|	821204	821216	AGGCCG	12	-	2	CGGCCT
gi|514486632|gb|KE346360.1|	823435	823447	ACGATG	12	-	2	TCGTCA
gi|514486632|gb|KE346360.1|	823513	823527	ACG	14	-	4	GTC
gi|514486632|gb|KE346360.1|	823603	823625	AGAGCC	22	-	3	TGGCTC
gi|514486632|gb|KE346360.1|	823626	823647	AGAGCC	21	-	3	CTGGCT
gi|514486632|gb|KE346360.1|	823786	823799	ACCCTC	13	-	2	GGGTGA
gi|514486632|gb|KE346360.1|	824343	824357	A	14	-	14	T
gi|514486632|gb|KE346360.1|	824359	824374	A	15	-	15	T
gi|514486632|gb|KE346360.1|	824547	824559	AAAC	12	+	3	CAAA
gi|514486632|gb|KE346360.1|	824718	824734	ACG	16	-	5	CGT
gi|514486632|gb|KE346360.1|	824735	824749	ACGATG	14	-	2	TCATCG
gi|514486632|gb|KE346360.1|	824956	824978	AAG	22	-	7	TTC
gi|514486632|gb|KE346360.1|	824973	824986	AAGCAG	13	-	2	CTTCTG
gi|514486632|gb|KE346360.1|	825392	825406	AAC	14	-	4	TGT
gi|514486632|gb|KE346360.1|	825401	825448	AACAGC	47	-	7	TGTTGC
gi|514486632|gb|KE346360.1|	825451	825468	AACAGC	17	-	2	TTGCTG
gi|514486632|gb|KE346360.1|	826442	826455	ATC	13	+	4	ATC
gi|514486632|gb|KE346360.1|	826874	826992	AAC	118	+	39	CAA
gi|514486632|gb|KE346360.1|	827457	827470	ACGCTG	13	-	2	GTCAGC
gi|514486632|gb|KE346360.1|	827707	827720	AATGCG	13	+	2	GAATGC
gi|514486632|gb|KE346360.1|	828284	828298	ACATGC	14	-	2	CATGTG
gi|514486632|gb|KE346360.1|	828711	828723	AGCTCG	12	+	2	GCTCGA
gi|514486632|gb|KE346360.1|	829231	829243	AAACGC	12	+	2	AACGCA
gi|514486632|gb|KE346360.1|	829281	829293	AAGCGG	12	+	2	CGGAAG
gi|514486632|gb|KE346360.1|	829593	829606	ACGCGC	13	-	2	TGCGCG
gi|514486632|gb|KE346360.1|	829843	829855	AAGCGC	12	-	2	GCTTGC
gi|514486632|gb|KE346360.1|	829969	829981	ACCTGC	12	-	2	GCAGGT
gi|514486632|gb|KE346360.1|	830137	830149	ACTG	12	-	3	CAGT
gi|514486632|gb|KE346360.1|	830505	830521	ATC	16	+	5	TCA
gi|514486632|gb|KE346360.1|	830649	830671	A	22	+	22	A
gi|514486632|gb|KE346360.1|	830678	830707	AACG	29	-	7	GTTC
gi|514486632|gb|KE346360.1|	831022	831056	A	34	+	34	A
gi|514486632|gb|KE346360.1|	831146	831159	AAAGAG	13	-	2	TCTTTC
gi|514486632|gb|KE346360.1|	831265	831277	AAACC	12	-	2	TTGGT
gi|514486632|gb|KE346360.1|	831429	831443	AC	14	-	7	TG
gi|514486632|gb|KE346360.1|	832051	832064	AATGG	13	-	2	CATTC
gi|514486632|gb|KE346360.1|	835056	835085	A	29	-	29	T
gi|514486632|gb|KE346360.1|	835150	835163	AAAAC	13	+	2	AAAAC
gi|514486632|gb|KE346360.1|	835417	835430	AAGGCG	13	-	2	GCCTTC
gi|514486632|gb|KE346360.1|	835443	835458	AAGGGC	15	-	2	CTTGCC
gi|514486632|gb|KE346360.1|	835954	835966	AAATCC	12	-	2	TTGGAT
gi|514486632|gb|KE346360.1|	836295	836308	AAGCCC	13	-	2	CTTGGG
gi|514486632|gb|KE346360.1|	837094	837107	ACGATG	13	-	2	TCATCG
gi|514486632|gb|KE346360.1|	837182	837195	ACGGCG	13	-	2	CGTCGC
gi|514486632|gb|KE346360.1|	838100	838112	AGAGCG	12	-	2	CGCTCT
gi|514486632|gb|KE346360.1|	838849	838861	AAGCGC	12	+	2	AAGCGC
gi|514486632|gb|KE346360.1|	840685	840704	A	19	+	19	A
gi|514486632|gb|KE346360.1|	840746	840760	ATCGCC	14	+	2	GCCATC
gi|514486632|gb|KE346360.1|	840899	840916	A	17	+	17	A
gi|514486632|gb|KE346360.1|	841200	841226	A	26	+	26	A
gi|514486632|gb|KE346360.1|	841638	841651	A	13	-	13	T
gi|514486632|gb|KE346360.1|	841719	841731	ACGCAG	12	-	2	TGCGTC
gi|514486632|gb|KE346360.1|	841859	841872	A	13	+	13	A
gi|514486632|gb|KE346360.1|	842014	842028	A	14	-	14	T
gi|514486632|gb|KE346360.1|	842026	842040	AAG	14	-	4	TTC
gi|514486632|gb|KE346360.1|	842084	842096	A	12	-	12	T
gi|514486632|gb|KE346360.1|	842120	842141	A	21	-	21	T
gi|514486632|gb|KE346360.1|	843032	843044	AATGC	12	+	2	CAATG
gi|514486632|gb|KE346360.1|	845079	845091	AACGTG	12	-	2	ACGTTC
gi|514486632|gb|KE346360.1|	846064	846082	A	18	+	18	A
gi|514486632|gb|KE346360.1|	846226	846239	A	13	-	13	T
gi|514486632|gb|KE346360.1|	846613	846625	C	12	+	12	C
gi|514486632|gb|KE346360.1|	849437	849449	AACGAG	12	-	2	TTCTCG
gi|514486632|gb|KE346360.1|	850861	850873	AAAGCG	12	+	2	AAGCGA
gi|514486632|gb|KE346360.1|	850920	850934	A	14	+	14	A
gi|514486632|gb|KE346360.1|	851490	851514	AAC	24	-	8	TTG
gi|514486632|gb|KE346360.1|	851818	851833	A	15	+	15	A
gi|514486632|gb|KE346360.1|	852162	852183	AG	21	+	10	AG
gi|514486632|gb|KE346360.1|	852229	852242	AAC	13	+	4	CAA
gi|514486632|gb|KE346360.1|	852423	852438	AAGAGC	15	+	2	CAAGAG
gi|514486632|gb|KE346360.1|	852658	852675	AG	17	+	8	AG
gi|514486632|gb|KE346360.1|	852816	852837	A	21	-	21	T
gi|514486632|gb|KE346360.1|	852857	852877	A	20	-	20	T
gi|514486632|gb|KE346360.1|	852894	852907	AG	13	-	6	CT
gi|514486632|gb|KE346360.1|	853399	853411	ACGATG	12	+	2	CGATGA
gi|514486632|gb|KE346360.1|	853431	853443	AAC	12	+	4	ACA
gi|514486632|gb|KE346360.1|	853668	853680	ACAGTC	12	+	2	GTCACA
gi|514486632|gb|KE346360.1|	853718	853735	ACACTC	17	+	2	CACACT
gi|514486632|gb|KE346360.1|	854802	854816	ACACC	14	+	2	CCACA
gi|514486632|gb|KE346360.1|	855923	855935	ACGCCG	12	+	2	CGCCGA
gi|514486632|gb|KE346360.1|	856438	856451	AAC	13	-	4	TTG
gi|514486632|gb|KE346360.1|	857298	857313	AAAAGC	15	+	2	AAAGCA
gi|514486632|gb|KE346360.1|	857308	857325	AAAAAC	17	+	2	CAAAAA
gi|514486632|gb|KE346360.1|	858659	858671	ACGCAG	12	-	2	GCGTCT
gi|514486632|gb|KE346360.1|	859666	859681	CCG	15	+	5	GCC
gi|514486632|gb|KE346360.1|	859804	859819	AGCCGC	15	+	2	GCAGCC
gi|514486632|gb|KE346360.1|	860915	860927	AGCCCG	12	-	2	GCTCGG
gi|514486632|gb|KE346360.1|	861729	861742	ACCTCC	13	-	2	GGTGGA
gi|514486632|gb|KE346360.1|	861830	861844	AGCTCC	14	-	2	TGGAGC
gi|514486632|gb|KE346360.1|	863418	863431	AGAGG	13	+	2	GAGGA
gi|514486632|gb|KE346360.1|	863435	863448	AGAGG	13	+	2	GAGAG
gi|514486632|gb|KE346360.1|	863586	863599	AG	13	+	6	AG
gi|514486632|gb|KE346360.1|	863606	863622	AAGAG	16	+	3	GAAGA
gi|514486632|gb|KE346360.1|	863698	863712	AAAAT	14	+	2	AAAAT
gi|514486632|gb|KE346360.1|	863712	863726	AAT	14	+	4	AAT
gi|514486632|gb|KE346360.1|	863890	863903	AC	13	-	6	GT
gi|514486632|gb|KE346360.1|	863930	863949	AAAAT	19	+	3	AAAAT
gi|514486632|gb|KE346360.1|	863971	863997	A	26	+	26	A
gi|514486632|gb|KE346360.1|	864428	864447	AAG	19	+	6	GAA
gi|514486632|gb|KE346360.1|	864532	864546	AACCAG	14	+	2	ACCAGA
gi|514486632|gb|KE346360.1|	864544	864557	ACGAGG	13	+	2	ACGAGG
gi|514486632|gb|KE346360.1|	865162	865179	AATG	17	-	4	ATTC
gi|514486632|gb|KE346360.1|	865179	865191	AATCGC	12	+	2	CGCAAT
gi|514486632|gb|KE346360.1|	865368	865380	AAAAAC	12	-	2	GTTTTT
gi|514486632|gb|KE346360.1|	865595	865608	ACCGCC	13	-	2	TGGCGG
gi|514486632|gb|KE346360.1|	865975	865987	AACGC	12	-	2	TGCGT
gi|514486632|gb|KE346360.1|	866856	866871	AAAAAC	15	+	2	AAAAAC
gi|514486632|gb|KE346360.1|	870122	870135	AAAC	13	+	3	ACAA
gi|514486632|gb|KE346360.1|	870397	870409	ACTCTC	12	-	2	AGTGAG
gi|514486632|gb|KE346360.1|	871312	871332	AAAGCC	20	+	3	CAAAGC
gi|514486632|gb|KE346360.1|	871327	871343	AGAGCC	16	+	2	AGCCAG
gi|514486632|gb|KE346360.1|	871769	871786	AATG	17	-	4	ATTC
gi|514486632|gb|KE346360.1|	871793	871806	ACTG	13	-	3	CAGT
gi|514486632|gb|KE346360.1|	871818	871835	AAAAAG	17	-	2	TTTTTC
gi|514486632|gb|KE346360.1|	872004	872019	ATC	15	+	5	ATC
gi|514486632|gb|KE346360.1|	872026	872040	ATC	14	+	4	TCA
gi|514486632|gb|KE346360.1|	872052	872066	AGC	14	+	4	AGC
gi|514486632|gb|KE346360.1|	872296	872309	AC	13	-	6	TG
gi|514486632|gb|KE346360.1|	874036	874048	AACAC	12	-	2	GTTGT
gi|514486632|gb|KE346360.1|	875487	875501	A	14	-	14	T
gi|514486632|gb|KE346360.1|	875502	875514	A	12	-	12	T
gi|514486632|gb|KE346360.1|	875955	875967	A	12	-	12	T
gi|514486632|gb|KE346360.1|	875962	875976	AAAAAC	14	-	2	TTTTTG
gi|514486632|gb|KE346360.1|	875977	876005	AAC	28	-	9	TTG
gi|514486632|gb|KE346360.1|	877095	877113	ACG	18	+	6	CGA
gi|514486632|gb|KE346360.1|	877186	877198	ACGGCG	12	+	2	GACGGC
gi|514486632|gb|KE346360.1|	877378	877390	ACGG	12	+	3	CGGA
gi|514486632|gb|KE346360.1|	878095	878107	ACGCCG	12	-	2	CGGCGT
gi|514486632|gb|KE346360.1|	878150	878168	A	18	+	18	A
gi|514486632|gb|KE346360.1|	879003	879025	AC	22	+	11	CA
gi|514486632|gb|KE346360.1|	879288	879302	A	14	+	14	A
gi|514486632|gb|KE346360.1|	879388	879408	A	20	+	20	A
gi|514486632|gb|KE346360.1|	879580	879594	CCG	14	-	4	GGC
gi|514486632|gb|KE346360.1|	880668	880691	A	23	-	23	T
gi|514486632|gb|KE346360.1|	880925	880939	ACG	14	+	4	GAC
gi|514486632|gb|KE346360.1|	881189	881212	AGG	23	+	7	GAG
gi|514486632|gb|KE346360.1|	881351	881374	AACAGC	23	+	3	CAGCAA
gi|514486632|gb|KE346360.1|	881379	881391	AACAGC	12	+	2	AGCAAC
gi|514486632|gb|KE346360.1|	881530	881552	ACG	22	+	7	CGA
gi|514486632|gb|KE346360.1|	881972	881985	AGCC	13	-	3	TGGC
gi|514486632|gb|KE346360.1|	882150	882162	AAAC	12	-	3	GTTT
gi|514486632|gb|KE346360.1|	882336	882348	ACC	12	+	4	CAC
gi|514486632|gb|KE346360.1|	882625	882637	AAGGGC	12	+	2	GGCAAG
gi|514486632|gb|KE346360.1|	882832	882861	ACCTGC	29	+	4	GCACCT
gi|514486632|gb|KE346360.1|	884283	884306	AACAGC	23	+	3	CAACAG
gi|514486632|gb|KE346360.1|	884310	884325	AAC	15	+	5	CAA
gi|514486632|gb|KE346360.1|	884527	884540	AGGGGC	13	-	2	CCCCTG
gi|514486632|gb|KE346360.1|	884535	884552	AGCAGG	17	-	2	CCTGCT
gi|514486632|gb|KE346360.1|	884547	884561	AGGGGC	14	-	2	CCTGCC
gi|514486632|gb|KE346360.1|	884616	884628	ACTCGC	12	+	2	TCGCAC
gi|514486632|gb|KE346360.1|	885068	885081	AGC	13	-	4	TGC
gi|514486632|gb|KE346360.1|	885928	885940	AACGGC	12	+	2	ACGGCA
gi|514486632|gb|KE346360.1|	886074	886088	AAAATC	14	-	2	TTGATT
gi|514486632|gb|KE346360.1|	886095	886112	A	17	-	17	T
gi|514486632|gb|KE346360.1|	886250	886262	A	12	-	12	T
gi|514486632|gb|KE346360.1|	886416	886432	A	16	-	16	T
gi|514486632|gb|KE346360.1|	886938	886952	AAGCAC	14	-	2	TGTGCT
gi|514486632|gb|KE346360.1|	887537	887549	AGGCCG	12	+	2	GCCGAG
gi|514486632|gb|KE346360.1|	889010	889025	AC	15	-	7	GT
gi|514486632|gb|KE346360.1|	890337	890351	AATGGC	14	-	2	CATTGC
gi|514486632|gb|KE346360.1|	890755	890767	A	12	-	12	T
gi|514486632|gb|KE346360.1|	890896	890908	AAGGTC	12	+	2	CAAGGT
gi|514486632|gb|KE346360.1|	891269	891287	AAG	18	+	6	AAG
gi|514486632|gb|KE346360.1|	891304	891317	A	13	+	13	A
gi|514486632|gb|KE346360.1|	891602	891616	A	14	-	14	T
gi|514486632|gb|KE346360.1|	892098	892110	AAGAGC	12	-	2	CTCTTG
gi|514486632|gb|KE346360.1|	893394	893410	AAC	16	+	5	ACA
gi|514486632|gb|KE346360.1|	893414	893433	A	19	+	19	A
gi|514486632|gb|KE346360.1|	893594	893612	A	18	+	18	A
gi|514486632|gb|KE346360.1|	893976	894000	A	24	+	24	A
gi|514486632|gb|KE346360.1|	894030	894054	A	24	-	24	T
gi|514486632|gb|KE346360.1|	894777	894793	AGC	16	-	5	CTG
gi|514486632|gb|KE346360.1|	894788	894802	AGCGGC	14	-	2	GCTGCC
gi|514486632|gb|KE346360.1|	895347	895359	AGGGG	12	-	2	CCCTC
gi|514486632|gb|KE346360.1|	895356	895369	AGGGG	13	-	2	CCCTC
gi|514486632|gb|KE346360.1|	895393	895408	AACAAT	15	-	2	TTGTTA
gi|514486632|gb|KE346360.1|	895550	895566	AAAAT	16	-	3	TATTT
gi|514486632|gb|KE346360.1|	895594	895611	ACCCTC	17	+	2	CCCTCA
gi|514486632|gb|KE346360.1|	895620	895636	AGAGGC	16	-	2	CTCTGC
gi|514486632|gb|KE346360.1|	895663	895680	AGAGGG	17	-	2	TCTCCC
gi|514486632|gb|KE346360.1|	895675	895697	AAGGAG	22	-	3	TCTCCT
gi|514486632|gb|KE346360.1|	895877	895890	AG	13	+	6	GA
gi|514486632|gb|KE346360.1|	896000	896012	ATGCCC	12	+	2	CCATGC
gi|514486632|gb|KE346360.1|	896107	896126	AATGCC	19	+	3	CCAATG
gi|514486632|gb|KE346360.1|	896128	896141	AAC	13	+	4	CAA
gi|514486632|gb|KE346360.1|	896314	896326	AGC	12	-	4	GCT
gi|514486632|gb|KE346360.1|	896407	896419	ACCGGC	12	+	2	ACCGGC
gi|514486632|gb|KE346360.1|	896776	896793	AAAAAG	17	-	2	TTTTTC
gi|514486632|gb|KE346360.1|	897192	897209	AGCGGC	17	-	2	GCTGCC
gi|514486632|gb|KE346360.1|	897225	897237	CCG	12	+	4	GCC
gi|514486632|gb|KE346360.1|	899608	899621	AAGCGC	13	-	2	GCTTGC
gi|514486632|gb|KE346360.1|	899688	899702	AGCAGG	14	+	2	GCAGGA
gi|514486632|gb|KE346360.1|	899724	899748	AGC	24	+	8	GCA
gi|514486632|gb|KE346360.1|	901989	902054	AAAAGG	65	-	10	TCCTTT
gi|514486632|gb|KE346360.1|	902376	902390	ACG	14	-	4	TCG
gi|514486632|gb|KE346360.1|	902603	902615	CCG	12	+	4	CGC
gi|514486632|gb|KE346360.1|	904548	904561	ACCCG	13	-	2	TCGGG
gi|514486632|gb|KE346360.1|	904734	904746	AAAAC	12	+	2	CAAAA
gi|514486632|gb|KE346360.1|	905306	905318	AAAAC	12	+	2	AAAAC
gi|514486632|gb|KE346360.1|	905363	905378	AGGG	15	+	3	GGAG
gi|514486632|gb|KE346360.1|	905874	905888	AGATGC	14	+	2	GCAGAT
gi|514486632|gb|KE346360.1|	906248	906268	AAAAAT	20	+	3	AATAAA
gi|514486632|gb|KE346360.1|	906265	906279	AAAAT	14	+	2	AAAAT
gi|514486632|gb|KE346360.1|	906285	906299	AAAAAT	14	+	2	AAAAAT
gi|514486632|gb|KE346360.1|	906424	906438	AGGGG	14	+	2	GGGAG
gi|514486632|gb|KE346360.1|	906432	906446	AAGGGG	14	+	2	AGGGGA
gi|514486632|gb|KE346360.1|	906851	906869	AAGC	18	-	4	GCTT
gi|514486632|gb|KE346360.1|	907185	907207	ATC	22	+	7	ATC
gi|514486632|gb|KE346360.1|	907211	907225	ATC	14	+	4	CAT
gi|514486632|gb|KE346360.1|	907220	907234	AGCATC	14	+	2	CATCAG
gi|514486632|gb|KE346360.1|	907262	907277	CCG	15	+	5	CCG
gi|514486632|gb|KE346360.1|	907497	907509	AGGCGC	12	+	2	CGCAGG
gi|514486632|gb|KE346360.1|	907571	907586	CCGCGG	15	+	2	CCGCGG
gi|514486632|gb|KE346360.1|	907691	907703	ATCCCC	12	+	2	CCATCC
gi|514486632|gb|KE346360.1|	908967	908980	AACAAG	13	-	2	TGTTCT
gi|514486632|gb|KE346360.1|	908991	909005	ATC	14	-	4	TGA
gi|514486632|gb|KE346360.1|	909081	909095	AAT	14	-	4	TTA
gi|514486632|gb|KE346360.1|	909204	909216	ACGGGG	12	-	2	CGTCCC
gi|514486632|gb|KE346360.1|	909502	909545	AAAAC	43	-	8	TTGTT
gi|514486632|gb|KE346360.1|	910001	910023	A	22	-	22	T
gi|514486632|gb|KE346360.1|	910999	911011	AAACGC	12	+	2	CGCAAA
gi|514486632|gb|KE346360.1|	911120	911133	AAGAC	13	+	2	AGACA
gi|514486632|gb|KE346360.1|	911160	911185	AAC	25	+	8	ACA
gi|514486632|gb|KE346360.1|	911245	911257	AAC	12	+	4	CAA
gi|514486632|gb|KE346360.1|	912180	912194	A	14	+	14	A
gi|514486632|gb|KE346360.1|	912211	912224	AAAAAC	13	+	2	AAAACA
gi|514486632|gb|KE346360.1|	915944	915957	AATGG	13	-	2	CCATT
gi|514486632|gb|KE346360.1|	917901	917914	ACACCT	13	-	2	GTGTAG
gi|514486632|gb|KE346360.1|	918230	918244	AAGAG	14	+	2	GAGAA
gi|514486632|gb|KE346360.1|	918240	918259	AGAGG	19	+	3	GAGAG
gi|514486632|gb|KE346360.1|	918263	918276	AAAC	13	+	3	ACAA
gi|514486632|gb|KE346360.1|	918516	918531	A	15	+	15	A
gi|514486632|gb|KE346360.1|	918551	918563	AATGC	12	+	2	AATGC
gi|514486632|gb|KE346360.1|	918849	918862	AAAACC	13	+	2	AAAACC
gi|514486632|gb|KE346360.1|	919374	919398	A	24	+	24	A
gi|514486632|gb|KE346360.1|	919413	919428	AAAAAT	15	+	2	AAATAA
gi|514486632|gb|KE346360.1|	919434	919449	A	15	+	15	A
gi|514486632|gb|KE346360.1|	919452	919464	AAAAG	12	+	2	AAAAG
gi|514486632|gb|KE346360.1|	919724	919742	AAAC	18	+	4	AAAC
gi|514486632|gb|KE346360.1|	920012	920026	AGCTCG	14	+	2	GCTCGA
gi|514486632|gb|KE346360.1|	920154	920167	AAAGCC	13	-	2	GGCTTT
gi|514486632|gb|KE346360.1|	921355	921368	AGCTGC	13	+	2	TGCAGC
gi|514486632|gb|KE346360.1|	921409	921428	AGG	19	-	6	CCT
gi|514486632|gb|KE346360.1|	921617	921632	AAAAC	15	+	3	AACAA
gi|514486632|gb|KE346360.1|	921994	922008	AAAAC	14	+	2	AAAAC
gi|514486632|gb|KE346360.1|	922068	922090	A	22	-	22	T
gi|514486632|gb|KE346360.1|	922456	922476	A	20	+	20	A
gi|514486632|gb|KE346360.1|	922665	922681	A	16	+	16	A
gi|514486632|gb|KE346360.1|	922763	922777	A	14	-	14	T
gi|514486632|gb|KE346360.1|	922835	922849	ATC	14	-	4	GAT
gi|514486632|gb|KE346360.1|	922915	922932	AAAGAG	17	-	2	TCTCTT
gi|514486632|gb|KE346360.1|	922927	922940	AG	13	-	6	TC
gi|514486632|gb|KE346360.1|	923021	923034	AAAAG	13	-	2	TTTTC
gi|514486632|gb|KE346360.1|	923148	923163	AAGC	15	-	3	CTTG
gi|514486632|gb|KE346360.1|	923163	923176	AAGCAG	13	-	2	TGCTTC
gi|514486632|gb|KE346360.1|	923472	923502	ATC	30	+	10	TCA
gi|514486632|gb|KE346360.1|	923639	923665	ACC	26	+	8	CCA
gi|514486632|gb|KE346360.1|	923769	923782	ATCGGC	13	-	2	TGCCGA
gi|514486632|gb|KE346360.1|	923937	923954	CCG	17	+	5	CGC
gi|514486632|gb|KE346360.1|	924132	924149	ACGCTG	17	+	2	CGCTGA
gi|514486632|gb|KE346360.1|	924328	924342	AGC	14	-	4	GCT
gi|514486632|gb|KE346360.1|	924343	924357	AGC	14	-	4	GCT
gi|514486632|gb|KE346360.1|	924358	924372	AGC	14	-	4	GCT
gi|514486632|gb|KE346360.1|	924766	924778	AGCGGC	12	-	2	GCTGCC
gi|514486632|gb|KE346360.1|	924823	924835	AGGCCC	12	+	2	GCCCAG
gi|514486632|gb|KE346360.1|	924930	924942	AAGGCC	12	+	2	GGCCAA
gi|514486632|gb|KE346360.1|	925269	925281	A	12	-	12	T
gi|514486632|gb|KE346360.1|	926447	926460	AAAATC	13	+	2	AAAATC
gi|514486632|gb|KE346360.1|	927064	927078	AAAAG	14	-	2	TTTTC
gi|514486632|gb|KE346360.1|	927103	927121	A	18	-	18	T
gi|514486632|gb|KE346360.1|	927442	927455	AAAACG	13	-	2	TCGTTT
gi|514486632|gb|KE346360.1|	927776	927788	ACACAG	12	-	2	TGTCTG
gi|514486632|gb|KE346360.1|	928258	928278	A	20	-	20	T
gi|514486632|gb|KE346360.1|	928607	928619	AAGCAT	12	+	2	GCATAA
gi|514486632|gb|KE346360.1|	930290	930315	A	25	-	25	T
gi|514486632|gb|KE346360.1|	931954	931971	AC	17	-	8	TG
gi|514486632|gb|KE346360.1|	931972	931987	AC	15	-	7	TG
gi|514486632|gb|KE346360.1|	934167	934183	A	16	+	16	A
gi|514486632|gb|KE346360.1|	934318	934332	AACTCC	14	-	2	AGTTGG
gi|514486632|gb|KE346360.1|	935536	935548	AAAAG	12	-	2	TCTTT
gi|514486632|gb|KE346360.1|	936349	936362	AGG	13	-	4	CCT
gi|514486632|gb|KE346360.1|	937714	937730	AAAAAT	16	+	2	AAAAAT
gi|514486632|gb|KE346360.1|	937749	937766	AAAAAT	17	+	2	AAAAAT
gi|514486632|gb|KE346360.1|	938329	938343	A	14	+	14	A
gi|514486632|gb|KE346360.1|	938791	938810	A	19	-	19	T
gi|514486632|gb|KE346360.1|	938827	938841	A	14	-	14	T
gi|514486632|gb|KE346360.1|	938877	938891	AAAAAG	14	+	2	AAAAAG
gi|514486632|gb|KE346360.1|	939747	939759	AAAAGC	12	+	2	AGCAAA
gi|514486632|gb|KE346360.1|	942090	942102	CCG	12	-	4	GGC
gi|514486632|gb|KE346360.1|	942159	942173	AACAGC	14	-	2	TGCTGT
gi|514486632|gb|KE346360.1|	942302	942314	AACC	12	-	3	TGGT
gi|514486632|gb|KE346360.1|	943393	943405	AAACCC	12	+	2	CAAACC
gi|514486632|gb|KE346360.1|	944094	944106	AAGCAT	12	-	2	ATGCTT
gi|514486632|gb|KE346360.1|	944355	944370	AAGAGC	15	-	2	TTGCTC
gi|514486632|gb|KE346360.1|	945047	945059	AATC	12	+	3	CAAT
gi|514486632|gb|KE346360.1|	945329	945342	AGCTCC	13	+	2	CAGCTC
gi|514486632|gb|KE346360.1|	945358	945370	AACAGC	12	+	2	ACAGCA
gi|514486632|gb|KE346360.1|	945365	945380	AGC	15	+	5	CAG
gi|514486632|gb|KE346360.1|	945497	945525	AACC	28	+	7	CCAA
gi|514486632|gb|KE346360.1|	945692	945721	ACCCAG	29	+	4	CAGACC
gi|514486632|gb|KE346360.1|	946022	946037	AC	15	+	7	CA
gi|514486632|gb|KE346360.1|	946460	946472	AGAGCG	12	-	2	TCGCTC
gi|514486632|gb|KE346360.1|	946734	946746	AGCGGC	12	-	2	CTGCCG
gi|514486632|gb|KE346360.1|	946874	946886	AAAACG	12	+	2	AACGAA
gi|514486632|gb|KE346360.1|	946903	946915	ACG	12	+	4	CGA
gi|514486632|gb|KE346360.1|	948872	948886	AACAGC	14	-	2	TGCTGT
gi|514486632|gb|KE346360.1|	948905	948932	AGC	27	-	9	TGC
gi|514486632|gb|KE346360.1|	949078	949093	ACGCGG	15	+	2	CGCGGA
gi|514486632|gb|KE346360.1|	949883	949900	AGCGGC	17	+	2	GCAGCG
gi|514486632|gb|KE346360.1|	949917	949931	AAGCCC	14	-	2	TGGGCT
gi|514486632|gb|KE346360.1|	950221	950243	AC	22	-	11	GT
gi|514486632|gb|KE346360.1|	950283	950298	AAAAG	15	+	3	AAAAG
gi|514486632|gb|KE346360.1|	950840	950864	ACC	24	-	8	GGT
gi|514486632|gb|KE346360.1|	951074	951086	AGAGC	12	+	2	AGCAG
gi|514486632|gb|KE346360.1|	951147	951165	A	18	+	18	A
gi|514486632|gb|KE346360.1|	951167	951181	A	14	+	14	A
gi|514486632|gb|KE346360.1|	951346	951376	A	30	+	30	A
gi|514486632|gb|KE346360.1|	951543	951558	AAATC	15	+	3	AAATC
gi|514486632|gb|KE346360.1|	951601	951613	AAACGG	12	+	2	AACGGA
gi|514486632|gb|KE346360.1|	951755	951767	AGG	12	+	4	GGA
gi|514486632|gb|KE346360.1|	951762	951782	AAGAGG	20	+	3	GAGGAA
gi|514486632|gb|KE346360.1|	952382	952397	A	15	-	15	T
gi|514486632|gb|KE346360.1|	952410	952422	AG	12	-	6	CT
gi|514486632|gb|KE346360.1|	952604	952617	A	13	-	13	T
gi|514486632|gb|KE346360.1|	952975	953007	A	32	-	32	T
gi|514486632|gb|KE346360.1|	953417	953429	AACTGC	12	-	2	TTGCAG
gi|514486632|gb|KE346360.1|	953492	953504	AGC	12	+	4	GCA
gi|514486632|gb|KE346360.1|	953638	953651	AGC	13	+	4	AGC
gi|514486632|gb|KE346360.1|	953678	953692	AGCGGC	14	+	2	GCAGCG
gi|514486632|gb|KE346360.1|	956056	956071	ACCTGG	15	+	2	GGACCT
gi|514486632|gb|KE346360.1|	956198	956211	ACACGT	13	+	2	GTACAC
gi|514486632|gb|KE346360.1|	956508	956536	AGC	28	+	9	GCA
gi|514486632|gb|KE346360.1|	957108	957125	ACCCTG	17	-	2	AGGGTC
gi|514486632|gb|KE346360.1|	957141	957156	AATTC	15	-	3	TTGAA
gi|514486632|gb|KE346360.1|	957180	957193	A	13	+	13	A
gi|514486632|gb|KE346360.1|	957245	957263	A	18	+	18	A
gi|514486632|gb|KE346360.1|	957353	957373	AAGACG	20	+	3	GAAGAC
gi|514486632|gb|KE346360.1|	957430	957447	A	17	+	17	A
gi|514486632|gb|KE346360.1|	957828	957847	A	19	+	19	A
gi|514486632|gb|KE346360.1|	958125	958140	AAG	15	+	5	AAG
gi|514486632|gb|KE346360.1|	958212	958227	A	15	-	15	T
gi|514486632|gb|KE346360.1|	958426	958438	AG	12	+	6	GA
gi|514486632|gb|KE346360.1|	958447	958464	AAT	17	-	5	TTA
gi|514486632|gb|KE346360.1|	958657	958675	A	18	-	18	T
gi|514486632|gb|KE346360.1|	958738	958750	ACTCC	12	-	2	GGAGT
gi|514486632|gb|KE346360.1|	959008	959021	AGAGGG	13	+	2	GAGGGA
gi|514486632|gb|KE346360.1|	959093	959112	ACC	19	+	6	CAC
gi|514486632|gb|KE346360.1|	959358	959370	AAAAGC	12	-	2	CTTTTG
gi|514486632|gb|KE346360.1|	961151	961164	AAGCTC	13	+	2	CTCAAG
gi|514486632|gb|KE346360.1|	961602	961618	AAAAAC	16	-	2	TTTTTG
gi|514486632|gb|KE346360.1|	961707	961721	AAC	14	-	4	TGT
gi|514486632|gb|KE346360.1|	961719	961746	AGC	27	-	9	TGC
gi|514486632|gb|KE346360.1|	962225	962240	AC	15	-	7	TG
gi|514486632|gb|KE346360.1|	962245	962257	AAAAC	12	-	2	TTTTG
gi|514486632|gb|KE346360.1|	962252	962264	AAC	12	-	4	TTG
gi|514486632|gb|KE346360.1|	962557	962569	AACGCC	12	-	2	CGTTGG
gi|514486632|gb|KE346360.1|	962669	962682	AGAGCG	13	-	2	GCTCTC
gi|514486632|gb|KE346360.1|	963577	963591	ACGAGC	14	-	2	CGTGCT
gi|514486632|gb|KE346360.1|	963891	963904	AC	13	-	6	GT
gi|514486632|gb|KE346360.1|	964043	964055	AACATC	12	+	2	ACATCA
gi|514486632|gb|KE346360.1|	964118	964130	A	12	+	12	A
gi|514486632|gb|KE346360.1|	964154	964166	AAAG	12	+	3	AAAG
gi|514486632|gb|KE346360.1|	967662	967674	AAAAAG	12	+	2	GAAAAA
gi|514486632|gb|KE346360.1|	967672	967684	AAAG	12	+	3	AAAG
gi|514486632|gb|KE346360.1|	968029	968043	AAAAG	14	+	2	AAAAG
gi|514486632|gb|KE346360.1|	968086	968099	AAAAAC	13	-	2	TTTTTG
gi|514486632|gb|KE346360.1|	968594	968606	AAGAGG	12	+	2	AGAGGA
gi|514486632|gb|KE346360.1|	968605	968623	AAAGAG	18	+	3	AGAGAA
gi|514486632|gb|KE346360.1|	969067	969079	AGCGC	12	+	2	GCAGC
gi|514486632|gb|KE346360.1|	969388	969400	AAAC	12	-	3	GTTT
gi|514486632|gb|KE346360.1|	969824	969837	ACCGTC	13	-	2	GACGGT
gi|514486632|gb|KE346360.1|	971346	971363	AATGC	17	-	3	TGCAT
gi|514486632|gb|KE346360.1|	972100	972116	A	16	-	16	T
gi|514486632|gb|KE346360.1|	973269	973281	ACTCTC	12	+	2	CTCACT
gi|514486632|gb|KE346360.1|	975223	975237	ACATGC	14	+	2	ACATGC
gi|514486632|gb|KE346360.1|	975399	975413	AATCTC	14	-	2	TGAGAT
gi|514486632|gb|KE346360.1|	975865	975877	ACGATG	12	-	2	TCATCG
gi|514486632|gb|KE346360.1|	975892	975906	AGC	14	+	4	AGC
gi|514486632|gb|KE346360.1|	976056	976068	AC	12	+	6	AC
gi|514486632|gb|KE346360.1|	976347	976360	AGC	13	-	4	TGC
gi|514486632|gb|KE346360.1|	976448	976467	AAACTC	19	+	3	CAAACT
gi|514486632|gb|KE346360.1|	978706	978718	AAAC	12	-	3	TTGT
gi|514486632|gb|KE346360.1|	978959	978971	AAGCTC	12	+	2	GCTCAA
gi|514486632|gb|KE346360.1|	979070	979086	AGC	16	-	5	TGC
gi|514486632|gb|KE346360.1|	979976	979989	ACCACT	13	+	2	CACTAC
gi|514486632|gb|KE346360.1|	980936	980951	AGC	15	+	5	GCA
gi|514486632|gb|KE346360.1|	981558	981570	ACCAGC	12	+	2	GCACCA
gi|514486632|gb|KE346360.1|	982215	982231	A	16	-	16	T
gi|514486632|gb|KE346360.1|	982841	982855	AGC	14	+	4	CAG
gi|514486632|gb|KE346360.1|	983012	983024	AAAGCC	12	+	2	AAAGCC
gi|514486632|gb|KE346360.1|	983149	983168	AG	19	-	9	CT
gi|514486632|gb|KE346360.1|	984149	984161	AGCAGG	12	-	2	TCCTGC
gi|514486632|gb|KE346360.1|	984181	984207	AGC	26	-	8	CTG
gi|514486632|gb|KE346360.1|	984284	984306	AGC	22	-	7	TGC
gi|514486632|gb|KE346360.1|	984604	984616	ACTGCC	12	+	2	ACTGCC
gi|514486632|gb|KE346360.1|	985812	985825	AG	13	+	6	AG
gi|514486632|gb|KE346360.1|	986320	986332	AAGATC	12	-	2	TCTTGA
gi|514486632|gb|KE346360.1|	988285	988300	AGC	15	-	5	TGC
gi|514486632|gb|KE346360.1|	988384	988396	AAAAAG	12	-	2	TTTCTT
gi|514486632|gb|KE346360.1|	989303	989331	CCG	28	-	9	GCG
gi|514486632|gb|KE346360.1|	989833	989853	CCG	20	+	6	CGC
gi|514486632|gb|KE346360.1|	989870	989882	AGC	12	+	4	GCA
gi|514486632|gb|KE346360.1|	990143	990155	AAAATC	12	-	2	TTTTGA
gi|514486632|gb|KE346360.1|	990175	990201	A	26	+	26	A
gi|514486632|gb|KE346360.1|	990408	990420	A	12	-	12	T
gi|514486632|gb|KE346360.1|	990441	990465	AAGGCG	24	-	4	CTTCGC
gi|514486632|gb|KE346360.1|	990461	990483	ACTCGC	22	+	3	TCGCAC
gi|514486632|gb|KE346360.1|	990581	990600	AG	19	-	9	TC
gi|514486632|gb|KE346360.1|	991312	991324	AAG	12	-	4	TCT
gi|514486632|gb|KE346360.1|	992792	992804	AG	12	+	6	GA
gi|514486632|gb|KE346360.1|	992805	992820	ACAGAG	15	+	2	AGACAG
gi|514486632|gb|KE346360.1|	993930	993942	AAAAAG	12	+	2	GAAAAA
gi|514486632|gb|KE346360.1|	994763	994775	A	12	-	12	T
gi|514486632|gb|KE346360.1|	994995	995013	A	18	+	18	A
gi|514486632|gb|KE346360.1|	995244	995261	A	17	+	17	A
gi|514486632|gb|KE346360.1|	995407	995420	AGGGG	13	+	2	GGGAG
gi|514486632|gb|KE346360.1|	995476	995500	A	24	-	24	T
gi|514486632|gb|KE346360.1|	995645	995657	AAAATC	12	+	2	TCAAAA
gi|514486632|gb|KE346360.1|	995816	995834	A	18	+	18	A
gi|514486632|gb|KE346360.1|	995894	995906	A	12	-	12	T
gi|514486632|gb|KE346360.1|	996178	996191	CCCCG	13	-	2	GGGGC
gi|514486632|gb|KE346360.1|	996420	996433	AAAAAC	13	-	2	TTGTTT
gi|514486632|gb|KE346360.1|	996866	996878	AAG	12	+	4	AAG
gi|514486632|gb|KE346360.1|	997127	997140	AAAAGG	13	+	2	GGAAAA
gi|514486632|gb|KE346360.1|	997267	997281	AAC	14	-	4	TTG
gi|514486632|gb|KE346360.1|	997678	997690	AGAGGG	12	+	2	GGAGAG
gi|514486632|gb|KE346360.1|	997703	997719	AGAGGG	16	+	2	GAGAGG
gi|514486632|gb|KE346360.1|	998063	998080	A	17	+	17	A
gi|514486632|gb|KE346360.1|	998481	998493	ACGCG	12	-	2	CGTCG
gi|514486632|gb|KE346360.1|	998649	998661	ACATGC	12	+	2	CATGCA
gi|514486632|gb|KE346360.1|	998656	998668	AAATGC	12	+	2	ATGCAA
gi|514486632|gb|KE346360.1|	999926	999939	AGCCCG	13	+	2	GAGCCC
gi|514486632|gb|KE346360.1|	999976	999991	AGC	15	-	5	CTG
gi|514486632|gb|KE346360.1|	1000010	1000022	AACAGC	12	-	2	TGCTGT
gi|514486632|gb|KE346360.1|	1000031	1000048	AAC	17	-	5	TGT
gi|514486632|gb|KE346360.1|	1001055	1001067	AACACC	12	+	2	CAACAC
gi|514486632|gb|KE346360.1|	1002516	1002533	AAGCTG	17	+	2	GCTGAA
gi|514486632|gb|KE346360.1|	1002623	1002636	AAAGAG	13	-	2	TCTTTC
gi|514486632|gb|KE346360.1|	1002630	1002642	AAAG	12	-	3	CTTT
gi|514486632|gb|KE346360.1|	1002866	1002878	ACG	12	+	4	CGA
gi|514486632|gb|KE346360.1|	1002930	1002950	ACTCTG	20	+	3	GACTCT
gi|514486632|gb|KE346360.1|	1003130	1003160	AAC	30	+	10	CAA
gi|514486632|gb|KE346360.1|	1004816	1004829	AAACC	13	+	2	ACCAA
gi|514486632|gb|KE346360.1|	1005660	1005673	AAAC	13	+	3	AACA
gi|514486632|gb|KE346360.1|	1005714	1005726	AAAAC	12	+	2	AAAAC
gi|514486632|gb|KE346360.1|	1006901	1006914	AAAAAT	13	+	2	AAAAAT
gi|514486632|gb|KE346360.1|	1007400	1007412	AAGGGC	12	+	2	AAGGGC
gi|514486632|gb|KE346360.1|	1007463	1007475	AAC	12	-	4	TGT
gi|514486632|gb|KE346360.1|	1007795	1007809	AG	14	-	7	CT
gi|514486632|gb|KE346360.1|	1007846	1007860	AGAGCG	14	-	2	TCGCTC
gi|514486632|gb|KE346360.1|	1007917	1007935	A	18	-	18	T
gi|514486632|gb|KE346360.1|	1007931	1007945	AAAAG	14	-	2	TTTTC
gi|514486632|gb|KE346360.1|	1008025	1008037	AGGGCG	12	-	2	TCGCCC
gi|514486632|gb|KE346360.1|	1008089	1008101	AAGGAC	12	+	2	AAGGAC
gi|514486632|gb|KE346360.1|	1008502	1008526	A	24	-	24	T
gi|514486632|gb|KE346360.1|	1008715	1008740	A	25	+	25	A
gi|514486632|gb|KE346360.1|	1008764	1008782	AAAAAC	18	+	3	AAAACA
gi|514486632|gb|KE346360.1|	1008790	1008805	A	15	+	15	A
gi|514486632|gb|KE346360.1|	1008858	1008871	AAAAAC	13	+	2	AAACAA
gi|514486632|gb|KE346360.1|	1008988	1009002	AAAAAC	14	-	2	GTTTTT
gi|514486632|gb|KE346360.1|	1008998	1009016	AACCAC	18	-	3	TTGTGG
gi|514486632|gb|KE346360.1|	1009527	1009542	A	15	-	15	T
gi|514486632|gb|KE346360.1|	1009808	1009821	AAGG	13	-	3	TCCT
gi|514486632|gb|KE346360.1|	1012893	1012909	AAG	16	+	5	AAG
gi|514486632|gb|KE346360.1|	1013359	1013371	AAAGCC	12	+	2	AAGCCA
gi|514486632|gb|KE346360.1|	1013764	1013776	ACTCTC	12	-	2	TGAGAG
gi|514486632|gb|KE346360.1|	1014208	1014220	ACGAGC	12	+	2	AGCACG
gi|514486632|gb|KE346360.1|	1014342	1014370	A	28	+	28	A
gi|514486632|gb|KE346360.1|	1014882	1014896	AAAC	14	+	3	AAAC
gi|514486632|gb|KE346360.1|	1015145	1015157	AACTGC	12	-	2	AGTTGC
gi|514486632|gb|KE346360.1|	1018044	1018057	ACGATG	13	-	2	CATCGT
gi|514486632|gb|KE346360.1|	1018052	1018066	AAGACG	14	-	2	TCGTCT
gi|514486632|gb|KE346360.1|	1018061	1018075	AAG	14	-	4	TCT
gi|514486632|gb|KE346360.1|	1018511	1018532	AC	21	+	10	CA
gi|514486632|gb|KE346360.1|	1018838	1018861	AACAGC	23	-	3	TGCTGT
gi|514486632|gb|KE346360.1|	1018956	1018968	AGCTCC	12	-	2	GAGCTG
gi|514486632|gb|KE346360.1|	1019702	1019723	A	21	-	21	T
gi|514486632|gb|KE346360.1|	1019725	1019737	A	12	-	12	T
gi|514486632|gb|KE346360.1|	1020368	1020380	AAC	12	-	4	TTG
gi|514486632|gb|KE346360.1|	1020603	1020652	AC	49	-	24	GT
gi|514486632|gb|KE346360.1|	1020980	1021001	AC	21	-	10	GT
gi|514486632|gb|KE346360.1|	1021721	1021733	AGGATG	12	+	2	GAGGAT
gi|514486632|gb|KE346360.1|	1023027	1023043	AACTGC	16	-	2	GCAGTT
gi|514486632|gb|KE346360.1|	1023395	1023407	AAATTG	12	+	2	AAATTG
gi|514486632|gb|KE346360.1|	1024071	1024088	CCG	17	-	5	GCG
gi|514486632|gb|KE346360.1|	1024086	1024105	AGC	19	+	6	GCA
gi|514486632|gb|KE346360.1|	1025302	1025316	ACTGCG	14	+	2	GCGACT
gi|514486632|gb|KE346360.1|	1025589	1025601	AACAGC	12	-	2	TGCTGT
gi|514486632|gb|KE346360.1|	1025620	1025633	AAC	13	-	4	GTT
gi|514486632|gb|KE346360.1|	1026537	1026583	AAC	46	-	15	GTT
gi|514486632|gb|KE346360.1|	1026615	1026628	ACC	13	-	4	GTG
gi|514486632|gb|KE346360.1|	1028292	1028310	A	18	+	18	A
gi|514486632|gb|KE346360.1|	1028316	1028333	A	17	+	17	A
gi|514486632|gb|KE346360.1|	1028458	1028470	AGCG	12	+	3	CGAG
gi|514486632|gb|KE346360.1|	1028518	1028542	A	24	+	24	A
gi|514486632|gb|KE346360.1|	1028588	1028600	AGCC	12	-	3	GCTG
gi|514486632|gb|KE346360.1|	1028715	1028739	A	24	+	24	A
gi|514486632|gb|KE346360.1|	1028773	1028799	A	26	+	26	A
gi|514486632|gb|KE346360.1|	1029081	1029096	ACC	15	-	5	GGT
gi|514486632|gb|KE346360.1|	1029118	1029130	AAAAG	12	+	2	AAAGA
gi|514486632|gb|KE346360.1|	1029240	1029252	ACTAG	12	-	2	TAGTC
gi|514486632|gb|KE346360.1|	1029274	1029288	AACCTC	14	-	2	GGTTGA
gi|514486632|gb|KE346360.1|	1029707	1029720	AGCGCG	13	+	2	CGAGCG
gi|514486632|gb|KE346360.1|	1033567	1033579	AAAACC	12	+	2	CCAAAA
gi|514486632|gb|KE346360.1|	1034439	1034452	AATGC	13	+	2	CAATG
gi|514486632|gb|KE346360.1|	1034889	1034907	AG	18	+	9	GA
gi|514486632|gb|KE346360.1|	1035242	1035259	ACGACT	17	-	2	GTAGTC
gi|514486632|gb|KE346360.1|	1035271	1035286	AGC	15	+	5	AGC
gi|514486632|gb|KE346360.1|	1036102	1036115	AAAAC	13	-	2	GTTTT
gi|514486632|gb|KE346360.1|	1040113	1040126	ACCAGC	13	-	2	CTGGTG
gi|514486632|gb|KE346360.1|	1040227	1040239	AAAGAC	12	+	2	GACAAA
gi|514486632|gb|KE346360.1|	1040794	1040808	AGC	14	+	4	AGC
gi|514486632|gb|KE346360.1|	1040876	1040888	ACGGCG	12	+	2	GGCGAC
gi|514486632|gb|KE346360.1|	1040951	1040971	ACGAGG	20	+	3	GAGGAC
gi|514486632|gb|KE346360.1|	1040966	1040989	AAGACG	23	+	3	GACGAA
gi|514486632|gb|KE346360.1|	1040984	1040997	ACGAGG	13	+	2	GACGAG
gi|514486632|gb|KE346360.1|	1041065	1041078	AGC	13	+	4	GCA
gi|514486632|gb|KE346360.1|	1041125	1041137	AAATGG	12	+	2	ATGGAA
gi|514486632|gb|KE346360.1|	1041173	1041186	ACGAGG	13	+	2	GAGGAC
gi|514486632|gb|KE346360.1|	1041338	1041350	AC	12	-	6	TG
gi|514486632|gb|KE346360.1|	1041636	1041648	AGCGCC	12	-	2	CTGGCG
gi|514486632|gb|KE346360.1|	1041869	1041883	ACTC	14	-	3	TGAG
gi|514486632|gb|KE346360.1|	1041900	1041913	ACATCC	13	-	2	ATGTGG
gi|514486632|gb|KE346360.1|	1041941	1041961	A	20	-	20	T
gi|514486632|gb|KE346360.1|	1042165	1042182	A	17	-	17	T
gi|514486632|gb|KE346360.1|	1042241	1042270	AACAAG	29	-	4	TTCTTG
gi|514486632|gb|KE346360.1|	1042364	1042379	AGGCG	15	-	3	CCTCG
gi|514486632|gb|KE346360.1|	1042814	1042828	AAAACC	14	-	2	TGGTTT
gi|514486632|gb|KE346360.1|	1042846	1042869	AC	23	+	11	AC
gi|514486632|gb|KE346360.1|	1043862	1043885	AAC	23	+	7	CAA
gi|514486632|gb|KE346360.1|	1044775	1044787	AAAGC	12	+	2	CAAAG
gi|514486632|gb|KE346360.1|	1045218	1045232	AAAAAC	14	+	2	AAAACA
gi|514486632|gb|KE346360.1|	1046751	1046773	AAC	22	+	7	CAA
gi|514486632|gb|KE346360.1|	1047293	1047306	ACTC	13	-	3	GAGT
gi|514486632|gb|KE346360.1|	1047357	1047370	AGGGGG	13	+	2	GAGGGG
gi|514486632|gb|KE346360.1|	1047481	1047496	AGCGCC	15	+	2	AGCGCC
gi|514486632|gb|KE346360.1|	1047509	1047521	A	12	+	12	A
gi|514486632|gb|KE346360.1|	1047531	1047545	AAAAAG	14	+	2	AAGAAA
gi|514486632|gb|KE346360.1|	1047689	1047702	AAACCC	13	-	2	GGGTTT
gi|514486632|gb|KE346360.1|	1048091	1048113	A	22	-	22	T
gi|514486632|gb|KE346360.1|	1048465	1048488	AAAAAT	23	-	3	TTTTTA
gi|514486632|gb|KE346360.1|	1048484	1048497	AAAAAT	13	-	2	TTTTTA
gi|514486632|gb|KE346360.1|	1048507	1048520	A	13	-	13	T
gi|514486632|gb|KE346360.1|	1048856	1048870	AGGG	14	-	3	CCTC
gi|514486632|gb|KE346360.1|	1049103	1049119	AAGCTG	16	-	2	CAGCTT
gi|514486632|gb|KE346360.1|	1049117	1049130	AGAGGC	13	-	2	GCCTCT
gi|514486632|gb|KE346360.1|	1049257	1049275	AGC	18	+	6	GCA
gi|514486632|gb|KE346360.1|	1049765	1049778	AACAGC	13	+	2	CAGCAA
gi|514486632|gb|KE346360.1|	1049833	1049845	AACCGC	12	+	2	ACCGCA
gi|514486632|gb|KE346360.1|	1050152	1050164	AGC	12	+	4	CAG
gi|514486632|gb|KE346360.1|	1050198	1050220	AGC	22	+	7	AGC
gi|514486632|gb|KE346360.1|	1050299	1050312	AAGCAC	13	+	2	CAAGCA
gi|514486632|gb|KE346360.1|	1050337	1050352	AACAGC	15	+	2	ACAGCA
gi|514486632|gb|KE346360.1|	1050347	1050375	AAC	28	+	9	CAA
gi|514486632|gb|KE346360.1|	1050464	1050479	AACAGC	15	+	2	CAGCAA
gi|514486632|gb|KE346360.1|	1051887	1051900	AAAAC	13	+	2	AAACA
gi|514486632|gb|KE346360.1|	1053068	1053091	AGC	23	+	7	AGC
gi|514486632|gb|KE346360.1|	1053582	1053596	AAC	14	+	4	ACA
gi|514486632|gb|KE346360.1|	1053597	1053610	AAC	13	+	4	ACA
gi|514486632|gb|KE346360.1|	1053609	1053624	AAACCC	15	+	2	AAACCC
gi|514486632|gb|KE346360.1|	1057179	1057194	AGAT	15	+	3	AGAT
gi|514486632|gb|KE346360.1|	1057191	1057212	AG	21	+	10	AG
gi|514486632|gb|KE346360.1|	1057213	1057237	AG	24	+	12	AG
gi|514486632|gb|KE346360.1|	1057236	1057259	AC	23	-	11	GT
gi|514486632|gb|KE346360.1|	1057310	1057326	A	16	+	16	A
gi|514486632|gb|KE346360.1|	1057328	1057345	AAC	17	+	5	ACA
gi|514486632|gb|KE346360.1|	1057652	1057667	AAAGAC	15	-	2	TCTTTG
gi|514486632|gb|KE346360.1|	1057726	1057739	AGC	13	-	4	GCT
gi|514486632|gb|KE346360.1|	1057839	1057862	AACAG	23	+	4	AGAAC
gi|514486632|gb|KE346360.1|	1057874	1057891	A	17	+	17	A
gi|514486632|gb|KE346360.1|	1058093	1058106	AGC	13	+	4	AGC
gi|514486632|gb|KE346360.1|	1058252	1058268	ACC	16	+	5	CCA
gi|514486632|gb|KE346360.1|	1058274	1058286	ACGCC	12	+	2	ACGCC
gi|514486632|gb|KE346360.1|	1058335	1058350	AACAAG	15	-	2	GTTCTT
gi|514486632|gb|KE346360.1|	1058526	1058553	ACAGCC	27	+	4	GCCACA
gi|514486632|gb|KE346360.1|	1058652	1058665	AACAGC	13	-	2	TGCTGT
gi|514486632|gb|KE346360.1|	1059128	1059141	AGGCGC	13	+	2	GGCGCA
gi|514486632|gb|KE346360.1|	1059287	1059299	C	12	+	12	C
gi|514486632|gb|KE346360.1|	1059302	1059319	ACC	17	+	5	ACC
gi|514486632|gb|KE346360.1|	1061290	1061304	AGC	14	+	4	CAG
gi|514486632|gb|KE346360.1|	1062788	1062800	AAC	12	+	4	AAC
gi|514486632|gb|KE346360.1|	1063589	1063601	AAGCAG	12	-	2	TTCTGC
gi|514486632|gb|KE346360.1|	1064389	1064402	ACGCGG	13	-	2	CGCGTC
gi|514486632|gb|KE346360.1|	1064419	1064431	AGC	12	-	4	CTG
gi|514486632|gb|KE346360.1|	1064460	1064472	AAGGCC	12	-	2	CCTTGG
gi|514486632|gb|KE346360.1|	1064933	1064945	AAACGC	12	-	2	GTTTGC
gi|514486632|gb|KE346360.1|	1065243	1065262	AGC	19	-	6	TGC
gi|514486632|gb|KE346360.1|	1065931	1065943	AACCC	12	+	2	CAACC
gi|514486632|gb|KE346360.1|	1066086	1066098	AAAGCC	12	-	2	GGCTTT
gi|514486632|gb|KE346360.1|	1066642	1066654	AAG	12	-	4	TCT
gi|514486632|gb|KE346360.1|	1066719	1066731	ACAGAG	12	-	2	TCTGTC
gi|514486632|gb|KE346360.1|	1066968	1066985	A	17	+	17	A
gi|514486632|gb|KE346360.1|	1066994	1067010	A	16	-	16	T
gi|514486632|gb|KE346360.1|	1067154	1067178	AAAAT	24	-	4	TTATT
gi|514486632|gb|KE346360.1|	1067186	1067202	AAAAT	16	-	3	TTTTA
gi|514486632|gb|KE346360.1|	1067210	1067233	AAAAT	23	-	4	TTTTA
gi|514486632|gb|KE346360.1|	1067647	1067667	ACTC	20	+	5	TCAC
gi|514486632|gb|KE346360.1|	1068509	1068521	CCCCG	12	+	2	CCCCG
gi|514486632|gb|KE346360.1|	1068845	1068857	AAACAC	12	-	2	GTGTTT
gi|514486632|gb|KE346360.1|	1069136	1069152	AAAGC	16	-	3	CTTTG
gi|514486632|gb|KE346360.1|	1069932	1069946	A	14	+	14	A
gi|514486632|gb|KE346360.1|	1070140	1070153	AAGGAC	13	-	2	CTTGTC
gi|514486632|gb|KE346360.1|	1070209	1070225	ACGAG	16	+	3	ACGAG
gi|514486632|gb|KE346360.1|	1070290	1070304	ACAG	14	-	3	CTGT
gi|514486632|gb|KE346360.1|	1070808	1070825	A	17	+	17	A
gi|514486632|gb|KE346360.1|	1070924	1070938	AAAGC	14	+	2	AAGCA
gi|514486632|gb|KE346360.1|	1070934	1070950	AAGCGG	16	+	2	AAGCGG
gi|514486632|gb|KE346360.1|	1071017	1071032	A	15	+	15	A
gi|514486632|gb|KE346360.1|	1071068	1071081	A	13	+	13	A
gi|514486632|gb|KE346360.1|	1071105	1071117	AC	12	-	6	TG
gi|514486632|gb|KE346360.1|	1071199	1071212	AAAG	13	-	3	TTTC
gi|514486632|gb|KE346360.1|	1071568	1071580	AAAAAG	12	+	2	GAAAAA
gi|514486632|gb|KE346360.1|	1071587	1071601	AAAAT	14	+	2	AAATA
gi|514486632|gb|KE346360.1|	1071781	1071803	A	22	+	22	A
gi|514486632|gb|KE346360.1|	1071997	1072015	A	18	+	18	A
gi|514486632|gb|KE346360.1|	1072017	1072029	AAGGC	12	-	2	GCCTT
gi|514486632|gb|KE346360.1|	1072183	1072207	A	24	+	24	A
gi|514486632|gb|KE346360.1|	1072445	1072462	ACCGAG	17	-	2	TCGGTC
gi|514486632|gb|KE346360.1|	1072748	1072760	AAACGG	12	-	2	CGTTTC
gi|514486632|gb|KE346360.1|	1072784	1072796	ACCTG	12	+	2	TGACC
gi|514486632|gb|KE346360.1|	1072805	1072819	AAGAG	14	-	2	CTTCT
gi|514486632|gb|KE346360.1|	1073116	1073128	ACAGGT	12	-	2	GTACCT
gi|514486632|gb|KE346360.1|	1074599	1074612	AGCGCG	13	+	2	GCGCGA
gi|514486632|gb|KE346360.1|	1075029	1075042	AAGGCC	13	+	2	AAGGCC
gi|514486632|gb|KE346360.1|	1075139	1075151	ACAGCG	12	+	2	CAGCGA
gi|514486632|gb|KE346360.1|	1075756	1075768	AACCTC	12	-	2	GTTGAG
gi|514486632|gb|KE346360.1|	1075827	1075839	AAGTCC	12	+	2	TCCAAG
gi|514486632|gb|KE346360.1|	1076952	1076965	AAGGGC	13	+	2	AAGGGC
gi|514486632|gb|KE346360.1|	1077054	1077080	AGGG	26	-	6	CCCT
gi|514486632|gb|KE346360.1|	1077492	1077507	A	15	-	15	T
gi|514486632|gb|KE346360.1|	1078504	1078516	AAAACC	12	-	2	TTTGGT
gi|514486632|gb|KE346360.1|	1078975	1079002	AC	27	+	13	AC
gi|514486632|gb|KE346360.1|	1079127	1079139	AATG	12	-	3	TTCA
gi|514486632|gb|KE346360.1|	1081430	1081449	AAAAAC	19	+	3	AACAAA
gi|514486632|gb|KE346360.1|	1081443	1081459	AAAAC	16	+	3	ACAAA
gi|514486632|gb|KE346360.1|	1081455	1081468	A	13	+	13	A
gi|514486632|gb|KE346360.1|	1081705	1081722	AAAAAG	17	+	2	AAAAAG
gi|514486632|gb|KE346360.1|	1082534	1082561	ACAG	27	+	6	GACA
gi|514486632|gb|KE346360.1|	1082823	1082835	ACTCC	12	-	2	GGAGT
gi|514486632|gb|KE346360.1|	1083239	1083253	AGC	14	-	4	TGC
gi|514486632|gb|KE346360.1|	1083280	1083297	AACGAC	17	+	2	ACGACA
gi|514486632|gb|KE346360.1|	1083292	1083305	ACG	13	+	4	ACG
gi|514486632|gb|KE346360.1|	1083315	1083329	ACGATG	14	+	2	GACGAT
gi|514486632|gb|KE346360.1|	1083403	1083418	ACGGCG	15	+	2	ACGGCG
gi|514486632|gb|KE346360.1|	1083413	1083452	ACG	39	+	13	CGA
gi|514486632|gb|KE346360.1|	1083449	1083464	AGGGCG	15	+	2	CGAGGG
gi|514486632|gb|KE346360.1|	1083833	1083845	AAAAAC	12	-	2	TTTTTG
gi|514486632|gb|KE346360.1|	1083865	1083879	ACCCCC	14	+	2	CCACCC
gi|514486632|gb|KE346360.1|	1084666	1084698	AAC	32	-	10	TGT
gi|514486632|gb|KE346360.1|	1084696	1084729	AGC	33	-	11	TGC
gi|514486632|gb|KE346360.1|	1086018	1086030	AAC	12	+	4	ACA
gi|514486632|gb|KE346360.1|	1086865	1086882	AGC	17	-	5	GCT
gi|514486632|gb|KE346360.1|	1089891	1089910	AAC	19	-	6	TGT
gi|514486632|gb|KE346360.1|	1089932	1089945	ATCGCG	13	+	2	GCGATC
gi|514486632|gb|KE346360.1|	1090653	1090666	AAACAC	13	+	2	AACACA
gi|514486632|gb|KE346360.1|	1090896	1090908	AAC	12	-	4	GTT
gi|514486632|gb|KE346360.1|	1090903	1090917	AAAC	14	-	3	TTGT
gi|514486632|gb|KE346360.1|	1091052	1091064	AACTCC	12	-	2	TTGGAG
gi|514486632|gb|KE346360.1|	1091175	1091193	AGC	18	+	6	GCA
gi|514486632|gb|KE346360.1|	1091253	1091268	AGC	15	+	5	GCA
gi|514486632|gb|KE346360.1|	1091445	1091458	AATG	13	+	3	AATG
gi|514486632|gb|KE346360.1|	1091490	1091517	AATG	27	+	6	ATGA
gi|514486632|gb|KE346360.1|	1091597	1091610	A	13	-	13	T
gi|514486632|gb|KE346360.1|	1091823	1091854	ATC	31	-	10	ATG
gi|514486632|gb|KE346360.1|	1091893	1091905	AAAACG	12	-	2	CGTTTT
gi|514486632|gb|KE346360.1|	1092784	1092796	AAC	12	-	4	GTT
gi|514486632|gb|KE346360.1|	1093219	1093231	AAC	12	-	4	TGT
gi|514486632|gb|KE346360.1|	1093226	1093243	AACGAC	17	-	2	GTTGTC
gi|514486632|gb|KE346360.1|	1093241	1093258	AACGAC	17	-	2	GTTGTC
gi|514486632|gb|KE346360.1|	1093745	1093758	AAAAC	13	-	2	TTTGT
gi|514486632|gb|KE346360.1|	1093758	1093777	AAGC	19	-	4	CTTG
gi|514486632|gb|KE346360.1|	1094520	1094611	AAAC	91	-	22	TTTG
gi|514486632|gb|KE346360.1|	1095298	1095332	AGC	34	+	11	CAG
gi|514486632|gb|KE346360.1|	1095649	1095664	AC	15	-	7	GT
gi|514486632|gb|KE346360.1|	1095841	1095855	AAGGGG	14	+	2	GGAAGG
gi|514486632|gb|KE346360.1|	1096014	1096026	AGCTCC	12	-	2	GAGCTG
gi|514486632|gb|KE346360.1|	1096202	1096218	AGC	16	-	5	GCT
gi|514486632|gb|KE346360.1|	1096220	1096236	ACC	16	-	5	GGT
gi|514486632|gb|KE346360.1|	1096320	1096332	AGCTGC	12	+	2	GCTGCA
gi|514486632|gb|KE346360.1|	1096880	1096894	AAAAG	14	+	2	AAAAG
gi|514486632|gb|KE346360.1|	1096890	1096902	AAAAAC	12	+	2	AAAAAC
gi|514486632|gb|KE346360.1|	1097414	1097438	AG	24	-	12	TC
gi|514486632|gb|KE346360.1|	1097799	1097827	ACCAG	28	+	5	CAGAC
gi|514486632|gb|KE346360.1|	1097834	1097846	AAAGGC	12	+	2	CAAAGG
gi|514486632|gb|KE346360.1|	1098051	1098070	AG	19	+	9	AG
gi|514486632|gb|KE346360.1|	1098255	1098290	AG	35	+	17	AG
gi|514486632|gb|KE346360.1|	1098694	1098707	CCG	13	+	4	CCG
gi|514486632|gb|KE346360.1|	1098834	1098848	AAGCTC	14	+	2	GCTCAA
gi|514486632|gb|KE346360.1|	1098962	1098989	A	27	+	27	A
gi|514486632|gb|KE346360.1|	1099163	1099176	A	13	-	13	T
gi|514486632|gb|KE346360.1|	1099836	1099859	AAC	23	-	7	TTG
gi|514486632|gb|KE346360.1|	1100338	1100351	AACG	13	-	3	TTCG
gi|514486632|gb|KE346360.1|	1100477	1100489	AGG	12	+	4	GAG
gi|514486632|gb|KE346360.1|	1100669	1100681	AAAAAG	12	-	2	CTTTTT
gi|514486632|gb|KE346360.1|	1100685	1100707	A	22	-	22	T
gi|514486632|gb|KE346360.1|	1100714	1100726	AAAAGT	12	-	2	ACTTTT
gi|514486632|gb|KE346360.1|	1100768	1100781	AAGAGC	13	-	2	TCTTGC
gi|514486632|gb|KE346360.1|	1100877	1100901	A	24	+	24	A
gi|514486632|gb|KE346360.1|	1101145	1101163	AAACCC	18	-	3	TTTGGG
gi|514486632|gb|KE346360.1|	1102400	1102412	ACAGCT	12	-	2	TGTAGC
gi|514486632|gb|KE346360.1|	1102801	1102824	A	23	+	23	A
gi|514486632|gb|KE346360.1|	1103118	1103132	A	14	-	14	T
gi|514486632|gb|KE346360.1|	1103193	1103209	AACAGC	16	+	2	CAACAG
gi|514486632|gb|KE346360.1|	1103803	1103816	AGG	13	-	4	CCT
gi|514486632|gb|KE346360.1|	1104040	1104057	ACGATG	17	+	2	ACGATG
gi|514486632|gb|KE346360.1|	1104187	1104200	CCGCGG	13	+	2	GCGGCC
gi|514486632|gb|KE346360.1|	1104364	1104377	A	13	-	13	T
gi|514486632|gb|KE346360.1|	1105075	1105092	AAAAAT	17	+	2	AAAAAT
gi|514486632|gb|KE346360.1|	1105110	1105135	A	25	+	25	A
gi|514486632|gb|KE346360.1|	1105285	1105303	AAG	18	+	6	GAA
gi|514486632|gb|KE346360.1|	1105301	1105313	A	12	+	12	A
gi|514486632|gb|KE346360.1|	1105697	1105711	A	14	+	14	A
gi|514486632|gb|KE346360.1|	1105725	1105740	A	15	+	15	A
gi|514486632|gb|KE346360.1|	1106766	1106779	ACC	13	+	4	CAC
gi|514486632|gb|KE346360.1|	1107000	1107014	A	14	-	14	T
gi|514486632|gb|KE346360.1|	1107021	1107036	A	15	-	15	T
gi|514486632|gb|KE346360.1|	1107046	1107064	AAG	18	-	6	CTT
gi|514486632|gb|KE346360.1|	1108903	1108916	ATCGCC	13	+	2	CCATCG
gi|514486632|gb|KE346360.1|	1109011	1109028	AC	17	-	8	TG
gi|514486632|gb|KE346360.1|	1109873	1109887	AAG	14	-	4	TTC
gi|514486632|gb|KE346360.1|	1110538	1110550	AGCCTC	12	-	2	GAGGCT
gi|514486632|gb|KE346360.1|	1110628	1110650	AAC	22	-	7	TTG
gi|514486632|gb|KE346360.1|	1111223	1111250	AAAC	27	-	6	TTTG
gi|514486632|gb|KE346360.1|	1111253	1111268	AAAC	15	-	3	GTTT
gi|514486632|gb|KE346360.1|	1111268	1111280	C	12	-	12	G
gi|514486632|gb|KE346360.1|	1112847	1112865	A	18	-	18	T
gi|514486632|gb|KE346360.1|	1113622	1113645	AGC	23	+	7	CAG
gi|514486632|gb|KE346360.1|	1114263	1114276	AAGAGG	13	-	2	TCCTCT
gi|514486632|gb|KE346360.1|	1114345	1114368	A	23	-	23	T
gi|514486632|gb|KE346360.1|	1114419	1114432	AGGC	13	-	3	GCCT
gi|514486632|gb|KE346360.1|	1114462	1114475	AG	13	+	6	AG
gi|514486632|gb|KE346360.1|	1114841	1114853	AAAAGC	12	+	2	AAGCAA
gi|514486632|gb|KE346360.1|	1115049	1115066	A	17	-	17	T
gi|514486632|gb|KE346360.1|	1115250	1115263	A	13	-	13	T
gi|514486632|gb|KE346360.1|	1115780	1115792	AGCGGC	12	-	2	GCTGCC
gi|514486632|gb|KE346360.1|	1116312	1116324	AAAC	12	-	3	GTTT
gi|514486632|gb|KE346360.1|	1116365	1116383	AAAC	18	-	4	TTGT
gi|514486632|gb|KE346360.1|	1116710	1116722	AAAAAT	12	+	2	TAAAAA
gi|514486632|gb|KE346360.1|	1116739	1116751	A	12	+	12	A
gi|514486632|gb|KE346360.1|	1116955	1116969	A	14	-	14	T
gi|514486632|gb|KE346360.1|	1116971	1116984	A	13	-	13	T
gi|514486632|gb|KE346360.1|	1117252	1117264	AGC	12	+	4	GCA
gi|514486632|gb|KE346360.1|	1117392	1117404	A	12	+	12	A
gi|514486632|gb|KE346360.1|	1117600	1117613	A	13	-	13	T
gi|514486632|gb|KE346360.1|	1117627	1117639	A	12	-	12	T
gi|514486632|gb|KE346360.1|	1117835	1117873	A	38	-	38	T
gi|514486632|gb|KE346360.1|	1117974	1117986	AAGGAC	12	-	2	CCTTGT
gi|514486632|gb|KE346360.1|	1118086	1118098	AACGAC	12	+	2	GACAAC
gi|514486632|gb|KE346360.1|	1118178	1118199	ACG	21	+	7	CGA
gi|514486632|gb|KE346360.1|	1118197	1118214	ATC	17	-	5	GAT
gi|514486632|gb|KE346360.1|	1118212	1118226	ACG	14	+	4	GAC
gi|514486632|gb|KE346360.1|	1121108	1121129	AAC	21	-	7	TTG
gi|514486632|gb|KE346360.1|	1122628	1122640	ACGCCG	12	-	2	CGGCGT
gi|514486632|gb|KE346360.1|	1123480	1123495	AAAC	15	+	3	AAAC
gi|514486632|gb|KE346360.1|	1123489	1123502	AAAAAC	13	+	2	AACAAA
gi|514486632|gb|KE346360.1|	1123814	1123829	A	15	+	15	A
gi|514486632|gb|KE346360.1|	1124359	1124372	AACATG	13	+	2	ATGAAC
gi|514486632|gb|KE346360.1|	1124452	1124474	AC	22	+	11	AC
gi|514486632|gb|KE346360.1|	1124505	1124518	AC	13	+	6	AC
gi|514486632|gb|KE346360.1|	1125004	1125026	AACG	22	+	5	AACG
gi|514486632|gb|KE346360.1|	1125030	1125042	AAAGG	12	+	2	AAAGG
gi|514486632|gb|KE346360.1|	1125459	1125473	AAAAGC	14	+	2	CAAAAG
gi|514486632|gb|KE346360.1|	1128122	1128136	AAAAT	14	+	2	AAAAT
gi|514486632|gb|KE346360.1|	1128841	1128854	AGAGCC	13	-	2	GCTCTG
gi|514486632|gb|KE346360.1|	1129965	1129977	AAGCAG	12	-	2	GCTTCT
gi|514486632|gb|KE346360.1|	1130095	1130107	AAAAAC	12	-	2	TTTTGT
gi|514486632|gb|KE346360.1|	1130305	1130319	AAAAG	14	-	2	TTTTC
gi|514486632|gb|KE346360.1|	1130315	1130330	A	15	-	15	T
gi|514486632|gb|KE346360.1|	1130771	1130787	A	16	-	16	T
gi|514486632|gb|KE346360.1|	1130795	1130807	A	12	-	12	T
gi|514486632|gb|KE346360.1|	1131044	1131057	AGCC	13	+	3	CCAG
gi|514486632|gb|KE346360.1|	1131326	1131349	A	23	-	23	T
gi|514486632|gb|KE346360.1|	1132150	1132164	AGCTCC	14	-	2	CTGGAG
gi|514486632|gb|KE346360.1|	1132253	1132265	AAGAGC	12	-	2	TCTTGC
gi|514486632|gb|KE346360.1|	1136229	1136242	AAAAC	13	-	2	TGTTT
gi|514486632|gb|KE346360.1|	1137251	1137266	AAC	15	+	5	ACA
gi|514486632|gb|KE346360.1|	1137267	1137393	AAC	126	+	42	CAA
gi|514486632|gb|KE346360.1|	1137479	1137491	AATCG	12	+	2	GAATC
gi|514486632|gb|KE346360.1|	1138107	1138119	AAGAG	12	+	2	AAGAG
gi|514486632|gb|KE346360.1|	1138925	1138937	AATGTG	12	-	2	TTCACA
gi|514486632|gb|KE346360.1|	1139303	1139315	AGCATG	12	+	2	GAGCAT
gi|514486632|gb|KE346360.1|	1139421	1139434	AAGTGC	13	+	2	TGCAAG
gi|514486632|gb|KE346360.1|	1140282	1140294	ACAGTC	12	+	2	GTCACA
gi|514486632|gb|KE346360.1|	1140347	1140365	A	18	-	18	T
gi|514486632|gb|KE346360.1|	1140505	1140525	A	20	+	20	A
gi|514486632|gb|KE346360.1|	1140616	1140630	AGCTC	14	-	2	GCTGA
gi|514486632|gb|KE346360.1|	1140755	1140772	A	17	+	17	A
gi|514486632|gb|KE346360.1|	1140786	1140803	AACTC	17	-	3	AGTTG
gi|514486632|gb|KE346360.1|	1142103	1142119	AGC	16	+	5	CAG
gi|514486632|gb|KE346360.1|	1142222	1142234	AGCAGG	12	+	2	GGAGCA
gi|514486632|gb|KE346360.1|	1142466	1142478	AAACGG	12	+	2	ACGGAA
gi|514486632|gb|KE346360.1|	1143509	1143525	ACTGCG	16	-	2	GCAGTC
gi|514486632|gb|KE346360.1|	1143573	1143587	AGC	14	+	4	CAG
gi|514486632|gb|KE346360.1|	1143715	1143727	ACTC	12	+	3	CTCA
gi|514486632|gb|KE346360.1|	1143738	1143754	AC	16	-	8	TG
gi|514486632|gb|KE346360.1|	1144020	1144039	ACTG	19	+	4	ACTG
gi|514486632|gb|KE346360.1|	1144040	1144052	ACCCCC	12	-	2	TGGGGG
gi|514486632|gb|KE346360.1|	1144074	1144089	AG	15	-	7	CT
gi|514486632|gb|KE346360.1|	1144841	1144856	A	15	-	15	T
gi|514486632|gb|KE346360.1|	1145177	1145191	AAACC	14	-	2	TTTGG
gi|514486632|gb|KE346360.1|	1145709	1145723	AG	14	+	7	AG
gi|514486632|gb|KE346360.1|	1145895	1145907	ACGGGG	12	+	2	GACGGG
gi|514486632|gb|KE346360.1|	1146571	1146592	A	21	-	21	T
gi|514486632|gb|KE346360.1|	1146588	1146602	AAAAG	14	-	2	TTTTC
gi|514486632|gb|KE346360.1|	1147721	1147734	AACC	13	+	3	AACC
gi|514486632|gb|KE346360.1|	1147730	1147748	ACC	18	+	6	ACC
gi|514486632|gb|KE346360.1|	1147916	1147928	AAC	12	+	4	CAA
gi|514486632|gb|KE346360.1|	1147941	1147953	AAAAAC	12	+	2	AAAACA
gi|514486632|gb|KE346360.1|	1148186	1148199	AAGCC	13	+	2	CAAGC
gi|514486632|gb|KE346360.1|	1148455	1148468	AGC	13	-	4	TGC
gi|514486632|gb|KE346360.1|	1150349	1150361	AATCC	12	+	2	CAATC
gi|514486632|gb|KE346360.1|	1150983	1151013	CCG	30	+	10	GCC
gi|514486632|gb|KE346360.1|	1151533	1151546	AGCCGC	13	-	2	TGCGGC
gi|514486632|gb|KE346360.1|	1152013	1152036	AACCCG	23	+	3	CCCGAA
gi|514486632|gb|KE346360.1|	1152044	1152060	ACCCTG	16	+	2	CTGACC
gi|514486632|gb|KE346360.1|	1154348	1154360	AAAAC	12	+	2	AAACA
gi|514486632|gb|KE346360.1|	1155245	1155257	AGCATG	12	+	2	AGCATG
gi|514486632|gb|KE346360.1|	1156108	1156121	ACCG	13	+	3	ACCG
gi|514486632|gb|KE346360.1|	1156273	1156290	AAG	17	-	5	TCT
gi|514486632|gb|KE346360.1|	1156292	1156305	ACAG	13	-	3	TCTG
gi|514486632|gb|KE346360.1|	1156528	1156575	AG	47	-	23	TC
gi|514486632|gb|KE346360.1|	1156660	1156675	AAGACG	15	+	2	ACGAAG
gi|514486632|gb|KE346360.1|	1156690	1156702	ACTG	12	-	3	GTCA
gi|514486632|gb|KE346360.1|	1156920	1156934	AAAAAC	14	-	2	TGTTTT
gi|514486632|gb|KE346360.1|	1157037	1157052	AACG	15	+	3	AACG
gi|514486632|gb|KE346360.1|	1157067	1157114	A	47	+	47	A
gi|514486632|gb|KE346360.1|	1157111	1157126	AAAG	15	+	3	AAAG
gi|514486632|gb|KE346360.1|	1157945	1158002	AAC	57	-	19	TTG
gi|514486632|gb|KE346360.1|	1158314	1158330	A	16	-	16	T
gi|514486632|gb|KE346360.1|	1158332	1158346	A	14	-	14	T
gi|514486632|gb|KE346360.1|	1159204	1159227	AGC	23	-	7	TGC
gi|514486632|gb|KE346360.1|	1160650	1160669	AAC	19	-	6	TTG
gi|514486632|gb|KE346360.1|	1160670	1160684	AAC	14	-	4	GTT
gi|514486632|gb|KE346360.1|	1160721	1160736	AC	15	-	7	TG
gi|514486632|gb|KE346360.1|	1161357	1161369	ACTCAG	12	+	2	TCAGAC
gi|514486632|gb|KE346360.1|	1161468	1161480	AAAAAC	12	+	2	CAAAAA
gi|514486632|gb|KE346360.1|	1162101	1162114	AATGCC	13	+	2	TGCCAA
gi|514486632|gb|KE346360.1|	1162389	1162402	A	13	+	13	A
gi|514486632|gb|KE346360.1|	1162817	1162833	AGAGC	16	+	3	AGCAG
gi|514486632|gb|KE346360.1|	1163212	1163225	AGC	13	+	4	GCA
gi|514486632|gb|KE346360.1|	1163328	1163341	AAACTG	13	+	2	AAACTG
gi|514486632|gb|KE346360.1|	1163518	1163550	AAGCAG	32	-	5	CTTCTG
gi|514486632|gb|KE346360.1|	1164301	1164313	AGCGCC	12	+	2	GCGCCA
gi|514486632|gb|KE346360.1|	1165978	1165990	AGC	12	+	4	AGC
gi|514486632|gb|KE346360.1|	1170169	1170182	ACGGCG	13	+	2	CGGCGA
gi|514486632|gb|KE346360.1|	1170349	1170363	A	14	-	14	T
gi|514486632|gb|KE346360.1|	1170764	1170784	AC	20	-	10	TG
gi|514486632|gb|KE346360.1|	1170916	1170939	ACTGC	23	-	4	TGCAG
gi|514486632|gb|KE346360.1|	1171797	1171809	A	12	-	12	T
gi|514486632|gb|KE346360.1|	1172119	1172136	AGCGGC	17	+	2	GCAGCG
gi|514486632|gb|KE346360.1|	1172241	1172257	A	16	+	16	A
gi|514486632|gb|KE346360.1|	1172538	1172550	AAGGGC	12	-	2	CCCTTG
gi|514486632|gb|KE346360.1|	1173217	1173231	AAG	14	-	4	TCT
gi|514486632|gb|KE346360.1|	1173759	1173772	AAGCTC	13	+	2	AGCTCA
gi|514486632|gb|KE346360.1|	1174789	1174802	AAGGCC	13	-	2	CCTTGG
gi|514486632|gb|KE346360.1|	1174974	1174986	AAGATC	12	-	2	ATCTTG
gi|514486632|gb|KE346360.1|	1175239	1175251	AAGGGC	12	-	2	CCTTGC
gi|514486632|gb|KE346360.1|	1175963	1175975	AAGGAC	12	+	2	CAAGGA
gi|514486632|gb|KE346360.1|	1176276	1176290	A	14	+	14	A
gi|514486632|gb|KE346360.1|	1176371	1176385	ACCTC	14	+	2	CACCT
gi|514486632|gb|KE346360.1|	1176513	1176527	AAACC	14	+	2	AAACC
gi|514486632|gb|KE346360.1|	1176710	1176722	AAACG	12	-	2	CGTTT
gi|514486632|gb|KE346360.1|	1176906	1176920	AAAGG	14	+	2	GAAAG
gi|514486632|gb|KE346360.1|	1176938	1176953	A	15	+	15	A
gi|514486632|gb|KE346360.1|	1177055	1177078	AAG	23	+	7	AAG
gi|514486632|gb|KE346360.1|	1177076	1177090	A	14	+	14	A
gi|514486632|gb|KE346360.1|	1177127	1177139	AAACG	12	+	2	AAACG
gi|514486632|gb|KE346360.1|	1177382	1177395	AAGGGC	13	-	2	CTTGCC
gi|514486632|gb|KE346360.1|	1178176	1178188	AGGGCG	12	+	2	AGGGCG
gi|514486632|gb|KE346360.1|	1178924	1178940	AAGG	16	+	4	AAGG
gi|514486632|gb|KE346360.1|	1178971	1179006	A	35	+	35	A
gi|514486632|gb|KE346360.1|	1180149	1180161	AAGGC	12	-	2	GCCTT
gi|514486632|gb|KE346360.1|	1180962	1180974	A	12	+	12	A
gi|514486632|gb|KE346360.1|	1180980	1180997	AAAAAG	17	+	2	AAAAAG
gi|514486632|gb|KE346360.1|	1181017	1181034	AAAAAG	17	+	2	AAAAAG
gi|514486632|gb|KE346360.1|	1181061	1181077	ATCGCC	16	-	2	GATGGC
gi|514486632|gb|KE346360.1|	1181151	1181167	AACAAG	16	+	2	AGAACA
gi|514486632|gb|KE346360.1|	1181180	1181201	A	21	+	21	A
gi|514486632|gb|KE346360.1|	1182186	1182202	AGC	16	-	5	TGC
gi|514486632|gb|KE346360.1|	1182984	1182996	ACGCAG	12	+	2	CAGACG
gi|514486632|gb|KE346360.1|	1183015	1183027	AGGATG	12	+	2	GGATGA
gi|514486632|gb|KE346360.1|	1184075	1184087	AAAATC	12	+	2	TCAAAA
gi|514486632|gb|KE346360.1|	1184548	1184561	ACC	13	-	4	GTG
gi|514486632|gb|KE346360.1|	1184603	1184634	A	31	-	31	T
gi|514486632|gb|KE346360.1|	1184745	1184757	ATCGCG	12	+	2	GATCGC
gi|514486632|gb|KE346360.1|	1185515	1185528	ACACC	13	+	2	CCACA
gi|514486632|gb|KE346360.1|	1187005	1187017	CCG	12	+	4	CCG
gi|514486632|gb|KE346360.1|	1187755	1187768	A	13	-	13	T
gi|514486632|gb|KE346360.1|	1187766	1187778	AACAGC	12	-	2	TTGCTG
gi|514486632|gb|KE346360.1|	1188002	1188019	ATC	17	-	5	GAT
gi|514486632|gb|KE346360.1|	1188209	1188222	CCG	13	-	4	GCG
gi|514486632|gb|KE346360.1|	1188345	1188362	ACCTGC	17	+	2	CTGCAC
gi|514486632|gb|KE346360.1|	1188912	1188924	ATGCCC	12	-	2	CATGGG
gi|514486632|gb|KE346360.1|	1189026	1189038	AGC	12	+	4	GCA
gi|514486632|gb|KE346360.1|	1189044	1189063	AGC	19	+	6	GCA
gi|514486632|gb|KE346360.1|	1189796	1189819	AC	23	-	11	TG
gi|514486632|gb|KE346360.1|	1189814	1189831	AAACAC	17	-	2	TGTGTT
gi|514486632|gb|KE346360.1|	1190633	1190649	AATG	16	-	4	TTCA
gi|514486632|gb|KE346360.1|	1190731	1190745	ACC	14	-	4	TGG
gi|514486632|gb|KE346360.1|	1191244	1191256	AACAGC	12	-	2	TTGCTG
gi|514486632|gb|KE346360.1|	1191340	1191352	ACCAGC	12	-	2	GTGCTG
gi|514486632|gb|KE346360.1|	1191356	1191370	AGC	14	-	4	TGC
gi|514486632|gb|KE346360.1|	1191371	1191415	AGC	44	-	14	TGC
gi|514486632|gb|KE346360.1|	1191437	1191449	AGC	12	-	4	TGC
gi|514486632|gb|KE346360.1|	1192922	1192942	AACAGC	20	-	3	TGTTGC
gi|514486632|gb|KE346360.1|	1193698	1193710	ACG	12	-	4	GTC
gi|514486632|gb|KE346360.1|	1193708	1193722	AAGAGG	14	-	2	TCCTCT
gi|514486632|gb|KE346360.1|	1194278	1194305	AGC	27	-	9	TGC
gi|514486632|gb|KE346360.1|	1194530	1194542	A	12	+	12	A
gi|514486632|gb|KE346360.1|	1194884	1194906	A	22	+	22	A
gi|514486632|gb|KE346360.1|	1195106	1195120	A	14	+	14	A
gi|514486632|gb|KE346360.1|	1195143	1195155	A	12	+	12	A
gi|514486632|gb|KE346360.1|	1195322	1195345	A	23	+	23	A
gi|514486632|gb|KE346360.1|	1195436	1195450	AG	14	+	7	GA
gi|514486632|gb|KE346360.1|	1195705	1195717	AAACAC	12	+	2	CAAACA
gi|514486632|gb|KE346360.1|	1195712	1195726	AAAAAC	14	+	2	AAACAA
gi|514486632|gb|KE346360.1|	1195729	1195750	AAAAAC	21	+	3	AAAAAC
gi|514486632|gb|KE346360.1|	1196054	1196066	AGGCGG	12	-	2	CCTCCG
gi|514486632|gb|KE346360.1|	1197597	1197613	A	16	+	16	A
gi|514486632|gb|KE346360.1|	1197646	1197672	A	26	+	26	A
gi|514486632|gb|KE346360.1|	1197680	1197703	A	23	-	23	T
gi|514486632|gb|KE346360.1|	1197860	1197881	AG	21	+	10	GA
gi|514486632|gb|KE346360.1|	1197900	1197918	AGG	18	+	6	GAG
gi|514486632|gb|KE346360.1|	1198732	1198745	ACGAGG	13	+	2	GAGGAC
gi|514486632|gb|KE346360.1|	1198978	1198992	ACGATG	14	-	2	TCGTCA
gi|514486632|gb|KE346360.1|	1199281	1199294	ATCGCG	13	+	2	CGATCG
gi|514486632|gb|KE346360.1|	1200933	1200950	AAAACC	17	+	2	CAAAAC
gi|514486632|gb|KE346360.1|	1201135	1201147	ACGTGC	12	+	2	TGCACG
gi|514486632|gb|KE346360.1|	1201331	1201345	AACACC	14	-	2	TGTTGG
gi|514486632|gb|KE346360.1|	1202014	1202028	AGC	14	+	4	AGC
gi|514486632|gb|KE346360.1|	1202101	1202115	AGC	14	-	4	CTG
gi|514486632|gb|KE346360.1|	1202143	1202155	AGCCG	12	-	2	GCTCG
gi|514486632|gb|KE346360.1|	1202250	1202268	A	18	+	18	A
gi|514486632|gb|KE346360.1|	1202428	1202440	AAC	12	-	4	TTG
gi|514486632|gb|KE346360.1|	1203143	1203158	A	15	-	15	T
gi|514486632|gb|KE346360.1|	1204161	1204173	A	12	+	12	A
gi|514486632|gb|KE346360.1|	1205547	1205560	AACGC	13	-	2	TTGCG
gi|514486632|gb|KE346360.1|	1205859	1205871	A	12	-	12	T
gi|514486632|gb|KE346360.1|	1205894	1205906	AACGAG	12	-	2	CTCGTT
gi|514486632|gb|KE346360.1|	1206206	1206218	AATGCC	12	+	2	ATGCCA
gi|514486632|gb|KE346360.1|	1207621	1207654	ACG	33	-	11	CGT
gi|514486632|gb|KE346360.1|	1207752	1207764	AGAGCG	12	-	2	CGCTCT
gi|514486632|gb|KE346360.1|	1207772	1207792	ACTGCT	20	+	3	CTACTG
gi|514486632|gb|KE346360.1|	1207787	1207814	AGC	27	-	9	CTG
gi|514486632|gb|KE346360.1|	1208048	1208065	AAAAAG	17	+	2	AAAAAG
gi|514486632|gb|KE346360.1|	1208069	1208081	AATG	12	+	3	ATGA
gi|514486632|gb|KE346360.1|	1208128	1208147	AAC	19	+	6	AAC
gi|514486632|gb|KE346360.1|	1208269	1208303	AAGGTC	34	-	5	TGACCT
gi|514486632|gb|KE346360.1|	1208422	1208434	ATCATG	12	+	2	CATGAT
gi|514486632|gb|KE346360.1|	1208455	1208467	CCCCG	12	-	2	CGGGG
gi|514486632|gb|KE346360.1|	1209347	1209359	ACCCGT	12	+	2	ACCCGT
gi|514486632|gb|KE346360.1|	1209673	1209693	A	20	-	20	T
gi|514486632|gb|KE346360.1|	1210055	1210067	ACG	12	+	4	ACG
gi|514486632|gb|KE346360.1|	1210537	1210551	AG	14	+	7	GA
gi|514486632|gb|KE346360.1|	1210583	1210595	AAAAC	12	-	2	TTTGT
gi|514486632|gb|KE346360.1|	1210823	1210845	ATC	22	+	7	CAT
gi|514486632|gb|KE346360.1|	1211138	1211160	AGC	22	-	7	CTG
gi|514486632|gb|KE346360.1|	1212066	1212078	AGGCCG	12	-	2	CTCGGC
gi|514486632|gb|KE346360.1|	1212903	1212920	AAAAC	17	-	3	TTGTT
gi|514486632|gb|KE346360.1|	1212942	1212956	AAAAC	14	-	2	TTTTG
gi|514486632|gb|KE346360.1|	1213383	1213398	AGC	15	-	5	GCT
gi|514486632|gb|KE346360.1|	1213488	1213500	AAGCCC	12	-	2	GGCTTG
gi|514486632|gb|KE346360.1|	1213887	1213899	ACACT	12	-	2	GTGTA
gi|514486632|gb|KE346360.1|	1214605	1214618	ACTCGC	13	-	2	GCGAGT
gi|514486632|gb|KE346360.1|	1214784	1214796	AAGGCC	12	-	2	GCCTTG
gi|514486632|gb|KE346360.1|	1214920	1214933	AAACGC	13	-	2	CGTTTG
gi|514486632|gb|KE346360.1|	1215439	1215454	AGCG	15	-	3	TCGC
gi|514486632|gb|KE346360.1|	1215457	1215475	A	18	+	18	A
gi|514486632|gb|KE346360.1|	1215667	1215690	A	23	+	23	A
gi|514486632|gb|KE346360.1|	1216178	1216190	A	12	-	12	T
gi|514486632|gb|KE346360.1|	1219697	1219709	AAAC	12	+	3	CAAA
gi|514486632|gb|KE346360.1|	1219982	1219994	AAAGTG	12	-	2	TCACTT
gi|514486632|gb|KE346360.1|	1220501	1220517	AGGATG	16	+	2	GATGAG
gi|514486632|gb|KE346360.1|	1220670	1220690	AATCTC	20	-	3	TTGAGA
gi|514486632|gb|KE346360.1|	1222049	1222061	A	12	+	12	A
gi|514486632|gb|KE346360.1|	1222187	1222199	AACGAC	12	-	2	TGTCGT
gi|514486632|gb|KE346360.1|	1222448	1222477	AC	29	-	14	GT
gi|514486632|gb|KE346360.1|	1222928	1222952	AGC	24	+	8	GCA
gi|514486632|gb|KE346360.1|	1223240	1223257	A	17	+	17	A
gi|514486632|gb|KE346360.1|	1223937	1223961	A	24	+	24	A
gi|514486632|gb|KE346360.1|	1224245	1224258	ACAGGC	13	-	2	GCCTGT
gi|514486632|gb|KE346360.1|	1224730	1224744	AAACTG	14	+	2	CTGAAA
gi|514486632|gb|KE346360.1|	1224921	1224934	AATGGC	13	-	2	TGCCAT
gi|514486632|gb|KE346360.1|	1224979	1224997	AAAC	18	-	4	TTGT
gi|514486632|gb|KE346360.1|	1226457	1226480	AGC	23	+	7	AGC
gi|514486632|gb|KE346360.1|	1226551	1226563	ACCAGC	12	+	2	CCAGCA
gi|514486632|gb|KE346360.1|	1226879	1226893	A	14	+	14	A
gi|514486632|gb|KE346360.1|	1227001	1227014	AACAGC	13	+	2	ACAGCA
gi|514486632|gb|KE346360.1|	1227229	1227242	AG	13	+	6	AG
gi|514486632|gb|KE346360.1|	1227256	1227286	AAG	30	-	10	TTC
gi|514486632|gb|KE346360.1|	1227408	1227427	A	19	+	19	A
gi|514486632|gb|KE346360.1|	1227459	1227471	A	12	+	12	A
gi|514486632|gb|KE346360.1|	1227617	1227629	AGCGGC	12	+	2	GCAGCG
gi|514486632|gb|KE346360.1|	1227781	1227800	ATC	19	-	6	ATG
gi|514486632|gb|KE346360.1|	1227853	1227867	AAAGAG	14	+	2	AAGAGA
gi|514486632|gb|KE346360.1|	1227970	1227991	AAC	21	-	7	TTG
gi|514486632|gb|KE346360.1|	1228349	1228362	AATGCC	13	-	2	GGCATT
gi|514486632|gb|KE346360.1|	1228759	1228772	AAC	13	-	4	TGT
gi|514486632|gb|KE346360.1|	1229269	1229281	AGCC	12	-	3	GGCT
gi|514486632|gb|KE346360.1|	1230159	1230173	CCCCG	14	-	2	GGGGC
gi|514486632|gb|KE346360.1|	1231006	1231021	AC	15	-	7	GT
gi|514486632|gb|KE346360.1|	1232566	1232580	AAAAC	14	+	2	AAAAC
gi|514486632|gb|KE346360.1|	1233453	1233466	AATGC	13	+	2	CAATG
gi|514486632|gb|KE346360.1|	1233465	1233479	ACCTC	14	-	2	AGGTG
gi|514486632|gb|KE346360.1|	1233920	1233933	ACACTC	13	-	2	TGAGTG
gi|514486632|gb|KE346360.1|	1234043	1234057	AAAGTC	14	+	2	TCAAAG
gi|514486632|gb|KE346360.1|	1234166	1234179	AAAAAG	13	+	2	AAAAAG
gi|514486632|gb|KE346360.1|	1234849	1234868	AAAC	19	+	4	AAAC
gi|514486632|gb|KE346360.1|	1234974	1234991	ACGCCG	17	+	2	CGCCGA
gi|514486632|gb|KE346360.1|	1235994	1236006	AAGGTG	12	+	2	GAAGGT
gi|514486632|gb|KE346360.1|	1238361	1238373	AAC	12	-	4	TTG
gi|514486632|gb|KE346360.1|	1238377	1238409	AGC	32	-	10	TGC
gi|514486632|gb|KE346360.1|	1239666	1239692	AAAC	26	+	6	AACA
gi|514486632|gb|KE346360.1|	1240582	1240604	A	22	+	22	A
gi|514486632|gb|KE346360.1|	1240763	1240776	AGGG	13	+	3	GAGG
gi|514486632|gb|KE346360.1|	1240824	1240836	A	12	-	12	T
gi|514486632|gb|KE346360.1|	1242087	1242100	AACGCC	13	-	2	CGTTGG
gi|514486632|gb|KE346360.1|	1243305	1243317	ATCC	12	-	3	GATG
gi|514486632|gb|KE346360.1|	1243816	1243828	AGC	12	+	4	CAG
gi|514486632|gb|KE346360.1|	1243829	1243845	AGC	16	+	5	AGC
gi|514486632|gb|KE346360.1|	1243939	1243951	AACAGC	12	+	2	CAGCAA
gi|514486632|gb|KE346360.1|	1244045	1244073	AAAC	28	-	7	TTGT
gi|514486632|gb|KE346360.1|	1246657	1246670	AACGCC	13	-	2	CGTTGG
gi|514486632|gb|KE346360.1|	1247875	1247887	ATCC	12	-	3	GATG
gi|514486632|gb|KE346360.1|	1248386	1248398	AGC	12	+	4	CAG
gi|514486632|gb|KE346360.1|	1248399	1248415	AGC	16	+	5	AGC
gi|514486632|gb|KE346360.1|	1248509	1248521	AACAGC	12	+	2	CAGCAA
gi|514486632|gb|KE346360.1|	1248615	1248643	AAAC	28	-	7	TTGT
gi|514486632|gb|KE346360.1|	1250239	1250252	ACCAGC	13	-	2	GCTGGT
gi|514486632|gb|KE346360.1|	1251597	1251611	AAC	14	-	4	TGT
gi|514486632|gb|KE346360.1|	1251867	1251885	A	18	-	18	T
gi|514486632|gb|KE346360.1|	1251967	1251981	C	14	-	14	G
gi|514486632|gb|KE346360.1|	1252124	1252142	A	18	+	18	A
gi|514486632|gb|KE346360.1|	1252329	1252351	A	22	+	22	A
gi|514486632|gb|KE346360.1|	1252546	1252578	A	32	-	32	T
gi|514486632|gb|KE346360.1|	1252605	1252617	ACTCAG	12	-	2	TGAGTC
gi|514486632|gb|KE346360.1|	1252935	1252958	A	23	-	23	T
gi|514486632|gb|KE346360.1|	1252997	1253009	AATCTC	12	+	2	ATCTCA
gi|514486632|gb|KE346360.1|	1253560	1253573	AAGCTC	13	+	2	CAAGCT
gi|514486632|gb|KE346360.1|	1254406	1254419	AACAC	13	-	2	TGTGT
gi|514486632|gb|KE346360.1|	1254654	1254666	AAACAC	12	+	2	ACAAAC
gi|514486632|gb|KE346360.1|	1254674	1254693	AGGGGG	19	+	3	GGGGGA
gi|514486632|gb|KE346360.1|	1256442	1256525	AAC	83	+	27	CAA
gi|514486632|gb|KE346360.1|	1256926	1256939	CG	13	+	6	CG
gi|514486632|gb|KE346360.1|	1257070	1257087	CCCCG	17	+	3	GCCCC
gi|514486632|gb|KE346360.1|	1257119	1257132	AC	13	+	6	AC
gi|514486632|gb|KE346360.1|	1257190	1257203	AAACAC	13	+	2	AACACA
gi|514486632|gb|KE346360.1|	1257255	1257279	AAGC	24	+	6	GCAA
gi|514486632|gb|KE346360.1|	1257522	1257554	AAGG	32	+	8	GGAA
gi|514486632|gb|KE346360.1|	1257669	1257681	AAATGT	12	-	2	ACATTT
gi|514486632|gb|KE346360.1|	1257848	1257866	AC	18	-	9	TG
gi|514486632|gb|KE346360.1|	1258086	1258098	AAAAC	12	+	2	AACAA
gi|514486632|gb|KE346360.1|	1258125	1258144	AAAG	19	+	4	AAAG
gi|514486632|gb|KE346360.1|	1258279	1258300	AGCG	21	+	5	GAGC
gi|514486632|gb|KE346360.1|	1258314	1258327	AACTCG	13	+	2	AACTCG
gi|514486632|gb|KE346360.1|	1258615	1258636	CCCCCG	21	-	3	GGGCGG
gi|514486632|gb|KE346360.1|	1258685	1258702	ACTC	17	+	4	CACT
gi|514486632|gb|KE346360.1|	1259105	1259117	ACGC	12	-	3	GTGC
gi|514486632|gb|KE346360.1|	1259120	1259136	A	16	-	16	T
gi|514486632|gb|KE346360.1|	1260931	1260948	ACT	17	+	5	ACT
gi|514486632|gb|KE346360.1|	1261762	1261788	ATC	26	+	8	TCA
gi|514486632|gb|KE346360.1|	1263002	1263017	AAAGAG	15	+	2	AGAGAA
gi|514486632|gb|KE346360.1|	1263021	1263036	AG	15	+	7	GA
gi|514486632|gb|KE346360.1|	1263120	1263133	AAAAC	13	+	2	CAAAA
gi|514486632|gb|KE346360.1|	1263201	1263228	ACT	27	-	9	AGT
gi|514486632|gb|KE346360.1|	1263547	1263560	AAAAAC	13	+	2	AAAAAC
gi|514486632|gb|KE346360.1|	1263610	1263625	AGAGCC	15	+	2	GAGCCA
gi|514486632|gb|KE346360.1|	1264055	1264067	AAC	12	+	4	AAC
gi|514486632|gb|KE346360.1|	1265551	1265564	AAAAGG	13	-	2	TCCTTT
gi|514486632|gb|KE346360.1|	1265852	1265864	ACGCTG	12	-	2	TCAGCG
gi|514486632|gb|KE346360.1|	1267996	1268013	ACGATG	17	-	2	TCGTCA
gi|514486632|gb|KE346360.1|	1268026	1268040	ACGATG	14	-	2	TCGTCA
gi|514486632|gb|KE346360.1|	1268049	1268061	AGG	12	+	4	GGA
gi|514486632|gb|KE346360.1|	1268255	1268267	AAAAGC	12	-	2	GCTTTT
gi|514486632|gb|KE346360.1|	1270147	1270159	AAAAC	12	+	2	AAACA
gi|514486632|gb|KE346360.1|	1270153	1270171	AAAC	18	+	4	AACA
gi|514486632|gb|KE346360.1|	1270252	1270272	AAC	20	-	6	GTT
gi|514486632|gb|KE346360.1|	1270415	1270430	ATC	15	+	5	TCA
gi|514486632|gb|KE346360.1|	1270492	1270505	AAATC	13	+	2	AAATC
gi|514486632|gb|KE346360.1|	1270499	1270512	AAAATC	13	+	2	ATCAAA
gi|514486632|gb|KE346360.1|	1270509	1270521	AAAAT	12	+	2	AAAAT
gi|514486632|gb|KE346360.1|	1270559	1270573	AG	14	+	7	AG
gi|514486632|gb|KE346360.1|	1270568	1270591	AGAGGG	23	+	3	GAGAGG
gi|514486632|gb|KE346360.1|	1270604	1270617	AAACG	13	+	2	AACGA
gi|514486632|gb|KE346360.1|	1270689	1270709	A	20	+	20	A
gi|514486632|gb|KE346360.1|	1271118	1271130	A	12	+	12	A
gi|514486632|gb|KE346360.1|	1271334	1271349	A	15	-	15	T
gi|514486632|gb|KE346360.1|	1271350	1271362	AAACAC	12	-	2	TGTGTT
gi|514486632|gb|KE346360.1|	1271376	1271388	AAC	12	-	4	TGT
gi|514486632|gb|KE346360.1|	1271441	1271453	AACCAG	12	-	2	CTGGTT
gi|514486632|gb|KE346360.1|	1271606	1271618	ACACGT	12	-	2	CGTGTA
gi|514486632|gb|KE346360.1|	1271877	1271890	ATCC	13	-	3	GGAT
gi|514486632|gb|KE346360.1|	1272211	1272223	A	12	-	12	T
gi|514486632|gb|KE346360.1|	1272225	1272238	AACG	13	-	3	TCGT
gi|514486632|gb|KE346360.1|	1272979	1272998	AAG	19	-	6	TTC
gi|514486632|gb|KE346360.1|	1274392	1274405	AG	13	-	6	CT
gi|514486632|gb|KE346360.1|	1274483	1274496	ACCCG	13	+	2	GACCC
gi|514486632|gb|KE346360.1|	1274704	1274716	ACTGCG	12	+	2	GACTGC
gi|514486632|gb|KE346360.1|	1275164	1275176	ACC	12	+	4	CCA
gi|514486632|gb|KE346360.1|	1275908	1275922	AAAAAC	14	+	2	AAAACA
gi|514486632|gb|KE346360.1|	1275916	1275946	AAAC	30	+	7	AACA
gi|514486632|gb|KE346360.1|	1275944	1275957	AAAAAC	13	+	2	AAAAAC
gi|514486632|gb|KE346360.1|	1276565	1276579	AAGCGC	14	+	2	GCAAGC
gi|514486632|gb|KE346360.1|	1277858	1277870	AAGG	12	-	3	CCTT
gi|514486632|gb|KE346360.1|	1280221	1280233	ACTG	12	-	3	TCAG
gi|514486632|gb|KE346360.1|	1280236	1280250	AAAACC	14	-	2	TTTGGT
gi|514486632|gb|KE346360.1|	1280270	1280285	A	15	+	15	A
gi|514486632|gb|KE346360.1|	1280595	1280607	ACTGCC	12	+	2	CTGCCA
gi|514486632|gb|KE346360.1|	1280929	1280968	AG	39	+	19	AG
gi|514486632|gb|KE346360.1|	1281028	1281040	ATCGCG	12	+	2	GCGATC
gi|514486632|gb|KE346360.1|	1281277	1281319	A	42	+	42	A
gi|514486632|gb|KE346360.1|	1281563	1281579	A	16	-	16	T
gi|514486632|gb|KE346360.1|	1281768	1281790	A	22	-	22	T
gi|514486632|gb|KE346360.1|	1282097	1282115	AC	18	-	9	TG
gi|514486632|gb|KE346360.1|	1282376	1282400	A	24	-	24	T
gi|514486632|gb|KE346360.1|	1282418	1282431	A	13	-	13	T
gi|514486632|gb|KE346360.1|	1282469	1282481	AAC	12	+	4	ACA
gi|514486632|gb|KE346360.1|	1282482	1282505	AAC	23	+	7	CAA
gi|514486632|gb|KE346360.1|	1282502	1282514	AC	12	+	6	AC
gi|514486632|gb|KE346360.1|	1282576	1282588	AGCGGC	12	-	2	CGCTGC
gi|514486632|gb|KE346360.1|	1282661	1282673	AAAGCG	12	+	2	AGCGAA
gi|514486632|gb|KE346360.1|	1282835	1282855	AAC	20	+	6	AAC
gi|514486632|gb|KE346360.1|	1283885	1283902	ACC	17	+	5	CCA
gi|514486632|gb|KE346360.1|	1283900	1283917	CCG	17	+	5	CCG
gi|514486632|gb|KE346360.1|	1284236	1284254	AGC	18	+	6	GCA
gi|514486632|gb|KE346360.1|	1284302	1284322	CCG	20	+	6	CCG
gi|514486632|gb|KE346360.1|	1284398	1284412	AGGCGG	14	-	2	CCGCCT
gi|514486632|gb|KE346360.1|	1284494	1284507	ACCGCC	13	+	2	CCACCG
gi|514486632|gb|KE346360.1|	1284725	1284737	AGCCCC	12	+	2	CCAGCC
gi|514486632|gb|KE346360.1|	1285654	1285669	A	15	-	15	T
gi|514486632|gb|KE346360.1|	1285713	1285727	AAAAG	14	+	2	AAAAG
gi|514486632|gb|KE346360.1|	1286544	1286570	ACG	26	-	8	CGT
gi|514486632|gb|KE346360.1|	1287273	1287285	ACCATC	12	-	2	TGGTGA
gi|514486632|gb|KE346360.1|	1287335	1287347	AGGCG	12	+	2	GGCGA
gi|514486632|gb|KE346360.1|	1287838	1287850	AGCCC	12	-	2	GCTGG
gi|514486632|gb|KE346360.1|	1288916	1288928	ACG	12	-	4	CGT
gi|514486632|gb|KE346360.1|	1288926	1288938	ACT	12	-	4	GTA
gi|514486632|gb|KE346360.1|	1289039	1289056	AGCG	17	+	4	GAGC
gi|514486632|gb|KE346360.1|	1289071	1289094	AC	23	+	11	CA
gi|514486632|gb|KE346360.1|	1289095	1289109	AC	14	+	7	CA
gi|514486632|gb|KE346360.1|	1289233	1289247	C	14	+	14	C
gi|514486632|gb|KE346360.1|	1289303	1289315	AGCG	12	+	3	AGCG
gi|514486632|gb|KE346360.1|	1289328	1289340	ACCC	12	-	3	GGGT
gi|514486632|gb|KE346360.1|	1289343	1289355	ACGAGG	12	+	2	CGAGGA
gi|514486632|gb|KE346360.1|	1289350	1289362	AGG	12	+	4	GAG
gi|514486632|gb|KE346360.1|	1289430	1289463	AAAG	33	+	8	AAGA
gi|514486632|gb|KE346360.1|	1289460	1289472	AATG	12	+	3	GAAT
gi|514486632|gb|KE346360.1|	1289473	1289485	AAAG	12	+	3	AAAG
gi|514486632|gb|KE346360.1|	1290310	1290325	AAAAGT	15	-	2	TACTTT
gi|514486632|gb|KE346360.1|	1290724	1290746	ACACAG	22	-	3	TGTGTC
gi|514486632|gb|KE346360.1|	1290747	1290762	ACACAG	15	-	2	CTGTGT
gi|514486632|gb|KE346360.1|	1291169	1291181	ATCGCC	12	+	2	CCATCG
gi|514486632|gb|KE346360.1|	1292825	1292837	AAAGG	12	-	2	TTCCT
gi|514486632|gb|KE346360.1|	1292834	1292847	A	13	-	13	T
gi|514486632|gb|KE346360.1|	1292947	1292969	A	22	+	22	A
gi|514486632|gb|KE346360.1|	1292974	1292986	A	12	+	12	A
gi|514486632|gb|KE346360.1|	1293245	1293258	AAAAG	13	-	2	TTTTC
gi|514486632|gb|KE346360.1|	1293452	1293464	AAAG	12	-	3	TTTC
gi|514486632|gb|KE346360.1|	1293461	1293474	AACGG	13	-	2	TTCCG
gi|514486632|gb|KE346360.1|	1293980	1293992	AACGGC	12	-	2	GCCGTT
gi|514486632|gb|KE346360.1|	1294536	1294548	ACG	12	-	4	TCG
gi|514486632|gb|KE346360.1|	1296620	1296632	AAGCGC	12	+	2	CGCAAG
gi|514486632|gb|KE346360.1|	1296775	1296787	A	12	-	12	T
gi|514486632|gb|KE346360.1|	1296976	1296990	ATC	14	-	4	TGA
gi|514486632|gb|KE346360.1|	1297051	1297063	A	12	+	12	A
gi|514486632|gb|KE346360.1|	1297067	1297082	AAAAC	15	+	3	AACAA
gi|514486632|gb|KE346360.1|	1297091	1297106	AAAAC	15	+	3	AACAA
gi|514486632|gb|KE346360.1|	1297115	1297130	AAAAC	15	+	3	AACAA
gi|514486632|gb|KE346360.1|	1297139	1297154	AAAAC	15	+	3	AACAA
gi|514486632|gb|KE346360.1|	1299104	1299116	ACCCCG	12	-	2	GTCGGG
gi|514486632|gb|KE346360.1|	1299651	1299663	ACACCT	12	-	2	AGGTGT
gi|514486632|gb|KE346360.1|	1300248	1300260	AAATTG	12	+	2	AATTGA
gi|514486632|gb|KE346360.1|	1300637	1300649	AAAAAC	12	+	2	AAACAA
gi|514486632|gb|KE346360.1|	1300891	1300911	A	20	-	20	T
gi|514486632|gb|KE346360.1|	1301104	1301116	AACAGC	12	+	2	CAGCAA
gi|514486632|gb|KE346360.1|	1301290	1301315	A	25	+	25	A
gi|514486632|gb|KE346360.1|	1301331	1301343	AAAAG	12	+	2	AAAAG
gi|514486632|gb|KE346360.1|	1301536	1301549	ACAGC	13	+	2	CACAG
gi|514486632|gb|KE346360.1|	1302656	1302681	AAC	25	+	8	ACA
gi|514486632|gb|KE346360.1|	1303144	1303254	AAAC	110	+	27	AAAC
gi|514486632|gb|KE346360.1|	1304192	1304207	AGG	15	+	5	AGG
gi|514486632|gb|KE346360.1|	1304235	1304247	AAAACC	12	-	2	GTTTTG
gi|514486632|gb|KE346360.1|	1304312	1304327	AG	15	+	7	AG
gi|514486632|gb|KE346360.1|	1304621	1304633	AGCCG	12	+	2	AGCCG
gi|514486632|gb|KE346360.1|	1304686	1304698	AACGAC	12	+	2	CAACGA
gi|514486632|gb|KE346360.1|	1304744	1304758	AAAAAC	14	+	2	ACAAAA
gi|514486632|gb|KE346360.1|	1304893	1304910	AGATGG	17	+	2	GAGATG
gi|514486632|gb|KE346360.1|	1305172	1305185	AGG	13	-	4	CTC
gi|514486632|gb|KE346360.1|	1305290	1305307	A	17	+	17	A
gi|514486632|gb|KE346360.1|	1305494	1305519	A	25	-	25	T
gi|514486632|gb|KE346360.1|	1306405	1306418	CCCGCG	13	+	2	CCGCGC
gi|514486632|gb|KE346360.1|	1307538	1307552	AAAAAC	14	+	2	AACAAA
gi|514486632|gb|KE346360.1|	1307547	1307560	A	13	+	13	A
gi|514486632|gb|KE346360.1|	1307642	1307655	AAAAC	13	+	2	AAAAC
gi|514486632|gb|KE346360.1|	1307663	1307685	A	22	+	22	A
gi|514486632|gb|KE346360.1|	1307730	1307743	AAACCC	13	+	2	CAAACC
gi|514486632|gb|KE346360.1|	1307837	1307874	AG	37	+	18	AG
gi|514486632|gb|KE346360.1|	1308125	1308137	C	12	+	12	C
gi|514486632|gb|KE346360.1|	1308618	1308630	AAAC	12	-	3	TTGT
gi|514486632|gb|KE346360.1|	1310172	1310191	AACAGC	19	-	3	GCTGTT
gi|514486632|gb|KE346360.1|	1310186	1310199	AAC	13	-	4	TGT
gi|514486632|gb|KE346360.1|	1310200	1310213	AAC	13	-	4	TTG
gi|514486632|gb|KE346360.1|	1311130	1311142	AGCGGC	12	+	2	GCGGCA
gi|514486632|gb|KE346360.1|	1311318	1311335	AAGCAG	17	+	2	AGAAGC
gi|514486632|gb|KE346360.1|	1312050	1312062	ATCGGC	12	-	2	CGATGC
gi|514486632|gb|KE346360.1|	1312600	1312617	AAG	17	+	5	GAA
gi|514486632|gb|KE346360.1|	1312729	1312742	AATCTG	13	-	2	TTCAGA
gi|514486632|gb|KE346360.1|	1312842	1312856	ACGCCG	14	+	2	CGCCGA
gi|514486632|gb|KE346360.1|	1312851	1312864	ACG	13	+	4	CGA
gi|514486632|gb|KE346360.1|	1313074	1313088	AGCCGG	14	+	2	GGAGCC
gi|514486632|gb|KE346360.1|	1313336	1313348	AAGCGC	12	-	2	GCTTGC
gi|514486632|gb|KE346360.1|	1313515	1313532	AAC	17	-	5	TGT
gi|514486632|gb|KE346360.1|	1314081	1314093	ACACC	12	+	2	ACCAC
gi|514486632|gb|KE346360.1|	1314164	1314179	AAGGGC	15	-	2	CCCTTG
gi|514486632|gb|KE346360.1|	1315023	1315036	AG	13	+	6	GA
gi|514486632|gb|KE346360.1|	1315066	1315080	AAATCC	14	+	2	AATCCA
gi|514486632|gb|KE346360.1|	1315400	1315412	AAGCCG	12	-	2	TTCGGC
gi|514486632|gb|KE346360.1|	1315736	1315752	A	16	+	16	A
gi|514486632|gb|KE346360.1|	1317204	1317219	ACC	15	-	5	GGT
gi|514486632|gb|KE346360.1|	1317259	1317273	AGATC	14	-	2	CTGAT
gi|514486632|gb|KE346360.1|	1317515	1317538	ACCCTG	23	-	3	AGGGTC
gi|514486632|gb|KE346360.1|	1317640	1317654	AGC	14	-	4	TGC
gi|514486632|gb|KE346360.1|	1317655	1317672	AGC	17	-	5	TGC
gi|514486632|gb|KE346360.1|	1317673	1317686	AGAGCG	13	-	2	TCTCGC
gi|514486632|gb|KE346360.1|	1318058	1318071	AAAAC	13	-	2	TTTTG
gi|514486632|gb|KE346360.1|	1318247	1318264	AAC	17	+	5	AAC
gi|514486632|gb|KE346360.1|	1319183	1319195	ACGGG	12	-	2	CGTCC
gi|514486632|gb|KE346360.1|	1319489	1319504	AAAAC	15	-	3	TTTTG
gi|514486632|gb|KE346360.1|	1320058	1320070	AACACC	12	+	2	CCAACA
gi|514486632|gb|KE346360.1|	1320843	1320855	ACGGGG	12	-	2	CCCGTC
gi|514486632|gb|KE346360.1|	1321332	1321346	ATC	14	-	4	TGA
gi|514486632|gb|KE346360.1|	1321916	1321937	A	21	-	21	T
gi|514486632|gb|KE346360.1|	1321943	1321963	A	20	-	20	T
gi|514486632|gb|KE346360.1|	1322011	1322025	AGAGGG	14	-	2	TCTCCC
gi|514486632|gb|KE346360.1|	1322396	1322415	ACG	19	+	6	GAC
gi|514486632|gb|KE346360.1|	1322525	1322551	ACCAGC	26	+	4	GCACCA
gi|514486632|gb|KE346360.1|	1322742	1322754	AATGTG	12	+	2	GAATGT
gi|514486632|gb|KE346360.1|	1322928	1322941	AAATCC	13	+	2	AATCCA
gi|514486632|gb|KE346360.1|	1322958	1322972	ACGAGG	14	-	2	CTCGTC
gi|514486632|gb|KE346360.1|	1323329	1323348	ATCGC	19	+	3	TCGCA
gi|514486632|gb|KE346360.1|	1324091	1324111	A	20	-	20	T
gi|514486632|gb|KE346360.1|	1324179	1324192	ACCACG	13	+	2	CGACCA
gi|514486632|gb|KE346360.1|	1324610	1324622	A	12	+	12	A
gi|514486632|gb|KE346360.1|	1324882	1324895	AACAGC	13	+	2	CAGCAA
gi|514486632|gb|KE346360.1|	1325501	1325518	ACGGCG	17	+	2	CGACGG
gi|514486632|gb|KE346360.1|	1326243	1326266	AGC	23	-	7	GCT
gi|514486632|gb|KE346360.1|	1326357	1326369	AGCGGC	12	+	2	GCAGCG
gi|514486632|gb|KE346360.1|	1326386	1326405	AC	19	-	9	TG
gi|514486632|gb|KE346360.1|	1327002	1327015	CCG	13	+	4	CGC
gi|514486632|gb|KE346360.1|	1327016	1327029	CCG	13	+	4	CCG
gi|514486632|gb|KE346360.1|	1328764	1328777	AAAACC	13	-	2	TTTTGG
gi|514486632|gb|KE346360.1|	1329088	1329100	AATCAC	12	+	2	CAATCA
gi|514486632|gb|KE346360.1|	1329106	1329140	A	34	+	34	A
gi|514486632|gb|KE346360.1|	1329315	1329327	A	12	-	12	T
gi|514486632|gb|KE346360.1|	1329329	1329341	AAAAAC	12	-	2	TTTGTT
gi|514486632|gb|KE346360.1|	1329663	1329679	AGC	16	+	5	CAG
gi|514486632|gb|KE346360.1|	1329885	1329902	AGC	17	+	5	CAG
gi|514486632|gb|KE346360.1|	1329921	1329947	AACAGC	26	+	4	CAGCAA
gi|514486632|gb|KE346360.1|	1330077	1330091	AGC	14	+	4	CAG
gi|514486632|gb|KE346360.1|	1330086	1330112	AACAGC	26	+	4	CAGCAA
gi|514486632|gb|KE346360.1|	1330113	1330130	AACAGC	17	+	2	CAACAG
gi|514486632|gb|KE346360.1|	1330142	1330159	AGC	17	+	5	GCA
gi|514486632|gb|KE346360.1|	1330193	1330205	AAGCGC	12	+	2	GCAAGC
gi|514486632|gb|KE346360.1|	1330373	1330385	AGC	12	+	4	GCA
gi|514486632|gb|KE346360.1|	1330416	1330436	AAC	20	+	6	CAA
gi|514486632|gb|KE346360.1|	1330924	1330937	AGCTCC	13	+	2	TCCAGC
gi|514486632|gb|KE346360.1|	1331148	1331160	A	12	-	12	T
gi|514486632|gb|KE346360.1|	1331794	1331814	A	20	-	20	T
gi|514486632|gb|KE346360.1|	1332023	1332036	A	13	+	13	A
gi|514486632|gb|KE346360.1|	1332521	1332546	AGG	25	-	8	CTC
gi|514486632|gb|KE346360.1|	1332691	1332703	ACCCGC	12	-	2	GTGCGG
gi|514486632|gb|KE346360.1|	1332818	1332838	AGG	20	-	6	TCC
gi|514486632|gb|KE346360.1|	1332836	1332853	AAGACG	17	-	2	TCGTCT
gi|514486632|gb|KE346360.1|	1333113	1333132	AAC	19	+	6	CAA
gi|514486632|gb|KE346360.1|	1333473	1333646	AAAC	173	+	43	ACAA
gi|514486632|gb|KE346360.1|	1333969	1333982	AAGACC	13	+	2	AAGACC
gi|514486632|gb|KE346360.1|	1334123	1334140	AAAAAC	17	+	2	CAAAAA
gi|514486632|gb|KE346360.1|	1335037	1335049	AAGCAG	12	+	2	GAAGCA
gi|514486632|gb|KE346360.1|	1335182	1335197	ACTGCC	15	-	2	TGGCAG
gi|514486632|gb|KE346360.1|	1335596	1335610	AAAAG	14	-	2	TTTTC
gi|514486632|gb|KE346360.1|	1335689	1335712	A	23	-	23	T
gi|514486632|gb|KE346360.1|	1335947	1335959	ACTGAG	12	-	2	CAGTCT
gi|514486632|gb|KE346360.1|	1336026	1336039	AAACCG	13	+	2	CGAAAC
gi|514486632|gb|KE346360.1|	1336052	1336065	AAAAAC	13	+	2	AACAAA
gi|514486632|gb|KE346360.1|	1336074	1336095	A	21	+	21	A
gi|514486632|gb|KE346360.1|	1336749	1336763	A	14	-	14	T
gi|514486632|gb|KE346360.1|	1340933	1340948	AAAAAC	15	-	2	TTTTTG
gi|514486632|gb|KE346360.1|	1340942	1341127	AAAC	185	-	46	TTGT
gi|514486632|gb|KE346360.1|	1341128	1341180	AAAC	52	-	13	GTTT
gi|514486632|gb|KE346360.1|	1341471	1341484	AACGTG	13	-	2	CACGTT
gi|514486632|gb|KE346360.1|	1341539	1341553	ACG	14	-	4	GTC
gi|514486632|gb|KE346360.1|	1341795	1341810	AAAC	15	-	3	TTTG
gi|514486632|gb|KE346360.1|	1342378	1342391	ATCGGC	13	-	2	GCCGAT
gi|514486632|gb|KE346360.1|	1342836	1342851	AAAAC	15	+	3	AAAAC
gi|514486632|gb|KE346360.1|	1343220	1343233	ATCCGC	13	-	2	GGATGC
gi|514486632|gb|KE346360.1|	1343807	1343824	AGC	17	+	5	CAG
gi|514486632|gb|KE346360.1|	1344191	1344204	AGC	13	+	4	CAG
gi|514486632|gb|KE346360.1|	1344349	1344361	AAGGCG	12	+	2	GCGAAG
gi|514486632|gb|KE346360.1|	1344570	1344586	AATG	16	+	4	TGAA
gi|514486632|gb|KE346360.1|	1344587	1344600	AAT	13	+	4	AAT
gi|514486632|gb|KE346360.1|	1345052	1345064	ACTC	12	-	3	GTGA
gi|514486632|gb|KE346360.1|	1345455	1345472	AAGGAC	17	-	2	TGTCCT
gi|514486632|gb|KE346360.1|	1345489	1345503	AAGGAC	14	-	2	CTTGTC
gi|514486632|gb|KE346360.1|	1345701	1345714	AACAC	13	+	2	AACAC
gi|514486632|gb|KE346360.1|	1346038	1346057	ATC	19	+	6	CAT
gi|514486632|gb|KE346360.1|	1346055	1346069	ACG	14	-	4	TCG
gi|514486632|gb|KE346360.1|	1346233	1346259	AAGCAG	26	-	4	CTGCTT
gi|514486632|gb|KE346360.1|	1346265	1346278	AAGCAG	13	-	2	GCTTCT
gi|514486632|gb|KE346360.1|	1347715	1347738	A	23	-	23	T
gi|514486632|gb|KE346360.1|	1348024	1348036	A	12	-	12	T
gi|514486632|gb|KE346360.1|	1348109	1348131	AAC	22	-	7	TTG
gi|514486632|gb|KE346360.1|	1348168	1348182	A	14	-	14	T
gi|514486632|gb|KE346360.1|	1348189	1348201	AATCCC	12	+	2	CCCAAT
gi|514486632|gb|KE346360.1|	1348329	1348341	AAG	12	-	4	TCT
gi|514486632|gb|KE346360.1|	1348349	1348361	AACTTC	12	+	2	ACTTCA
gi|514486632|gb|KE346360.1|	1348397	1348417	A	20	+	20	A
gi|514486632|gb|KE346360.1|	1348505	1348521	ACG	16	+	5	ACG
gi|514486632|gb|KE346360.1|	1348534	1348551	AGCATC	17	-	2	TGCTGA
gi|514486632|gb|KE346360.1|	1348658	1348673	AG	15	-	7	CT
gi|514486632|gb|KE346360.1|	1348709	1348727	AACG	18	-	4	GTTC
gi|514486632|gb|KE346360.1|	1348761	1348773	AAAAAC	12	+	2	CAAAAA
gi|514486632|gb|KE346360.1|	1348779	1348793	ACTC	14	+	3	ACTC
gi|514486632|gb|KE346360.1|	1351060	1351072	AACTGC	12	+	2	GCAACT
gi|514486632|gb|KE346360.1|	1353120	1353132	AACATC	12	+	2	TCAACA
gi|514486632|gb|KE346360.1|	1353894	1353908	AAAAG	14	+	2	AAAAG
gi|514486632|gb|KE346360.1|	1354423	1354435	ACACTG	12	+	2	CTGACA
gi|514486632|gb|KE346360.1|	1354714	1354727	AG	13	-	6	TC
gi|514486632|gb|KE346360.1|	1354774	1354796	A	22	-	22	T
gi|514486632|gb|KE346360.1|	1354888	1354907	AG	19	+	9	GA
gi|514486632|gb|KE346360.1|	1355419	1355432	AAAAAC	13	-	2	TTGTTT
gi|514486632|gb|KE346360.1|	1355673	1355685	AAGCTC	12	+	2	CTCAAG
gi|514486632|gb|KE346360.1|	1355779	1355916	AC	137	-	68	TG
gi|514486632|gb|KE346360.1|	1356863	1356877	ACAT	14	-	3	GTAT
gi|514486632|gb|KE346360.1|	1357139	1357164	AACTG	25	+	5	GAACT
gi|514486632|gb|KE346360.1|	1357409	1357424	AATTCG	15	+	2	TCGAAT
gi|514486632|gb|KE346360.1|	1357663	1357676	AAGGAC	13	+	2	GGACAA
gi|514486632|gb|KE346360.1|	1358566	1358593	AAAC	27	-	6	TTTG
gi|514486632|gb|KE346360.1|	1358589	1358605	AAAACC	16	-	2	GTTTTG
gi|514486632|gb|KE346360.1|	1358599	1358622	AAACC	23	-	4	TGGTT
gi|514486632|gb|KE346360.1|	1359882	1359894	AAAAG	12	-	2	TTTTC
gi|514486632|gb|KE346360.1|	1359936	1359948	ACGCAG	12	-	2	CTGCGT
gi|514486632|gb|KE346360.1|	1359959	1359971	AACAAG	12	+	2	CAAGAA
gi|514486632|gb|KE346360.1|	1360290	1360302	AAAAAT	12	-	2	ATTTTT
gi|514486632|gb|KE346360.1|	1360297	1360313	A	16	-	16	T
gi|514486632|gb|KE346360.1|	1360415	1360428	AAAAC	13	-	2	TTTGT
gi|514486632|gb|KE346360.1|	1360488	1360500	A	12	-	12	T
gi|514486632|gb|KE346360.1|	1360750	1360762	ACCCGG	12	+	2	GACCCG
gi|514486632|gb|KE346360.1|	1360855	1360872	AGGGGC	17	+	2	GCAGGG
gi|514486632|gb|KE346360.1|	1360913	1360938	ATC	25	+	8	CAT
gi|514486632|gb|KE346360.1|	1360937	1360953	AGC	16	-	5	CTG
gi|514486632|gb|KE346360.1|	1360959	1360971	ACC	12	+	4	CAC
gi|514486632|gb|KE346360.1|	1360987	1360999	ACCACT	12	+	2	ACCACT
gi|514486632|gb|KE346360.1|	1361488	1361500	ACGCGG	12	-	2	GCGTCC
gi|514486632|gb|KE346360.1|	1362095	1362108	A	13	-	13	T
gi|514486632|gb|KE346360.1|	1364284	1364296	CCG	12	+	4	GCC
gi|514486632|gb|KE346360.1|	1364390	1364404	AGC	14	-	4	GCT
gi|514486632|gb|KE346360.1|	1365352	1365366	CCCCCG	14	-	2	GGCGGG
gi|514486632|gb|KE346360.1|	1366061	1366077	AAAC	16	-	4	TTGT
gi|514486632|gb|KE346360.1|	1366839	1366856	AAAAC	17	+	3	AACAA
gi|514486632|gb|KE346360.1|	1367139	1367154	AAAC	15	+	3	AAAC
gi|514486632|gb|KE346360.1|	1367620	1367632	AAAAC	12	+	2	AACAA
gi|514486632|gb|KE346360.1|	1368205	1368222	AAAAAC	17	-	2	TTTTTG
gi|514486632|gb|KE346360.1|	1368602	1368619	A	17	+	17	A
gi|514486632|gb|KE346360.1|	1369047	1369064	CCG	17	-	5	GCG
gi|514486632|gb|KE346360.1|	1369330	1369350	AGC	20	+	6	GCA
gi|514486632|gb|KE346360.1|	1369908	1369920	AGGCCC	12	-	2	CTGGGC
gi|514486632|gb|KE346360.1|	1370031	1370043	ACCCCG	12	-	2	GTCGGG
gi|514486632|gb|KE346360.1|	1370158	1370170	ACCGGC	12	-	2	GTGCCG
gi|514486632|gb|KE346360.1|	1370193	1370206	AAGGTG	13	+	2	GAAGGT
gi|514486632|gb|KE346360.1|	1370604	1370623	A	19	-	19	T
gi|514486632|gb|KE346360.1|	1370641	1370656	AAAC	15	-	3	TTTG
gi|514486632|gb|KE346360.1|	1370665	1370681	AAG	16	-	5	CTT
gi|514486632|gb|KE346360.1|	1370791	1370808	A	17	+	17	A
gi|514486632|gb|KE346360.1|	1370825	1370847	A	22	+	22	A
gi|514486632|gb|KE346360.1|	1370998	1371011	AAAAGC	13	+	2	AAAGCA
gi|514486632|gb|KE346360.1|	1371051	1371070	AAAAC	19	-	3	TTTTG
gi|514486632|gb|KE346360.1|	1371176	1371190	AACAGC	14	+	2	CAACAG
gi|514486632|gb|KE346360.1|	1371328	1371343	AAAAAT	15	+	2	AAATAA
gi|514486632|gb|KE346360.1|	1371352	1371366	AAAAGC	14	-	2	CTTTTG
gi|514486632|gb|KE346360.1|	1371476	1371490	AGCGGC	14	-	2	CCGCTG
gi|514486632|gb|KE346360.1|	1371741	1371771	A	30	+	30	A
gi|514486632|gb|KE346360.1|	1371942	1371964	A	22	+	22	A
gi|514486632|gb|KE346360.1|	1371975	1371997	A	22	+	22	A
gi|514486632|gb|KE346360.1|	1372277	1372291	AACAAT	14	+	2	CAATAA
gi|514486632|gb|KE346360.1|	1372450	1372462	AGCGGC	12	+	2	AGCGGC
gi|514486632|gb|KE346360.1|	1372826	1372838	AATCC	12	+	2	AATCC
gi|514486632|gb|KE346360.1|	1372865	1372888	A	23	+	23	A
gi|514486632|gb|KE346360.1|	1372889	1372906	AAAC	17	+	4	CAAA
gi|514486632|gb|KE346360.1|	1373958	1373970	AAACC	12	+	2	ACCAA
gi|514486632|gb|KE346360.1|	1374045	1374063	AAAAGG	18	-	3	TTCCTT
gi|514486632|gb|KE346360.1|	1374275	1374288	AATCAC	13	-	2	TGATTG
gi|514486632|gb|KE346360.1|	1374469	1374486	AGG	17	-	5	TCC
gi|514486632|gb|KE346360.1|	1375226	1375247	AGC	21	-	7	CTG
gi|514486632|gb|KE346360.1|	1376469	1376486	A	17	+	17	A
gi|514486632|gb|KE346360.1|	1378916	1378929	ACG	13	+	4	ACG
gi|514486632|gb|KE346360.1|	1379545	1379557	AAAAC	12	+	2	AACAA
gi|514486632|gb|KE346360.1|	1379573	1379587	A	14	+	14	A
gi|514486632|gb|KE346360.1|	1381126	1381145	AGC	19	+	6	GCA
gi|514486632|gb|KE346360.1|	1381192	1381204	ACCTCG	12	-	2	GTCGAG
gi|514486632|gb|KE346360.1|	1381216	1381228	AGC	12	+	4	GCA
gi|514486632|gb|KE346360.1|	1381400	1381418	ATC	18	-	6	ATG
gi|514486632|gb|KE346360.1|	1381498	1381523	A	25	-	25	T
gi|514486632|gb|KE346360.1|	1381563	1381593	AATC	30	-	7	GATT
gi|514486632|gb|KE346360.1|	1382008	1382028	AAC	20	+	6	CAA
gi|514486632|gb|KE346360.1|	1382092	1382104	AACTCG	12	+	2	ACTCGA
gi|514486632|gb|KE346360.1|	1382183	1382210	AATCTG	27	+	4	GAATCT
gi|514486632|gb|KE346360.1|	1382212	1382231	AATCTC	19	+	3	TCAATC
gi|514486632|gb|KE346360.1|	1384179	1384191	AAAGAC	12	-	2	GTCTTT
gi|514486632|gb|KE346360.1|	1384754	1384772	AAC	18	-	6	TTG
gi|514486632|gb|KE346360.1|	1384784	1384799	AAC	15	-	5	TTG
gi|514486632|gb|KE346360.1|	1384815	1384835	AAC	20	-	6	TGT
gi|514486632|gb|KE346360.1|	1385025	1385037	ACACAG	12	+	2	GACACA
gi|514486632|gb|KE346360.1|	1385711	1385769	A	58	+	58	A
gi|514486632|gb|KE346360.1|	1389104	1389117	A	13	+	13	A
gi|514486632|gb|KE346360.1|	1389455	1389477	A	22	+	22	A
gi|514486632|gb|KE346360.1|	1389885	1389897	AAAACC	12	+	2	CCAAAA
gi|514486632|gb|KE346360.1|	1389893	1389933	A	40	+	40	A
gi|514486632|gb|KE346360.1|	1390980	1390994	CCG	14	-	4	CGG
gi|514486632|gb|KE346360.1|	1391395	1391414	AAC	19	+	6	AAC
gi|514486632|gb|KE346360.1|	1392202	1392215	ACACCG	13	-	2	GTGTCG
gi|514486632|gb|KE346360.1|	1392440	1392452	ATC	12	-	4	TGA
gi|514486632|gb|KE346360.1|	1392903	1392921	AAC	18	-	6	TTG
gi|514486632|gb|KE346360.1|	1395156	1395169	AAGGGC	13	-	2	GCCCTT
gi|514486632|gb|KE346360.1|	1395678	1395691	ACGCCG	13	+	2	CGCCGA
gi|514486632|gb|KE346360.1|	1395724	1395737	CCG	13	+	4	GCC
gi|514486632|gb|KE346360.1|	1395753	1395768	AGC	15	+	5	AGC
gi|514486632|gb|KE346360.1|	1395935	1395950	AAAAC	15	-	3	TGTTT
gi|514486632|gb|KE346360.1|	1395944	1395958	AAAC	14	-	3	TTGT
gi|514486632|gb|KE346360.1|	1395952	1395968	AAAAC	16	-	3	TTGTT
gi|514486632|gb|KE346360.1|	1396048	1396066	A	18	+	18	A
gi|514486632|gb|KE346360.1|	1396109	1396132	AAAATC	23	-	3	ATTTTG
gi|514486632|gb|KE346360.1|	1396129	1396151	AAAATC	22	-	3	TTTTGA
gi|514486632|gb|KE346360.1|	1396207	1396219	AAGTG	12	+	2	AAGTG
gi|514486632|gb|KE346360.1|	1396256	1396271	AACTG	15	+	3	TGAAC
gi|514486632|gb|KE346360.1|	1396386	1396403	AGC	17	-	5	TGC
gi|514486632|gb|KE346360.1|	1397015	1397027	AATGGC	12	-	2	GCCATT
gi|514486632|gb|KE346360.1|	1397331	1397350	AAC	19	-	6	TTG
gi|514486632|gb|KE346360.1|	1397889	1397908	AAAC	19	-	4	TTGT
gi|514486632|gb|KE346360.1|	1397909	1397935	AAAC	26	-	6	TGTT
gi|514486632|gb|KE346360.1|	1398399	1398414	AAC	15	+	5	CAA
gi|514486632|gb|KE346360.1|	1399827	1399846	A	19	-	19	T
gi|514486632|gb|KE346360.1|	1399847	1399860	A	13	-	13	T
gi|514486632|gb|KE346360.1|	1399902	1399914	ACACAG	12	+	2	ACACAG
gi|514486632|gb|KE346360.1|	1400029	1400041	AGC	12	+	4	GCA
gi|514486632|gb|KE346360.1|	1400200	1400212	AAACC	12	+	2	CAAAC
gi|514486632|gb|KE346360.1|	1400214	1400231	A	17	+	17	A
gi|514486632|gb|KE346360.1|	1400415	1400427	AAAAAC	12	+	2	AAAACA
gi|514486632|gb|KE346360.1|	1400441	1400454	AAAACC	13	+	2	CCAAAA
gi|514486632|gb|KE346360.1|	1400584	1400596	ACGGCG	12	-	2	GCCGTC
gi|514486632|gb|KE346360.1|	1400629	1400654	A	25	+	25	A
gi|514486632|gb|KE346360.1|	1400857	1400874	A	17	-	17	T
gi|514486632|gb|KE346360.1|	1400978	1400996	A	18	+	18	A
gi|514486632|gb|KE346360.1|	1401238	1401250	AC	12	-	6	TG
gi|514486632|gb|KE346360.1|	1402215	1402235	AAAG	20	-	5	TCTT
gi|514486632|gb|KE346360.1|	1402688	1402708	AGC	20	-	6	TGC
gi|514486632|gb|KE346360.1|	1403435	1403452	A	17	-	17	T
gi|514486632|gb|KE346360.1|	1403449	1403476	AAAC	27	-	6	TTTG
gi|514486632|gb|KE346360.1|	1404265	1404282	A	17	-	17	T
gi|514486632|gb|KE346360.1|	1404379	1404391	AAAAGC	12	-	2	TTTGCT
gi|514486632|gb|KE346360.1|	1405110	1405123	ACATG	13	-	2	TCATG
gi|514486632|gb|KE346360.1|	1405404	1405416	ATCGGC	12	+	2	TCGGCA
gi|514486632|gb|KE346360.1|	1405697	1405714	AAAC	17	-	4	TTTG
gi|514486632|gb|KE346360.1|	1405708	1405720	AAACAC	12	-	2	GTTTGT
gi|514486632|gb|KE346360.1|	1405714	1405761	AAAC	47	-	11	GTTT
gi|514486632|gb|KE346360.1|	1406467	1406480	AAAAAG	13	+	2	AAAAAG
gi|514486632|gb|KE346360.1|	1406539	1406551	ACGAGG	12	+	2	GACGAG
gi|514486632|gb|KE346360.1|	1406776	1406790	AAAAG	14	-	2	TTTTC
gi|514486632|gb|KE346360.1|	1407146	1407166	CCG	20	+	6	CCG
gi|514486632|gb|KE346360.1|	1407161	1407175	AGGCGG	14	-	2	CCGCCT
gi|514486632|gb|KE346360.1|	1407682	1407707	ACCGCG	25	-	4	GCGGTC
gi|514486632|gb|KE346360.1|	1407825	1407837	ACAGG	12	+	2	GGACA
gi|514486632|gb|KE346360.1|	1407895	1407911	AGC	16	-	5	GCT
gi|514486632|gb|KE346360.1|	1408225	1408237	ACGAGG	12	-	2	TCCTCG
gi|514486632|gb|KE346360.1|	1408744	1408764	AGC	20	+	6	GCA
gi|514486632|gb|KE346360.1|	1410318	1410330	AGCGCG	12	-	2	GCGCTC
gi|514486632|gb|KE346360.1|	1410919	1410941	ACC	22	-	7	GTG
gi|514486632|gb|KE346360.1|	1411241	1411254	ACCCGC	13	+	2	CACCCG
gi|514486632|gb|KE346360.1|	1411780	1411798	AGC	18	-	6	TGC
gi|514486632|gb|KE346360.1|	1411793	1411805	AGCCGC	12	-	2	GCTGCG
gi|514486632|gb|KE346360.1|	1411831	1411851	AGC	20	-	6	TGC
gi|514486632|gb|KE346360.1|	1411855	1411869	AGC	14	-	4	TGC
gi|514486632|gb|KE346360.1|	1411888	1411901	AAAGGC	13	+	2	GGCAAA
gi|514486632|gb|KE346360.1|	1411968	1411980	AGCGAT	12	-	2	ATCGCT
gi|514486632|gb|KE346360.1|	1412106	1412128	A	22	+	22	A
gi|514486632|gb|KE346360.1|	1412144	1412157	AAAC	13	+	3	AAAC
gi|514486632|gb|KE346360.1|	1412233	1412253	AATG	20	+	5	TGAA
gi|514486632|gb|KE346360.1|	1413338	1413351	AGGCG	13	+	2	GCGAG
gi|514486632|gb|KE346360.1|	1413399	1413420	A	21	-	21	T
gi|514486632|gb|KE346360.1|	1413576	1413590	AAAC	14	-	3	TGTT
gi|514486632|gb|KE346360.1|	1413979	1413991	AAACAT	12	-	2	ATGTTT
gi|514486632|gb|KE346360.1|	1414672	1414685	ATC	13	-	4	GAT
gi|514486632|gb|KE346360.1|	1414715	1414729	AAAAAC	14	-	2	TTTGTT
gi|514486632|gb|KE346360.1|	1414733	1414745	AAAAC	12	-	2	TTTGT
gi|514486632|gb|KE346360.1|	1414978	1414990	ACGATG	12	+	2	TGACGA
gi|514486632|gb|KE346360.1|	1415339	1415354	AAAAAC	15	-	2	TTTTTG
gi|514486632|gb|KE346360.1|	1416291	1416303	AGCATG	12	+	2	GCATGA
gi|514486632|gb|KE346360.1|	1417254	1417266	AC	12	+	6	AC
gi|514486632|gb|KE346360.1|	1417290	1417303	AAAAG	13	-	2	CTTTT
gi|514486632|gb|KE346360.1|	1417594	1417606	AAATG	12	+	2	AATGA
gi|514486632|gb|KE346360.1|	1418129	1418142	CCCGCG	13	+	2	CGCCCG
gi|514486632|gb|KE346360.1|	1418589	1418601	AAAAAG	12	-	2	CTTTTT
gi|514486632|gb|KE346360.1|	1418622	1418638	ACATG	16	+	3	ATGAC
gi|514486632|gb|KE346360.1|	1418810	1418822	ACATGT	12	+	2	CATGTA
gi|514486632|gb|KE346360.1|	1418917	1418933	AAAC	16	-	4	GTTT
gi|514486632|gb|KE346360.1|	1418930	1418945	A	15	-	15	T
gi|514486632|gb|KE346360.1|	1419416	1419430	A	14	+	14	A
gi|514486632|gb|KE346360.1|	1419583	1419618	AGG	35	+	11	GAG
gi|514486632|gb|KE346360.1|	1419802	1419814	ACG	12	-	4	TCG
gi|514486632|gb|KE346360.1|	1420293	1420320	A	27	-	27	T
gi|514486632|gb|KE346360.1|	1420497	1420509	AAGCAC	12	-	2	CTTGTG
gi|514486632|gb|KE346360.1|	1420565	1420577	ACTCTC	12	+	2	TCACTC
gi|514486632|gb|KE346360.1|	1420571	1420584	ACTC	13	+	3	TCAC
gi|514486632|gb|KE346360.1|	1420587	1420619	AAGTG	32	-	6	CTTCA
gi|514486632|gb|KE346360.1|	1421025	1421038	AAC	13	-	4	TGT
gi|514486632|gb|KE346360.1|	1423751	1423765	AAAAC	14	+	2	AAAAC
gi|514486632|gb|KE346360.1|	1427750	1427768	AAT	18	-	6	TTA
gi|514486632|gb|KE346360.1|	1427982	1427994	A	12	-	12	T
gi|514486632|gb|KE346360.1|	1428011	1428023	A	12	-	12	T
gi|514486632|gb|KE346360.1|	1428035	1428050	A	15	-	15	T
gi|514486632|gb|KE346360.1|	1428254	1428268	A	14	-	14	T
gi|514486632|gb|KE346360.1|	1428506	1428520	A	14	-	14	T
gi|514486632|gb|KE346360.1|	1428707	1428719	AAAAG	12	-	2	TTTTC
gi|514486632|gb|KE346360.1|	1428732	1428745	A	13	-	13	T
gi|514486632|gb|KE346360.1|	1428764	1428782	A	18	-	18	T
gi|514486632|gb|KE346360.1|	1428946	1428959	AAGG	13	+	3	GAAG
gi|514486632|gb|KE346360.1|	1428975	1428990	A	15	+	15	A
gi|514486632|gb|KE346360.1|	1429028	1429044	A	16	+	16	A
gi|514486632|gb|KE346360.1|	1429254	1429266	AACCCC	12	-	2	GGGGTT
gi|514486632|gb|KE346360.1|	1429271	1429283	AAAACC	12	-	2	GTTTTG
gi|514486632|gb|KE346360.1|	1429787	1429809	AGCG	22	-	5	TCGC
gi|514486632|gb|KE346360.1|	1430171	1430183	AAATGG	12	-	2	ATTTCC
gi|514486632|gb|KE346360.1|	1431466	1431478	AAAAAG	12	+	2	AGAAAA
gi|514486632|gb|KE346360.1|	1431603	1431620	AAGC	17	+	4	AAGC
gi|514486632|gb|KE346360.1|	1431816	1431828	AAAAG	12	+	2	AAAAG
gi|514486632|gb|KE346360.1|	1431958	1431970	AACAGC	12	+	2	CAGCAA
gi|514486632|gb|KE346360.1|	1432296	1432322	AAAC	26	+	6	AACA
gi|514486632|gb|KE346360.1|	1432324	1432336	AAAAC	12	+	2	AAACA
gi|514486632|gb|KE346360.1|	1432330	1432344	AAAC	14	+	3	AACA
gi|514486632|gb|KE346360.1|	1432338	1432350	AAAAC	12	+	2	AACAA
gi|514486632|gb|KE346360.1|	1433727	1433739	ACCATG	12	+	2	CCATGA
gi|514486632|gb|KE346360.1|	1433746	1433768	A	22	+	22	A
gi|514486632|gb|KE346360.1|	1433818	1433841	A	23	+	23	A
gi|514486632|gb|KE346360.1|	1434200	1434214	AAAT	14	+	3	AATA
gi|514486632|gb|KE346360.1|	1434241	1434269	A	28	+	28	A
gi|514486632|gb|KE346360.1|	1434314	1434338	A	24	-	24	T
gi|514486632|gb|KE346360.1|	1434841	1434853	AGC	12	+	4	GCA
gi|514486632|gb|KE346360.1|	1434912	1434924	AAATCG	12	-	2	TTTCGA
gi|514486632|gb|KE346360.1|	1435005	1435026	ACCGCG	21	-	3	GTCGCG
gi|514486632|gb|KE346360.1|	1435162	1435174	A	12	+	12	A
gi|514486632|gb|KE346360.1|	1436162	1436177	ACACC	15	+	3	CACAC
gi|514486632|gb|KE346360.1|	1436182	1436194	ACACC	12	+	2	CACAC
gi|514486632|gb|KE346360.1|	1436895	1436907	AGC	12	-	4	CTG
gi|514486632|gb|KE346360.1|	1437401	1437413	A	12	+	12	A
gi|514486632|gb|KE346360.1|	1437585	1437602	AATGCC	17	-	2	TGGCAT
gi|514486632|gb|KE346360.1|	1437626	1437638	AAGCCG	12	+	2	CCGAAG
gi|514486632|gb|KE346360.1|	1437706	1437720	ATC	14	+	4	TCA
gi|514486632|gb|KE346360.1|	1437779	1437804	AGC	25	+	8	AGC
gi|514486632|gb|KE346360.1|	1437979	1437991	AGCGGC	12	-	2	GCCGCT
gi|514486632|gb|KE346360.1|	1440570	1440586	A	16	-	16	T
gi|514486632|gb|KE346360.1|	1440588	1440602	A	14	-	14	T
gi|514486632|gb|KE346360.1|	1440631	1440645	AAAAGG	14	-	2	CTTTTC
gi|514486632|gb|KE346360.1|	1440918	1440930	AAACAC	12	-	2	GTTTGT
gi|514486632|gb|KE346360.1|	1441163	1441175	AATTAC	12	-	2	TAATTG
gi|514486632|gb|KE346360.1|	1443020	1443032	A	12	-	12	T
gi|514486632|gb|KE346360.1|	1443181	1443200	AAC	19	+	6	AAC
gi|514486632|gb|KE346360.1|	1443311	1443335	A	24	-	24	T
gi|514486632|gb|KE346360.1|	1443372	1443384	AAT	12	+	4	AAT
gi|514486632|gb|KE346360.1|	1443569	1443588	A	19	-	19	T
gi|514486632|gb|KE346360.1|	1443708	1443725	ACG	17	-	5	CGT
gi|514486632|gb|KE346360.1|	1443720	1443732	ACGGCG	12	-	2	CGTCGC
gi|514486632|gb|KE346360.1|	1443830	1443843	ACCGCC	13	+	2	CCACCG
gi|514486632|gb|KE346360.1|	1443868	1443882	ACT	14	-	4	TAG
gi|514486632|gb|KE346360.1|	1443908	1443924	ACTATG	16	-	2	AGTCAT
gi|514486632|gb|KE346360.1|	1443953	1443970	AGC	17	+	5	AGC
gi|514486632|gb|KE346360.1|	1444382	1444408	AAAGAC	26	-	4	TCTTTG
gi|514486632|gb|KE346360.1|	1444462	1444476	AACCAC	14	+	2	CAACCA
gi|514486632|gb|KE346360.1|	1444471	1444483	ACAGCC	12	+	2	CCACAG
gi|514486632|gb|KE346360.1|	1444612	1444626	ACC	14	+	4	CAC
gi|514486632|gb|KE346360.1|	1444621	1444644	ACCAGC	23	+	3	CACCAG
gi|514486632|gb|KE346360.1|	1445862	1445875	AGC	13	-	4	CTG
gi|514486632|gb|KE346360.1|	1445996	1446011	ACTCGG	15	+	2	GACTCG
gi|514486632|gb|KE346360.1|	1446030	1446044	ATCGCC	14	+	2	CGCCAT
gi|514486632|gb|KE346360.1|	1446059	1446074	AAGGAG	15	-	2	TTCTCC
gi|514486632|gb|KE346360.1|	1447469	1447481	ACCAGT	12	-	2	ACTGGT
gi|514486632|gb|KE346360.1|	1447515	1447528	AAAAC	13	-	2	TTTTG
gi|514486632|gb|KE346360.1|	1447550	1447563	ACAG	13	-	3	TCTG
gi|514486632|gb|KE346360.1|	1447582	1447626	AC	44	-	22	TG
gi|514486632|gb|KE346360.1|	1447634	1447646	AG	12	-	6	TC
gi|514486632|gb|KE346360.1|	1447652	1447667	AAAGAG	15	-	2	TTTCTC
gi|514486632|gb|KE346360.1|	1448117	1448141	A	24	-	24	T
gi|514486632|gb|KE346360.1|	1448332	1448367	A	35	-	35	T
gi|514486632|gb|KE346360.1|	1448717	1448729	A	12	+	12	A
gi|514486632|gb|KE346360.1|	1448750	1448764	AAG	14	+	4	AAG
gi|514486632|gb|KE346360.1|	1449009	1449021	AAAGAC	12	-	2	TCTTTG
gi|514486632|gb|KE346360.1|	1449861	1449873	AAACG	12	-	2	TTCGT
gi|514486632|gb|KE346360.1|	1450267	1450284	A	17	-	17	T
gi|514486632|gb|KE346360.1|	1450280	1450292	AAAACC	12	-	2	TTTTGG
gi|514486632|gb|KE346360.1|	1450747	1450759	A	12	-	12	T
gi|514486632|gb|KE346360.1|	1451339	1451354	AAC	15	-	5	GTT
gi|514486632|gb|KE346360.1|	1451362	1451374	ACCATC	12	-	2	GGTGAT
gi|514486632|gb|KE346360.1|	1454777	1454790	ACAGT	13	+	2	TACAG
gi|514486632|gb|KE346360.1|	1455290	1455303	AAAAAT	13	-	2	TTTTTA
gi|514486632|gb|KE346360.1|	1455466	1455487	A	21	-	21	T
gi|514486632|gb|KE346360.1|	1455829	1455854	A	25	-	25	T
gi|514486632|gb|KE346360.1|	1455918	1455930	AAGC	12	-	3	CTTG
gi|514486632|gb|KE346360.1|	1456165	1456185	A	20	-	20	T
gi|514486632|gb|KE346360.1|	1457811	1457827	AGG	16	+	5	GAG
gi|514486632|gb|KE346360.1|	1458339	1458356	AGCGGC	17	-	2	GCCGCT
gi|514486632|gb|KE346360.1|	1458402	1458418	ACGATG	16	+	2	GACGAT
gi|514486632|gb|KE346360.1|	1458745	1458758	AGC	13	-	4	CTG
gi|514486632|gb|KE346360.1|	1458756	1458770	AGC	14	+	4	GCA
gi|514486632|gb|KE346360.1|	1458939	1458955	AAG	16	+	5	AAG
gi|514486632|gb|KE346360.1|	1459903	1459917	AC	14	-	7	GT
gi|514486632|gb|KE346360.1|	1461183	1461195	AC	12	+	6	AC
gi|514486632|gb|KE346360.1|	1461573	1461585	AGGGCG	12	+	2	GCGAGG
gi|514486632|gb|KE346360.1|	1461637	1461655	A	18	+	18	A
gi|514486632|gb|KE346360.1|	1461672	1461684	AAATCC	12	-	2	TTGGAT
gi|514486632|gb|KE346360.1|	1461845	1461857	AGAGC	12	+	2	CAGAG
gi|514486632|gb|KE346360.1|	1461930	1461942	AGGGGG	12	-	2	CCTCCC
gi|514486632|gb|KE346360.1|	1463749	1463761	C	12	-	12	G
gi|514486632|gb|KE346360.1|	1463775	1463787	AAC	12	+	4	CAA
gi|514486632|gb|KE346360.1|	1463816	1463830	AAAAAC	14	+	2	AAAAAC
gi|514486632|gb|KE346360.1|	1464747	1464762	ACGTCC	15	+	2	CCACGT
gi|514486632|gb|KE346360.1|	1464824	1464837	A	13	+	13	A
gi|514486632|gb|KE346360.1|	1465599	1465619	AAC	20	+	6	CAA
gi|514486632|gb|KE346360.1|	1466964	1466978	AAGTGC	14	+	2	AAGTGC
gi|514486632|gb|KE346360.1|	1466997	1467015	ACAGTC	18	+	3	CACAGT
gi|514486632|gb|KE346360.1|	1467333	1467360	A	27	+	27	A
gi|514486632|gb|KE346360.1|	1467426	1467440	AACAGC	14	-	2	TTGCTG
gi|514486632|gb|KE346360.1|	1467721	1467737	AAG	16	+	5	AGA
gi|514486632|gb|KE346360.1|	1467748	1467762	AAAAAG	14	+	2	AAAAAG
gi|514486632|gb|KE346360.1|	1467915	1467927	AGCCCG	12	+	2	CGAGCC
gi|514486632|gb|KE346360.1|	1467970	1467987	A	17	+	17	A
gi|514486632|gb|KE346360.1|	1468101	1468118	ACTCC	17	-	3	GGAGT
gi|514486632|gb|KE346360.1|	1468276	1468290	A	14	+	14	A
gi|514486632|gb|KE346360.1|	1468291	1468303	A	12	+	12	A
gi|514486632|gb|KE346360.1|	1468531	1468554	A	23	+	23	A
gi|514486632|gb|KE346360.1|	1468578	1468591	A	13	-	13	T
gi|514486632|gb|KE346360.1|	1468859	1468871	AAAAGC	12	+	2	CAAAAG
gi|514486632|gb|KE346360.1|	1468985	1469018	AG	33	-	16	CT
gi|514486632|gb|KE346360.1|	1470030	1470048	ACGAGC	18	+	3	CGAGCA
gi|514486632|gb|KE346360.1|	1470459	1470472	ATCGGC	13	-	2	CGATGC
gi|514486632|gb|KE346360.1|	1470581	1470593	AGGGCC	12	+	2	GCCAGG
gi|514486632|gb|KE346360.1|	1470899	1470912	AACCTC	13	-	2	TTGAGG
gi|514486632|gb|KE346360.1|	1472197	1472209	AACGCC	12	+	2	AACGCC
gi|514486632|gb|KE346360.1|	1474822	1474834	AACCTC	12	-	2	GAGGTT
gi|514486632|gb|KE346360.1|	1476155	1476167	AGCAGG	12	+	2	AGGAGC
gi|514486632|gb|KE346360.1|	1476493	1476505	AAGGCC	12	+	2	AAGGCC
gi|514486632|gb|KE346360.1|	1476526	1476538	AAGGCC	12	+	2	AAGGCC
gi|514486632|gb|KE346360.1|	1476559	1476571	AAGGCC	12	+	2	AAGGCC
gi|514486632|gb|KE346360.1|	1476592	1476604	AAGGCC	12	+	2	AAGGCC
gi|514486632|gb|KE346360.1|	1476814	1476830	CCCCCG	16	+	2	CCCGCC
gi|514486632|gb|KE346360.1|	1476956	1476970	AACCTC	14	+	2	TCAACC
gi|514486632|gb|KE346360.1|	1477002	1477024	AGC	22	-	7	TGC
gi|514486632|gb|KE346360.1|	1477066	1477078	AAG	12	+	4	AAG
gi|514486632|gb|KE346360.1|	1477268	1477280	AAAAC	12	-	2	TGTTT
gi|514486632|gb|KE346360.1|	1477458	1477472	ACCACG	14	-	2	GTGGTC
gi|514486632|gb|KE346360.1|	1479377	1479390	AGGGCC	13	-	2	CTGGCC
gi|514486632|gb|KE346360.1|	1480388	1480401	ATCATG	13	+	2	TCATGA
gi|514486632|gb|KE346360.1|	1480521	1480535	ACCATC	14	+	2	CACCAT
gi|514486632|gb|KE346360.1|	1480533	1480550	AGC	17	+	5	CAG
gi|514486632|gb|KE346360.1|	1480791	1480810	AC	19	-	9	TG
gi|514486632|gb|KE346360.1|	1480915	1480931	AGC	16	+	5	CAG
gi|514486632|gb|KE346360.1|	1480952	1480996	AGC	44	-	14	CTG
gi|514486632|gb|KE346360.1|	1482287	1482300	AAACAC	13	-	2	GTGTTT
gi|514486632|gb|KE346360.1|	1482970	1482984	AGG	14	+	4	AGG
gi|514486632|gb|KE346360.1|	1483112	1483133	AGG	21	+	7	GGA
gi|514486632|gb|KE346360.1|	1484408	1484420	AACGAG	12	+	2	CGAGAA
gi|514486632|gb|KE346360.1|	1484647	1484660	ACTCCG	13	-	2	GAGTCG
gi|514486632|gb|KE346360.1|	1484938	1484950	AACTGC	12	+	2	CTGCAA
gi|514486632|gb|KE346360.1|	1485025	1485048	AGC	23	+	7	CAG
gi|514486632|gb|KE346360.1|	1485510	1485536	A	26	-	26	T
gi|514486632|gb|KE346360.1|	1485537	1485549	A	12	-	12	T
gi|514486632|gb|KE346360.1|	1485749	1485773	A	24	-	24	T
gi|514486632|gb|KE346360.1|	1486102	1486118	A	16	+	16	A
gi|514486632|gb|KE346360.1|	1486123	1486142	A	19	+	19	A
gi|514486632|gb|KE346360.1|	1486311	1486331	A	20	-	20	T
gi|514486632|gb|KE346360.1|	1486530	1486543	A	13	-	13	T
gi|514486632|gb|KE346360.1|	1487317	1487330	ACG	13	-	4	CGT
gi|514486632|gb|KE346360.1|	1488009	1488023	AACATC	14	+	2	CAACAT
gi|514486632|gb|KE346360.1|	1488090	1488110	AACAGC	20	+	3	CAGCAA
gi|514486632|gb|KE346360.1|	1488719	1488732	AAATGC	13	+	2	CAAATG
gi|514486632|gb|KE346360.1|	1488902	1488915	AACAGC	13	+	2	CAGCAA
gi|514486632|gb|KE346360.1|	1489046	1489068	AGC	22	+	7	CAG
gi|514486632|gb|KE346360.1|	1489236	1489249	AAGGG	13	-	2	TCCCT
gi|514486632|gb|KE346360.1|	1489337	1489349	AACAGC	12	+	2	CAGCAA
gi|514486632|gb|KE346360.1|	1489523	1489535	AAGCGC	12	+	2	GCGCAA
gi|514486632|gb|KE346360.1|	1490243	1490268	A	25	+	25	A
gi|514486632|gb|KE346360.1|	1490477	1490489	A	12	-	12	T
gi|514486632|gb|KE346360.1|	1490762	1490780	A	18	-	18	T
gi|514486632|gb|KE346360.1|	1490786	1490798	A	12	-	12	T
gi|514486632|gb|KE346360.1|	1490997	1491018	A	21	-	21	T
gi|514486632|gb|KE346360.1|	1491274	1491297	A	23	-	23	T
gi|514486632|gb|KE346360.1|	1491325	1491337	AAAGTT	12	-	2	AACTTT
gi|514486632|gb|KE346360.1|	1491467	1491480	A	13	-	13	T
gi|514486632|gb|KE346360.1|	1495016	1495029	ACCCCG	13	+	2	CCCCGA
gi|514486632|gb|KE346360.1|	1495468	1495481	AATAGG	13	-	2	ATTCCT
gi|514486632|gb|KE346360.1|	1495791	1495803	AAGGGG	12	-	2	CTTCCC
gi|514486632|gb|KE346360.1|	1496022	1496035	ACATGT	13	+	2	CATGTA
gi|514486632|gb|KE346360.1|	1497202	1497216	AAAAAG	14	-	2	TTTTCT
gi|514486632|gb|KE346360.1|	1497259	1497272	AC	13	-	6	TG
gi|514486632|gb|KE346360.1|	1497321	1497333	AAACAC	12	-	2	TGTGTT
gi|514486632|gb|KE346360.1|	1497734	1497746	AGCTC	12	+	2	CAGCT
gi|514486632|gb|KE346360.1|	1497878	1497891	AGC	13	+	4	CAG
gi|514486632|gb|KE346360.1|	1500106	1500118	AACCC	12	-	2	TTGGG
gi|514486632|gb|KE346360.1|	1501011	1501044	A	33	+	33	A
gi|514486632|gb|KE346360.1|	1501113	1501126	AACATC	13	+	2	CATCAA
gi|514486632|gb|KE346360.1|	1501949	1501962	AACACG	13	-	2	TGTTCG
gi|514486632|gb|KE346360.1|	1502163	1502184	AGC	21	-	7	CTG
gi|514486632|gb|KE346360.1|	1502206	1502222	ACG	16	+	5	GAC
gi|514486632|gb|KE346360.1|	1502737	1502750	AAGACG	13	-	2	TTCGTC
gi|514486632|gb|KE346360.1|	1503392	1503413	ACG	21	-	7	TCG
gi|514486632|gb|KE346360.1|	1503612	1503629	ACGGCG	17	-	2	CGCCGT
gi|514486632|gb|KE346360.1|	1504140	1504154	AAC	14	-	4	TTG
gi|514486632|gb|KE346360.1|	1504152	1504164	A	12	-	12	T
gi|514486632|gb|KE346360.1|	1504160	1504174	AAAAC	14	-	2	TTTTG
gi|514486632|gb|KE346360.1|	1504173	1504187	AAAAC	14	-	2	TTTTG
gi|514486632|gb|KE346360.1|	1504306	1504319	ACTGG	13	+	2	GACTG
gi|514486632|gb|KE346360.1|	1505097	1505110	ACGATG	13	-	2	GTCATC
gi|514486632|gb|KE346360.1|	1505121	1505142	ATC	21	+	7	CAT
gi|514486632|gb|KE346360.1|	1505144	1505163	ATC	19	+	6	TCA
gi|514486632|gb|KE346360.1|	1505286	1505298	AAAGGG	12	-	2	TTCCCT
gi|514486632|gb|KE346360.1|	1505544	1505557	AAAAC	13	+	2	AAAAC
gi|514486632|gb|KE346360.1|	1505600	1505613	AC	13	+	6	AC
gi|514486632|gb|KE346360.1|	1505733	1505745	AGGGC	12	+	2	GGCAG
gi|514486632|gb|KE346360.1|	1505757	1505769	AGC	12	+	4	GCA
gi|514486632|gb|KE346360.1|	1506256	1506271	ACC	15	+	5	CAC
gi|514486632|gb|KE346360.1|	1506820	1506832	AACGAG	12	-	2	GTTCTC
gi|514486632|gb|KE346360.1|	1506833	1506848	AAT	15	-	5	ATT
gi|514486632|gb|KE346360.1|	1507069	1507082	AAC	13	-	4	GTT
gi|514486632|gb|KE346360.1|	1507083	1507095	AAAAG	12	-	2	TTTCT
gi|514486632|gb|KE346360.1|	1507463	1507478	AAAAG	15	+	3	AAAAG
gi|514486632|gb|KE346360.1|	1507862	1507874	AAATGC	12	-	2	GCATTT
gi|514486632|gb|KE346360.1|	1508899	1508925	AG	26	+	13	GA
gi|514486632|gb|KE346360.1|	1509128	1509143	AAAC	15	+	3	AAAC
gi|514486632|gb|KE346360.1|	1509462	1509474	ACTAGC	12	+	2	AGCACT
gi|514486632|gb|KE346360.1|	1512545	1512557	AAACTC	12	+	2	AACTCA
gi|514486632|gb|KE346360.1|	1512552	1512564	ACACTC	12	+	2	ACTCAC
gi|514486632|gb|KE346360.1|	1512569	1512582	AC	13	+	6	CA
gi|514486632|gb|KE346360.1|	1512581	1512607	AG	26	-	13	CT
gi|514486632|gb|KE346360.1|	1512892	1512907	A	15	+	15	A
gi|514486632|gb|KE346360.1|	1512913	1512925	A	12	+	12	A
gi|514486632|gb|KE346360.1|	1513182	1513196	AACC	14	-	3	GTTG
gi|514486632|gb|KE346360.1|	1514676	1514690	ACCCC	14	+	2	CCCCA
gi|514486632|gb|KE346360.1|	1514707	1514723	ACAGCC	16	+	2	CCACAG
gi|514486632|gb|KE346360.1|	1514742	1514759	AGCG	17	+	4	CGAG
gi|514486632|gb|KE346360.1|	1514762	1514776	A	14	+	14	A
gi|514486632|gb|KE346360.1|	1514879	1514891	ACCGAG	12	+	2	ACCGAG
gi|514486632|gb|KE346360.1|	1514934	1514954	A	20	+	20	A
gi|514486632|gb|KE346360.1|	1514956	1514976	A	20	+	20	A
gi|514486632|gb|KE346360.1|	1516030	1516042	AAAAC	12	+	2	AACAA
gi|514486632|gb|KE346360.1|	1516135	1516148	A	13	-	13	T
gi|514486632|gb|KE346360.1|	1516256	1516274	AGG	18	-	6	CCT
gi|514486632|gb|KE346360.1|	1516654	1516667	A	13	-	13	T
gi|514486632|gb|KE346360.1|	1516668	1516686	A	18	-	18	T
gi|514486632|gb|KE346360.1|	1516986	1516998	AAGAGG	12	-	2	TCTTCC
gi|514486632|gb|KE346360.1|	1519815	1519848	AGC	33	+	11	AGC
gi|514486632|gb|KE346360.1|	1520203	1520217	AGC	14	+	4	GCA
gi|514486632|gb|KE346360.1|	1520224	1520239	CCG	15	-	5	GCG
gi|514486632|gb|KE346360.1|	1520260	1520273	AGGCGG	13	+	2	GAGGCG
gi|514486632|gb|KE346360.1|	1520272	1520287	AGC	15	+	5	GCA
gi|514486632|gb|KE346360.1|	1521089	1521101	ACTCGG	12	-	2	AGTCCG
gi|514486632|gb|KE346360.1|	1521284	1521297	ACGCAG	13	+	2	CAGACG
gi|514486632|gb|KE346360.1|	1521292	1521307	ACGCGG	15	+	2	GACGCG
gi|514486632|gb|KE346360.1|	1522659	1522684	A	25	+	25	A
gi|514486632|gb|KE346360.1|	1523274	1523286	ACG	12	-	4	TCG
gi|514486632|gb|KE346360.1|	1523436	1523449	AGC	13	-	4	GCT
gi|514486632|gb|KE346360.1|	1523447	1523468	ATC	21	-	7	TGA
gi|514486632|gb|KE346360.1|	1523466	1523485	ACG	19	+	6	GAC
gi|514486632|gb|KE346360.1|	1523571	1523584	ACGAGG	13	-	2	TCGTCC
gi|514486632|gb|KE346360.1|	1523863	1523878	AAGGGC	15	-	2	CTTGCC
gi|514486632|gb|KE346360.1|	1524598	1524610	AGCTCC	12	+	2	CAGCTC
gi|514486632|gb|KE346360.1|	1525608	1525624	AGCGGC	16	+	2	CAGCGG
gi|514486632|gb|KE346360.1|	1525754	1525770	ACTAGC	16	-	2	TGCTAG
gi|514486632|gb|KE346360.1|	1525903	1525933	A	30	+	30	A
gi|514486632|gb|KE346360.1|	1525954	1525968	A	14	+	14	A
gi|514486632|gb|KE346360.1|	1526294	1526309	A	15	+	15	A
gi|514486632|gb|KE346360.1|	1526385	1526402	AAAC	17	-	4	GTTT
gi|514486632|gb|KE346360.1|	1526399	1526416	AAGC	17	-	4	TTGC
gi|514486632|gb|KE346360.1|	1526894	1526907	AAG	13	-	4	TTC
gi|514486632|gb|KE346360.1|	1527155	1527169	AGAGCG	14	-	2	TCTCGC
gi|514486632|gb|KE346360.1|	1527164	1527183	AGCGCG	19	-	3	CGCTCG
gi|514486632|gb|KE346360.1|	1527211	1527224	AGGGG	13	+	2	GAGGG
gi|514486632|gb|KE346360.1|	1527228	1527242	AG	14	+	7	AG
gi|514486632|gb|KE346360.1|	1527241	1527261	AC	20	-	10	GT
gi|514486632|gb|KE346360.1|	1527328	1527341	A	13	-	13	T
gi|514486632|gb|KE346360.1|	1527342	1527354	AAC	12	-	4	GTT
gi|514486632|gb|KE346360.1|	1528455	1528467	AAAGCG	12	+	2	AAAGCG
gi|514486632|gb|KE346360.1|	1528637	1528649	AAGTGC	12	+	2	GTGCAA
gi|514486632|gb|KE346360.1|	1528670	1528683	A	13	+	13	A
gi|514486632|gb|KE346360.1|	1528725	1528738	AGGG	13	-	3	CCTC
gi|514486632|gb|KE346360.1|	1530803	1530815	ACCGCC	12	-	2	TGGCGG
gi|514486632|gb|KE346360.1|	1531026	1531038	AAGGTC	12	-	2	GACCTT
gi|514486632|gb|KE346360.1|	1531219	1531240	ACGCAG	21	+	3	GCAGAC
gi|514486632|gb|KE346360.1|	1531288	1531304	ACG	16	+	5	GAC
gi|514486632|gb|KE346360.1|	1531322	1531336	AGC	14	+	4	CAG
gi|514486632|gb|KE346360.1|	1531436	1531449	A	13	+	13	A
gi|514486632|gb|KE346360.1|	1535481	1535494	AGCGCG	13	-	2	CGCGCT
gi|514486632|gb|KE346360.1|	1535642	1535654	AC	12	+	6	CA
gi|514486632|gb|KE346360.1|	1535852	1535865	AGC	13	-	4	TGC
gi|514486632|gb|KE346360.1|	1536315	1536327	AATTGC	12	+	2	ATTGCA
gi|514486632|gb|KE346360.1|	1536570	1536597	A	27	+	27	A
gi|514486632|gb|KE346360.1|	1536865	1536878	AGGGGG	13	-	2	CTCCCC
gi|514486632|gb|KE346360.1|	1536981	1537004	A	23	-	23	T
gi|514486632|gb|KE346360.1|	1537054	1537067	CCCGCG	13	-	2	GGGCGC
gi|514486632|gb|KE346360.1|	1537367	1537380	AAAAAC	13	+	2	AAAAAC
gi|514486632|gb|KE346360.1|	1537401	1537415	AGG	14	-	4	TCC
gi|514486632|gb|KE346360.1|	1537431	1537454	ACG	23	-	7	TCG
gi|514486632|gb|KE346360.1|	1537449	1537472	AAGACG	23	-	3	TCGTCT
gi|514486632|gb|KE346360.1|	1539105	1539117	AAAAGG	12	-	2	CTTTTC
gi|514486632|gb|KE346360.1|	1539782	1539794	AAAACC	12	+	2	AAAACC
gi|514486632|gb|KE346360.1|	1539795	1539814	A	19	+	19	A
gi|514486632|gb|KE346360.1|	1540111	1540130	AGC	19	+	6	GCA
gi|514486632|gb|KE346360.1|	1540169	1540181	ACGGCG	12	-	2	CGTCGC
gi|514486632|gb|KE346360.1|	1540248	1540272	AAGGAC	24	-	4	CTTGTC
gi|514486632|gb|KE346360.1|	1541868	1541880	AGAGAT	12	-	2	TCTCTA
gi|514486632|gb|KE346360.1|	1543187	1543208	AAAC	21	-	5	TGTT
gi|514486632|gb|KE346360.1|	1544383	1544395	ACC	12	-	4	GGT
gi|514486632|gb|KE346360.1|	1546130	1546194	AG	64	+	32	GA
gi|514486632|gb|KE346360.1|	1546440	1546452	AAGCCG	12	-	2	TTCGGC
gi|514486632|gb|KE346360.1|	1546483	1546496	ACTCGC	13	+	2	TCGCAC
gi|514486632|gb|KE346360.1|	1546588	1546600	AAAAAT	12	+	2	AAAATA
gi|514486632|gb|KE346360.1|	1546652	1546665	AAAAAC	13	-	2	GTTTTT
gi|514486632|gb|KE346360.1|	1546759	1546771	A	12	+	12	A
gi|514486632|gb|KE346360.1|	1547523	1547540	AATGCC	17	+	2	TGCCAA
gi|514486632|gb|KE346360.1|	1548043	1548061	A	18	+	18	A
gi|514486632|gb|KE346360.1|	1548207	1548219	AAAAT	12	+	2	AAAAT
gi|514486632|gb|KE346360.1|	1548252	1548268	A	16	+	16	A
gi|514486632|gb|KE346360.1|	1548291	1548303	AATCGC	12	-	2	ATTGCG
gi|514486632|gb|KE346360.1|	1548385	1548398	ACACTC	13	-	2	GAGTGT
gi|514486632|gb|KE346360.1|	1548749	1548766	AATG	17	+	4	TGAA
gi|514486632|gb|KE346360.1|	1548926	1548938	AAATCC	12	-	2	TGGATT
gi|514486632|gb|KE346360.1|	1549233	1549258	AGC	25	+	8	AGC
gi|514486632|gb|KE346360.1|	1549315	1549333	ACG	18	+	6	ACG
gi|514486632|gb|KE346360.1|	1549636	1549649	ACACTC	13	+	2	ACACTC
gi|514486632|gb|KE346360.1|	1550118	1550130	ACCGCC	12	-	2	GCGGTG
gi|514486632|gb|KE346360.1|	1550939	1550958	AG	19	-	9	CT
gi|514486632|gb|KE346360.1|	1550978	1551060	AC	82	+	41	CA
gi|514486632|gb|KE346360.1|	1551060	1551082	AC	22	+	11	AC
gi|514486632|gb|KE346360.1|	1551185	1551198	AATGGC	13	-	2	CATTGC
gi|514486632|gb|KE346360.1|	1551838	1551850	AAGCGC	12	+	2	GCAAGC
gi|514486632|gb|KE346360.1|	1553242	1553256	ACG	14	-	4	TCG
gi|514486632|gb|KE346360.1|	1553305	1553317	AGCCCC	12	-	2	GCTGGG
gi|514486632|gb|KE346360.1|	1553363	1553379	AGCGGG	16	+	2	GAGCGG
gi|514486632|gb|KE346360.1|	1553824	1553836	ACG	12	-	4	TCG
gi|514486632|gb|KE346360.1|	1553959	1553972	AAGC	13	-	3	GCTT
gi|514486632|gb|KE346360.1|	1553982	1554008	AGC	26	+	8	AGC
gi|514486632|gb|KE346360.1|	1554198	1554210	AAAAGG	12	+	2	GAAAAG
gi|514486632|gb|KE346360.1|	1554216	1554230	AAAAG	14	+	2	AAAAG
gi|514486632|gb|KE346360.1|	1554224	1554237	AAAAAG	13	+	2	AGAAAA
gi|514486632|gb|KE346360.1|	1554232	1554245	A	13	+	13	A
gi|514486632|gb|KE346360.1|	1554247	1554259	ACTGAG	12	+	2	GAGACT
gi|514486632|gb|KE346360.1|	1554576	1554588	AGCATC	12	+	2	TCAGCA
gi|514486632|gb|KE346360.1|	1554883	1554899	A	16	+	16	A
gi|514486632|gb|KE346360.1|	1554913	1554927	AACAGG	14	+	2	AACAGG
gi|514486632|gb|KE346360.1|	1555459	1555472	ACCCCC	13	-	2	GGGGGT
gi|514486632|gb|KE346360.1|	1555848	1555862	A	14	+	14	A
gi|514486632|gb|KE346360.1|	1555972	1555985	ACGTCG	13	+	2	GACGTC
gi|514486632|gb|KE346360.1|	1556100	1556112	ACGATG	12	+	2	GATGAC
gi|514486632|gb|KE346360.1|	1556443	1556455	ACGGCT	12	-	2	GCCGTA
gi|514486632|gb|KE346360.1|	1560823	1560835	AAAC	12	+	3	AAAC
gi|514486632|gb|KE346360.1|	1560967	1560990	AAC	23	+	7	AAC
gi|514486632|gb|KE346360.1|	1561004	1561016	AACCTG	12	-	2	GTTCAG
gi|514486632|gb|KE346360.1|	1561054	1561066	A	12	-	12	T
gi|514486632|gb|KE346360.1|	1561300	1561329	A	29	-	29	T
gi|514486632|gb|KE346360.1|	1561494	1561518	A	24	-	24	T
gi|514486632|gb|KE346360.1|	1561536	1561548	A	12	-	12	T
gi|514486632|gb|KE346360.1|	1561761	1561773	A	12	-	12	T
gi|514486632|gb|KE346360.1|	1562026	1562038	AAGCC	12	-	2	TTGGC
gi|514486632|gb|KE346360.1|	1562793	1562810	CCG	17	+	5	CCG
gi|514486632|gb|KE346360.1|	1562817	1562830	AGC	13	-	4	CTG
gi|514486632|gb|KE346360.1|	1563071	1563088	AGC	17	-	5	GCT
gi|514486632|gb|KE346360.1|	1563086	1563100	CCG	14	+	4	GCC
gi|514486632|gb|KE346360.1|	1563348	1563371	ACC	23	+	7	CCA
gi|514486632|gb|KE346360.1|	1563609	1563622	CCG	13	+	4	CCG
gi|514486632|gb|KE346360.1|	1563644	1563658	AGCGGC	14	-	2	GCCGCT
gi|514486632|gb|KE346360.1|	1563811	1563823	AACACC	12	+	2	CCAACA
gi|514486632|gb|KE346360.1|	1563830	1563844	AGC	14	+	4	CAG
gi|514486632|gb|KE346360.1|	1563854	1563868	AGC	14	+	4	CAG
gi|514486632|gb|KE346360.1|	1564138	1564153	AGC	15	+	5	GCA
gi|514486632|gb|KE346360.1|	1564435	1564447	ACCAGC	12	+	2	CCAGCA
gi|514486632|gb|KE346360.1|	1564453	1564467	ACCCCT	14	+	2	CTACCC
gi|514486632|gb|KE346360.1|	1564646	1564658	AGGGCC	12	+	2	GGCCAG
gi|514486632|gb|KE346360.1|	1564742	1564757	AGGGCC	15	+	2	CAGGGC
gi|514486632|gb|KE346360.1|	1564766	1564784	ACTGCG	18	-	3	TCGCAG
gi|514486632|gb|KE346360.1|	1564784	1564801	AACAGC	17	+	2	CAGCAA
gi|514486632|gb|KE346360.1|	1565146	1565160	AAAAC	14	+	2	AAAAC
gi|514486632|gb|KE346360.1|	1565630	1565644	AGAGCG	14	+	2	CGAGAG
gi|514486632|gb|KE346360.1|	1566373	1566385	A	12	-	12	T
gi|514486632|gb|KE346360.1|	1566381	1566393	AAAAG	12	-	2	TTTTC
gi|514486632|gb|KE346360.1|	1566537	1566558	A	21	-	21	T
gi|514486632|gb|KE346360.1|	1567546	1567558	AGCC	12	+	3	CCAG
gi|514486632|gb|KE346360.1|	1569291	1569309	A	18	-	18	T
gi|514486632|gb|KE346360.1|	1569509	1569521	ACTG	12	-	3	GTCA
gi|514486632|gb|KE346360.1|	1569521	1569533	ACTG	12	-	3	AGTC
gi|514486632|gb|KE346360.1|	1569652	1569676	A	24	+	24	A
gi|514486632|gb|KE346360.1|	1570709	1570723	AGG	14	-	4	TCC
gi|514486632|gb|KE346360.1|	1570849	1570861	AAGCTG	12	-	2	TTCAGC
gi|514486632|gb|KE346360.1|	1571324	1571337	AATACG	13	-	2	GTATTC
gi|514486632|gb|KE346360.1|	1571709	1571723	AGC	14	-	4	CTG
gi|514486632|gb|KE346360.1|	1572012	1572024	AAAAG	12	+	2	AGAAA
gi|514486632|gb|KE346360.1|	1572051	1572064	A	13	-	13	T
gi|514486632|gb|KE346360.1|	1572334	1572354	AAAC	20	+	5	ACAA
gi|514486632|gb|KE346360.1|	1577320	1577335	AAAAAC	15	+	2	AAACAA
gi|514486632|gb|KE346360.1|	1577472	1577489	AAAGG	17	+	3	AAAGG
gi|514486632|gb|KE346360.1|	1577629	1577641	ACACCC	12	-	2	GTGTGG
gi|514486632|gb|KE346360.1|	1577865	1577881	AAAAG	16	+	3	AAAGA
gi|514486632|gb|KE346360.1|	1578876	1578891	AATGAC	15	-	2	TGTCAT
gi|514486632|gb|KE346360.1|	1579546	1579559	AATG	13	+	3	ATGA
gi|514486632|gb|KE346360.1|	1579660	1579674	ACCACG	14	+	2	ACGACC
gi|514486632|gb|KE346360.1|	1580349	1580361	AACTTC	12	-	2	TGAAGT
gi|514486632|gb|KE346360.1|	1580623	1580635	ACGATG	12	-	2	TCGTCA
gi|514486632|gb|KE346360.1|	1581721	1581738	A	17	-	17	T
gi|514486632|gb|KE346360.1|	1582403	1582419	AAGGGC	16	+	2	CAAGGG
gi|514486632|gb|KE346360.1|	1582478	1582504	AGC	26	-	8	TGC
gi|514486632|gb|KE346360.1|	1583550	1583563	A	13	-	13	T
gi|514486632|gb|KE346360.1|	1583605	1583619	A	14	-	14	T
gi|514486632|gb|KE346360.1|	1584391	1584408	AAG	17	+	5	AAG
gi|514486632|gb|KE346360.1|	1584960	1584978	AAAGGG	18	-	3	CTTTCC
gi|514486632|gb|KE346360.1|	1585544	1585557	AAATGG	13	+	2	GAAATG
gi|514486632|gb|KE346360.1|	1585942	1585954	A	12	+	12	A
gi|514486632|gb|KE346360.1|	1586345	1586359	AAAG	14	+	3	GAAA
gi|514486632|gb|KE346360.1|	1586356	1586375	AG	19	+	9	AG
gi|514486632|gb|KE346360.1|	1586584	1586597	ACGAGG	13	+	2	GACGAG
gi|514486632|gb|KE346360.1|	1586743	1586774	AGCAGG	31	+	5	GGAGCA
gi|514486632|gb|KE346360.1|	1586778	1586790	AGC	12	+	4	AGC
gi|514486632|gb|KE346360.1|	1586868	1586881	AGC	13	+	4	CAG
gi|514486632|gb|KE346360.1|	1586903	1586916	ACAGGC	13	+	2	CAGGCA
gi|514486632|gb|KE346360.1|	1586927	1586944	AGCCTG	17	-	2	CAGGCT
gi|514486632|gb|KE346360.1|	1587182	1587207	AAGGAC	25	+	4	ACAAGG
gi|514486632|gb|KE346360.1|	1587202	1587225	AAGGAG	23	+	3	AAGGAG
gi|514486632|gb|KE346360.1|	1587220	1587243	AAGGAC	23	+	3	AAGGAC
gi|514486632|gb|KE346360.1|	1587247	1587267	AAGGAC	20	+	3	GACAAG
gi|514486632|gb|KE346360.1|	1587268	1587291	AAGGAC	23	+	3	AAGGAC
gi|514486632|gb|KE346360.1|	1587716	1587728	CCCCCG	12	-	2	GGGGGC
gi|514486632|gb|KE346360.1|	1589019	1589043	A	24	-	24	T
gi|514486632|gb|KE346360.1|	1589290	1589310	AGC	20	+	6	GCA
gi|514486632|gb|KE346360.1|	1589751	1589771	AAC	20	-	6	TGT
gi|514486632|gb|KE346360.1|	1591377	1591389	AAAAAC	12	-	2	TTTTTG
gi|514486632|gb|KE346360.1|	1591811	1591823	AGGGG	12	-	2	CCCTC
gi|514486632|gb|KE346360.1|	1591822	1591834	AAAAAC	12	+	2	CAAAAA
gi|514486632|gb|KE346360.1|	1592924	1592940	AAATC	16	-	3	TGATT
gi|514486632|gb|KE346360.1|	1595041	1595053	AGCGCG	12	-	2	TCGCGC
gi|514486632|gb|KE346360.1|	1595193	1595205	AGG	12	-	4	TCC
gi|514486632|gb|KE346360.1|	1595296	1595310	AGC	14	+	4	CAG
gi|514486632|gb|KE346360.1|	1595311	1595334	AGC	23	+	7	CAG
gi|514486632|gb|KE346360.1|	1595332	1595353	AAC	21	+	7	CAA
gi|514486632|gb|KE346360.1|	1595656	1595690	AAC	34	-	11	TTG
gi|514486632|gb|KE346360.1|	1595830	1595843	ATGCGC	13	+	2	ATGCGC
gi|514486632|gb|KE346360.1|	1596518	1596532	ACGCCG	14	-	2	GTCGGC
gi|514486632|gb|KE346360.1|	1596540	1596553	AGCGCG	13	-	2	TCGCGC
gi|514486632|gb|KE346360.1|	1596795	1596807	AATTCC	12	+	2	CAATTC
gi|514486632|gb|KE346360.1|	1597199	1597214	A	15	-	15	T
gi|514486632|gb|KE346360.1|	1597291	1597306	ACAGAG	15	-	2	TGTCTC
gi|514486632|gb|KE346360.1|	1597606	1597625	ATC	19	+	6	TCA
gi|514486632|gb|KE346360.1|	1599403	1599418	AAC	15	-	5	TTG
gi|514486632|gb|KE346360.1|	1599835	1599848	AAAAAC	13	-	2	TGTTTT
gi|514486632|gb|KE346360.1|	1600420	1600506	AG	86	+	43	AG
gi|514486632|gb|KE346360.1|	1600503	1600516	ACTC	13	-	3	GAGT
gi|514486632|gb|KE346360.1|	1600525	1600539	AAAC	14	+	3	AAAC
gi|514486632|gb|KE346360.1|	1601283	1601364	ATC	81	+	27	CAT
gi|514486632|gb|KE346360.1|	1602732	1602754	ACC	22	-	7	GTG
gi|514486632|gb|KE346360.1|	1603145	1603157	AATTCG	12	+	2	ATTCGA
gi|514486632|gb|KE346360.1|	1603521	1603544	A	23	-	23	T
gi|514486632|gb|KE346360.1|	1603573	1603595	A	22	-	22	T
gi|514486632|gb|KE346360.1|	1603793	1603811	A	18	-	18	T
gi|514486632|gb|KE346360.1|	1604186	1604199	A	13	-	13	T
gi|514486632|gb|KE346360.1|	1604239	1604256	A	17	-	17	T
gi|514486632|gb|KE346360.1|	1604475	1604487	AACAC	12	+	2	CACAA
gi|514486632|gb|KE346360.1|	1604568	1604583	ATCGC	15	-	3	GATGC
gi|514486632|gb|KE346360.1|	1604661	1604676	A	15	+	15	A
gi|514486632|gb|KE346360.1|	1604677	1604689	A	12	+	12	A
gi|514486632|gb|KE346360.1|	1606563	1606575	AAAAG	12	-	2	CTTTT
gi|514486632|gb|KE346360.1|	1606912	1606924	AATG	12	+	3	TGAA
gi|514486632|gb|KE346360.1|	1606932	1606950	A	18	-	18	T
gi|514486632|gb|KE346360.1|	1607714	1607726	AAAAAG	12	-	2	TTTTCT
gi|514486632|gb|KE346360.1|	1608097	1608118	AACG	21	-	5	TCGT
gi|514486632|gb|KE346360.1|	1608792	1608804	AAAAC	12	+	2	AACAA
gi|514486632|gb|KE346360.1|	1612019	1612031	AGCGGC	12	-	2	CCGCTG
gi|514486632|gb|KE346360.1|	1612596	1612608	AGCAGG	12	+	2	GGAGCA
gi|514486632|gb|KE346360.1|	1612642	1612660	AGCCGC	18	+	3	CCGCAG
gi|514486632|gb|KE346360.1|	1612727	1612740	AAGGAC	13	-	2	GTCCTT
gi|514486632|gb|KE346360.1|	1613556	1613568	AATCAG	12	-	2	TGATTC
gi|514486632|gb|KE346360.1|	1613828	1613841	A	13	-	13	T
gi|514486632|gb|KE346360.1|	1613874	1613900	A	26	-	26	T
gi|514486632|gb|KE346360.1|	1614098	1614130	A	32	-	32	T
gi|514486632|gb|KE346360.1|	1614160	1614172	AAAACC	12	-	2	TTTGGT
gi|514486632|gb|KE346360.1|	1614381	1614393	C	12	-	12	G
gi|514486632|gb|KE346360.1|	1614507	1614532	A	25	+	25	A
gi|514486632|gb|KE346360.1|	1614527	1614550	AAAAAG	23	+	3	AAAAAG
gi|514486632|gb|KE346360.1|	1614554	1614567	A	13	+	13	A
gi|514486632|gb|KE346360.1|	1614568	1614581	A	13	+	13	A
gi|514486632|gb|KE346360.1|	1614967	1614986	AC	19	+	9	AC
gi|514486632|gb|KE346360.1|	1614998	1615011	ACGATG	13	+	2	GACGAT
gi|514486632|gb|KE346360.1|	1615112	1615124	ACCGCG	12	-	2	GTCGCG
gi|514486632|gb|KE346360.1|	1615824	1615836	AAAAAC	12	-	2	TTTTTG
gi|514486632|gb|KE346360.1|	1616586	1616599	AAAC	13	-	3	GTTT
gi|514486632|gb|KE346360.1|	1616626	1616638	AGCC	12	-	3	GCTG
gi|514486632|gb|KE346360.1|	1617438	1617452	AGGGGG	14	-	2	CCCCTC
gi|514486632|gb|KE346360.1|	1617574	1617615	AC	41	+	20	AC
gi|514486632|gb|KE346360.1|	1617611	1617625	ACATC	14	+	2	CACAT
gi|514486632|gb|KE346360.1|	1617700	1617712	ACGGCG	12	+	2	GCGACG
gi|514486632|gb|KE346360.1|	1617815	1617831	ACG	16	+	5	GAC
gi|514486632|gb|KE346360.1|	1619025	1619186	AAC	161	-	53	TTG
gi|514486632|gb|KE346360.1|	1619790	1619806	AAGCTG	16	-	2	CTTCAG
gi|514486632|gb|KE346360.1|	1620009	1620026	AAAC	17	+	4	AAAC
gi|514486632|gb|KE346360.1|	1620044	1620058	AAAAC	14	+	2	AAAAC
gi|514486632|gb|KE346360.1|	1620052	1620064	AAAAAC	12	+	2	ACAAAA
gi|514486632|gb|KE346360.1|	1620616	1620629	ACAGAG	13	+	2	AGACAG
gi|514486632|gb|KE346360.1|	1620623	1620656	ACAG	33	+	8	GACA
gi|514486632|gb|KE346360.1|	1621215	1621234	A	19	+	19	A
gi|514486632|gb|KE346360.1|	1621827	1621839	A	12	-	12	T
gi|514486632|gb|KE346360.1|	1622055	1622067	AAGGCG	12	-	2	CGCCTT
gi|514486632|gb|KE346360.1|	1623073	1623085	AAAAAG	12	-	2	TTTTTC
gi|514486632|gb|KE346360.1|	1623096	1623112	A	16	-	16	T
gi|514486632|gb|KE346360.1|	1623261	1623273	AACCC	12	-	2	GGGTT
gi|514486632|gb|KE346360.1|	1623441	1623460	A	19	+	19	A
gi|514486632|gb|KE346360.1|	1624678	1624693	AC	15	-	7	TG
gi|514486632|gb|KE346360.1|	1624766	1624779	AAAAAC	13	-	2	TTTTTG
gi|514486632|gb|KE346360.1|	1624853	1624866	AC	13	-	6	GT
gi|514486632|gb|KE346360.1|	1624897	1624935	AAG	38	+	12	AAG
gi|514486632|gb|KE346360.1|	1625038	1625061	A	23	+	23	A
gi|514486632|gb|KE346360.1|	1625106	1625118	A	12	-	12	T
gi|514486632|gb|KE346360.1|	1625116	1625135	AAG	19	-	6	TTC
gi|514486632|gb|KE346360.1|	1625150	1625162	AAACAG	12	-	2	TGTTTC
gi|514486632|gb|KE346360.1|	1626330	1626344	AAAC	14	-	3	TTTG
gi|514486632|gb|KE346360.1|	1627078	1627090	ACGGGC	12	+	2	GGCACG
gi|514486632|gb|KE346360.1|	1627224	1627236	AC	12	-	6	TG
gi|514486632|gb|KE346360.1|	1627364	1627376	AATGCC	12	+	2	CCAATG
gi|514486632|gb|KE346360.1|	1627906	1627920	ACGAGG	14	-	2	CCTCGT
gi|514486632|gb|KE346360.1|	1628279	1628296	AACGAC	17	-	2	GTCGTT
gi|514486632|gb|KE346360.1|	1628291	1628315	ACG	24	-	8	GTC
gi|514486632|gb|KE346360.1|	1628800	1628812	ACCGC	12	+	2	ACCGC
gi|514486632|gb|KE346360.1|	1630323	1630337	AAGGG	14	+	2	GGGAA
gi|514486632|gb|KE346360.1|	1631517	1631529	ACTGGG	12	+	2	CTGGGA
gi|514486632|gb|KE346360.1|	1631834	1631864	ACC	30	+	10	CCA
gi|514486632|gb|KE346360.1|	1631862	1631878	AGC	16	+	5	CAG
gi|514486632|gb|KE346360.1|	1633036	1633048	AAAAAC	12	+	2	AACAAA
gi|514486632|gb|KE346360.1|	1633670	1633682	AGCGCG	12	+	2	GAGCGC
gi|514486632|gb|KE346360.1|	1633729	1633741	AGCCG	12	-	2	GCTCG
gi|514486632|gb|KE346360.1|	1634544	1634565	AGC	21	+	7	CAG
gi|514486632|gb|KE346360.1|	1635029	1635041	AGCCGC	12	-	2	GGCTGC
gi|514486632|gb|KE346360.1|	1635292	1635315	AAAAAC	23	+	3	AAAAAC
gi|514486632|gb|KE346360.1|	1635310	1635331	A	21	+	21	A
gi|514486632|gb|KE346360.1|	1635375	1635387	AGC	12	-	4	CTG
gi|514486632|gb|KE346360.1|	1635487	1635507	ACGAGG	20	+	3	GAGGAC
gi|514486632|gb|KE346360.1|	1635804	1635816	AGAGGG	12	+	2	GGGAGA
gi|514486632|gb|KE346360.1|	1635839	1635855	AG	16	+	8	GA
gi|514486632|gb|KE346360.1|	1635856	1635875	AG	19	+	9	AG
gi|514486632|gb|KE346360.1|	1636221	1636243	A	22	-	22	T
gi|514486632|gb|KE346360.1|	1636468	1636482	AGC	14	-	4	GCT
gi|514486632|gb|KE346360.1|	1637211	1637224	ACTGCC	13	+	2	CACTGC
gi|514486632|gb|KE346360.1|	1637393	1637407	AGC	14	-	4	CTG
gi|514486632|gb|KE346360.1|	1637410	1637422	CCG	12	+	4	GCC
gi|514486632|gb|KE346360.1|	1637719	1637734	AAG	15	-	5	TCT
gi|514486632|gb|KE346360.1|	1637735	1637749	AAG	14	-	4	CTT
gi|514486632|gb|KE346360.1|	1638987	1638999	AAAAGC	12	+	2	GCAAAA
gi|514486632|gb|KE346360.1|	1639085	1639104	AAG	19	-	6	CTT
gi|514486632|gb|KE346360.1|	1639339	1639354	AATG	15	-	3	TTCA
gi|514486632|gb|KE346360.1|	1639448	1639462	AACAGC	14	+	2	CAGCAA
gi|514486632|gb|KE346360.1|	1639662	1639676	AG	14	-	7	TC
gi|514486632|gb|KE346360.1|	1639677	1639696	AAAGAG	19	-	3	CTTTCT
gi|514486632|gb|KE346360.1|	1639695	1639707	CCCCCG	12	+	2	CCCCCG
gi|514486632|gb|KE346360.1|	1639758	1639771	AAAAC	13	+	2	AAAAC
gi|514486632|gb|KE346360.1|	1639968	1639981	AAAGAC	13	-	2	CTTTGT
gi|514486632|gb|KE346360.1|	1640462	1640476	AG	14	-	7	TC
gi|514486632|gb|KE346360.1|	1640829	1640841	AAAAAC	12	-	2	TTTTTG
gi|514486632|gb|KE346360.1|	1641275	1641303	A	28	-	28	T
gi|514486632|gb|KE346360.1|	1642301	1642313	AACTG	12	-	2	TCAGT
gi|514486632|gb|KE346360.1|	1642658	1642672	AAACAC	14	-	2	TTGTGT
gi|514486632|gb|KE346360.1|	1642695	1642711	AAAACC	16	-	2	TTGGTT
gi|514486632|gb|KE346360.1|	1643109	1643123	ACGATG	14	+	2	GATGAC
gi|514486632|gb|KE346360.1|	1643118	1643135	ACGAGG	17	+	2	GACGAG
gi|514486632|gb|KE346360.1|	1643733	1643749	CCG	16	-	5	CGG
gi|514486632|gb|KE346360.1|	1644340	1644383	AAC	43	+	14	CAA
gi|514486632|gb|KE346360.1|	1644513	1644525	AACAGC	12	+	2	CAACAG
gi|514486632|gb|KE346360.1|	1645223	1645235	AAC	12	+	4	CAA
gi|514486632|gb|KE346360.1|	1645248	1645261	AAAAAC	13	+	2	CAAAAA
gi|514486632|gb|KE346360.1|	1646148	1646160	AGAGCG	12	+	2	AGCGAG
gi|514486632|gb|KE346360.1|	1646202	1646214	ATCC	12	-	3	ATGG
gi|514486632|gb|KE346360.1|	1647107	1647119	AAACAC	12	+	2	AACACA
gi|514486632|gb|KE346360.1|	1647153	1647165	AAATG	12	-	2	ATTTC
gi|514486632|gb|KE346360.1|	1647206	1647218	AAACAC	12	-	2	GTGTTT
gi|514486632|gb|KE346360.1|	1647331	1647360	AC	29	-	14	GT
gi|514486632|gb|KE346360.1|	1647444	1647457	AAC	13	-	4	TGT
gi|514486632|gb|KE346360.1|	1647509	1647522	AC	13	-	6	TG
gi|514486632|gb|KE346360.1|	1647521	1647534	AG	13	-	6	TC
gi|514486632|gb|KE346360.1|	1647907	1647923	AAG	16	-	5	TCT
gi|514486632|gb|KE346360.1|	1649423	1649435	AACAGC	12	-	2	TGTTGC
gi|514486632|gb|KE346360.1|	1649602	1649614	ATCATG	12	+	2	TGATCA
gi|514486632|gb|KE346360.1|	1650013	1650027	AATGGC	14	-	2	CATTGC
gi|514486632|gb|KE346360.1|	1650625	1650637	ACGCAG	12	-	2	TGCGTC
gi|514486632|gb|KE346360.1|	1650831	1650845	ACGCCG	14	-	2	CGTCGG
gi|514486632|gb|KE346360.1|	1651134	1651148	ACGCAG	14	-	2	CTGCGT
gi|514486632|gb|KE346360.1|	1652455	1652471	A	16	-	16	T
gi|514486632|gb|KE346360.1|	1652473	1652489	A	16	-	16	T
gi|514486632|gb|KE346360.1|	1652656	1652682	AAC	26	+	8	AAC
gi|514486632|gb|KE346360.1|	1652976	1652993	AC	17	+	8	CA
gi|514486632|gb|KE346360.1|	1653037	1653049	ACACGT	12	+	2	TACACG
gi|514486632|gb|KE346360.1|	1654083	1654095	AACAGC	12	-	2	TGTTGC
gi|514486632|gb|KE346360.1|	1654262	1654274	ATCATG	12	+	2	TGATCA
gi|514486632|gb|KE346360.1|	1654673	1654687	AATGGC	14	-	2	CATTGC
gi|514486632|gb|KE346360.1|	1655290	1655302	ACGCCG	12	-	2	GCGTCG
gi|514486632|gb|KE346360.1|	1655466	1655478	CCG	12	+	4	CCG
gi|514486632|gb|KE346360.1|	1656082	1656094	A	12	-	12	T
gi|514486632|gb|KE346360.1|	1656211	1656224	AAAAC	13	+	2	AAACA
gi|514486632|gb|KE346360.1|	1656463	1656643	AG	180	-	90	TC
gi|514486632|gb|KE346360.1|	1656766	1656778	AAATAC	12	+	2	ATACAA
gi|514486632|gb|KE346360.1|	1659325	1659353	A	28	+	28	A
gi|514486632|gb|KE346360.1|	1659679	1659709	AGAGGG	30	-	5	TCTCCC
gi|514486632|gb|KE346360.1|	1659735	1659749	AGGGGG	14	+	2	AGGGGG
gi|514486632|gb|KE346360.1|	1659887	1659899	AGGATG	12	-	2	TCCTCA
gi|514486632|gb|KE346360.1|	1660382	1660408	AGC	26	-	8	TGC
gi|514486632|gb|KE346360.1|	1660406	1660419	AAC	13	-	4	TGT
gi|514486632|gb|KE346360.1|	1662522	1662534	AAAAG	12	+	2	AAAGA
gi|514486632|gb|KE346360.1|	1662537	1662549	AAAAAC	12	+	2	AAAAAC
gi|514486632|gb|KE346360.1|	1662855	1662870	AGC	15	+	5	CAG
gi|514486632|gb|KE346360.1|	1663014	1663027	AACAC	13	+	2	CACAA
gi|514486632|gb|KE346360.1|	1664299	1664311	ACGGCG	12	-	2	GTCGCC
gi|514486632|gb|KE346360.1|	1664797	1664809	CCCCCG	12	+	2	CCGCCC
gi|514486632|gb|KE346360.1|	1665805	1665817	AAAG	12	+	3	AGAA
gi|514486632|gb|KE346360.1|	1665818	1665830	AAAG	12	+	3	GAAA
gi|514486632|gb|KE346360.1|	1665837	1665849	AAGC	12	+	3	GCAA
gi|514486632|gb|KE346360.1|	1665919	1665935	AACGAC	16	+	2	CAACGA
gi|514486632|gb|KE346360.1|	1665930	1666023	AAC	93	+	31	ACA
gi|514486632|gb|KE346360.1|	1666017	1666033	AACAC	16	+	3	ACAAC
gi|514486632|gb|KE346360.1|	1666027	1666074	AAC	47	+	15	ACA
gi|514486632|gb|KE346360.1|	1666176	1666189	AAAAAC	13	+	2	CAAAAA
gi|514486632|gb|KE346360.1|	1666494	1666510	AATTCC	16	-	2	GGAATT
gi|514486632|gb|KE346360.1|	1667182	1667201	ACGAGG	19	+	3	GGACGA
gi|514486632|gb|KE346360.1|	1667209	1667226	AGC	17	-	5	GCT
gi|514486632|gb|KE346360.1|	1667222	1667234	ACTGCC	12	+	2	CTGCCA
gi|514486632|gb|KE346360.1|	1667256	1667273	AACATC	17	-	2	TGTTGA
gi|514486632|gb|KE346360.1|	1667511	1667528	AAT	17	+	5	AAT
gi|514486632|gb|KE346360.1|	1667610	1667622	AAGATG	12	+	2	GAAGAT
gi|514486632|gb|KE346360.1|	1667626	1667638	AGG	12	+	4	AGG
gi|514486632|gb|KE346360.1|	1667648	1667660	AAAGGG	12	+	2	GGGAAA
gi|514486632|gb|KE346360.1|	1667680	1667705	AG	25	+	12	AG
gi|514486632|gb|KE346360.1|	1667741	1667754	AAGGG	13	-	2	CCCTT
gi|514486632|gb|KE346360.1|	1669719	1669731	AAAAT	12	-	2	TTATT
gi|514486632|gb|KE346360.1|	1669725	1669737	AAAAAT	12	-	2	TATTTT
gi|514486632|gb|KE346360.1|	1669892	1669910	A	18	-	18	T
gi|514486632|gb|KE346360.1|	1669923	1669942	A	19	-	19	T
gi|514486632|gb|KE346360.1|	1670133	1670161	A	28	-	28	T
gi|514486632|gb|KE346360.1|	1670208	1670222	A	14	+	14	A
gi|514486632|gb|KE346360.1|	1670349	1670362	AAAAC	13	+	2	AAACA
gi|514486632|gb|KE346360.1|	1670358	1670375	A	17	+	17	A
gi|514486632|gb|KE346360.1|	1670382	1670394	ACCATC	12	+	2	TCACCA
gi|514486632|gb|KE346360.1|	1671708	1671723	AAC	15	-	5	TGT
gi|514486632|gb|KE346360.1|	1671724	1671737	ACT	13	-	4	GTA
gi|514486632|gb|KE346360.1|	1671739	1671756	AAC	17	-	5	GTT
gi|514486632|gb|KE346360.1|	1672140	1672153	AAAAAC	13	+	2	AAACAA
gi|514486632|gb|KE346360.1|	1672550	1672577	A	27	+	27	A
gi|514486632|gb|KE346360.1|	1673450	1673463	CCGCG	13	+	2	GCCGC
gi|514486632|gb|KE346360.1|	1673734	1673747	AAC	13	-	4	TTG
gi|514486632|gb|KE346360.1|	1674013	1674028	AAACAC	15	+	2	ACAAAC
gi|514486632|gb|KE346360.1|	1674258	1674270	A	12	+	12	A
gi|514486632|gb|KE346360.1|	1674266	1674280	AAAAG	14	+	2	AAAAG
gi|514486632|gb|KE346360.1|	1674287	1674299	A	12	+	12	A
gi|514486632|gb|KE346360.1|	1674491	1674511	AAAAAT	20	-	3	TTTTTA
gi|514486632|gb|KE346360.1|	1674768	1674781	AAAGC	13	-	2	TGCTT
gi|514486632|gb|KE346360.1|	1674919	1674935	AAAAGG	16	-	2	TTTTCC
gi|514486632|gb|KE346360.1|	1674931	1674943	A	12	-	12	T
gi|514486632|gb|KE346360.1|	1674945	1674957	A	12	-	12	T
gi|514486632|gb|KE346360.1|	1675112	1675125	A	13	-	13	T
gi|514486632|gb|KE346360.1|	1675130	1675143	AAATTG	13	-	2	TTTCAA
gi|514486632|gb|KE346360.1|	1675219	1675231	AAAAAT	12	-	2	TTTTTA
gi|514486632|gb|KE346360.1|	1675232	1675250	AAAAT	18	-	3	TTTAT
gi|514486632|gb|KE346360.1|	1675263	1675275	AAAG	12	-	3	TTTC
gi|514486632|gb|KE346360.1|	1676513	1676528	ACCCTC	15	+	2	TCACCC
gi|514486632|gb|KE346360.1|	1676576	1676588	AAGGCC	12	+	2	CCAAGG
gi|514486632|gb|KE346360.1|	1678271	1678283	A	12	-	12	T
gi|514486632|gb|KE346360.1|	1678312	1678324	ACCATC	12	-	2	ATGGTG
gi|514486632|gb|KE346360.1|	1678498	1678511	AAGCAC	13	-	2	TGCTTG
gi|514486632|gb|KE346360.1|	1678676	1678689	ACTGAG	13	+	2	GACTGA
gi|514486632|gb|KE346360.1|	1678986	1678998	AGAGC	12	-	2	TCTGC
gi|514486632|gb|KE346360.1|	1679574	1679586	AACTAC	12	+	2	ACAACT
gi|514486632|gb|KE346360.1|	1679589	1679619	AACTGC	30	+	5	ACTGCA
gi|514486632|gb|KE346360.1|	1679629	1679658	AACTAC	29	+	4	CAACTA
gi|514486632|gb|KE346360.1|	1679970	1679982	AGCTGC	12	+	2	TGCAGC
gi|514486632|gb|KE346360.1|	1680025	1680043	ACG	18	+	6	GAC
gi|514486632|gb|KE346360.1|	1680962	1680975	AATCCC	13	+	2	CCAATC
gi|514486632|gb|KE346360.1|	1680970	1680987	AATCCG	17	+	2	AATCCG
gi|514486632|gb|KE346360.1|	1680992	1681031	A	39	+	39	A
gi|514486632|gb|KE346360.1|	1681125	1681142	A	17	+	17	A
gi|514486632|gb|KE346360.1|	1681454	1681466	AAC	12	-	4	TGT
gi|514486632|gb|KE346360.1|	1681683	1681702	ACGCG	19	-	3	CGTCG
gi|514486632|gb|KE346360.1|	1681914	1681927	AAG	13	+	4	AAG
gi|514486632|gb|KE346360.1|	1682182	1682196	AACCC	14	+	2	CAACC
gi|514486632|gb|KE346360.1|	1682340	1682355	ACCAGC	15	+	2	GCACCA
gi|514486632|gb|KE346360.1|	1683241	1683253	AGCC	12	-	3	CTGG
gi|514486632|gb|KE346360.1|	1683520	1683533	AAGCTC	13	+	2	CAAGCT
gi|514486632|gb|KE346360.1|	1683970	1683982	AAAAAC	12	-	2	TTTTTG
gi|514486632|gb|KE346360.1|	1684253	1684265	ACCGGC	12	+	2	ACCGGC
gi|514486632|gb|KE346360.1|	1684858	1684870	AACCCC	12	+	2	AACCCC
gi|514486632|gb|KE346360.1|	1686037	1686049	ACT	12	-	4	AGT
gi|514486632|gb|KE346360.1|	1686560	1686587	A	27	-	27	T
gi|514486632|gb|KE346360.1|	1687220	1687232	A	12	+	12	A
gi|514486632|gb|KE346360.1|	1687227	1687239	AAAAAG	12	+	2	AAAAAG
gi|514486632|gb|KE346360.1|	1687474	1687489	AGCCG	15	-	3	GCTCG
gi|514486632|gb|KE346360.1|	1687535	1687547	ACAGAG	12	+	2	CAGAGA
gi|514486632|gb|KE346360.1|	1687728	1687740	AGGCGC	12	-	2	GCCTGC
gi|514486632|gb|KE346360.1|	1688081	1688093	AGGGGG	12	+	2	GGGGAG
gi|514486632|gb|KE346360.1|	1688187	1688199	AACC	12	-	3	TTGG
gi|514486632|gb|KE346360.1|	1688394	1688406	A	12	-	12	T
gi|514486632|gb|KE346360.1|	1688538	1688551	AAAGAC	13	+	2	GACAAA
gi|514486632|gb|KE346360.1|	1688559	1688571	A	12	+	12	A
gi|514486632|gb|KE346360.1|	1688758	1688778	A	20	-	20	T
gi|514486632|gb|KE346360.1|	1688782	1688794	AAAGCG	12	-	2	CGCTTT
gi|514486632|gb|KE346360.1|	1689082	1689103	AGC	21	+	7	CAG
gi|514486632|gb|KE346360.1|	1689139	1689152	AGC	13	-	4	GCT
gi|514486632|gb|KE346360.1|	1689147	1689182	ACCAGC	35	-	5	TGCTGG
gi|514486632|gb|KE346360.1|	1689193	1689208	ACGCCG	15	+	2	GACGCC
gi|514486632|gb|KE346360.1|	1689439	1689451	AACAGC	12	+	2	ACAGCA
gi|514486632|gb|KE346360.1|	1689856	1689868	ACGC	12	-	3	TGCG
gi|514486632|gb|KE346360.1|	1690622	1690637	ACG	15	+	5	CGA
gi|514486632|gb|KE346360.1|	1691305	1691318	AC	13	-	6	TG
gi|514486632|gb|KE346360.1|	1691469	1691481	AAACAC	12	+	2	ACACAA
gi|514486632|gb|KE346360.1|	1691506	1691523	AAAC	17	+	4	CAAA
gi|514486632|gb|KE346360.1|	1691539	1691560	AAC	21	+	7	ACA
gi|514486632|gb|KE346360.1|	1692861	1692873	ATATCC	12	+	2	TATCCA
gi|514486632|gb|KE346360.1|	1692986	1692998	AGCGCG	12	-	2	CGCTCG
gi|514486632|gb|KE346360.1|	1693210	1693241	AGGC	31	+	7	GCAG
gi|514486632|gb|KE346360.1|	1693270	1693283	AGG	13	+	4	AGG
gi|514486632|gb|KE346360.1|	1693306	1693318	AACC	12	+	3	CAAC
gi|514486632|gb|KE346360.1|	1693728	1693783	AG	55	-	27	CT
gi|514486632|gb|KE346360.1|	1694006	1694019	AACCCC	13	+	2	CCCCAA
gi|514486632|gb|KE346360.1|	1694052	1694064	AAAAC	12	+	2	AACAA
gi|514486632|gb|KE346360.1|	1694070	1694105	A	35	-	35	T
gi|514486632|gb|KE346360.1|	1694290	1694307	A	17	-	17	T
gi|514486632|gb|KE346360.1|	1694605	1694617	AC	12	-	6	GT
gi|514486632|gb|KE346360.1|	1694667	1694683	AAAAAT	16	+	2	AAAATA
gi|514486632|gb|KE346360.1|	1695214	1695227	ATCGC	13	+	2	TCGCA
gi|514486632|gb|KE346360.1|	1695977	1696003	ACC	26	+	8	CCA
gi|514486632|gb|KE346360.1|	1696017	1696031	AGC	14	+	4	CAG
gi|514486632|gb|KE346360.1|	1696599	1696612	AAAC	13	+	3	AACA
gi|514486632|gb|KE346360.1|	1698774	1698786	AGC	12	+	4	GCA
gi|514486632|gb|KE346360.1|	1699530	1699542	ACCCG	12	-	2	GGGTC
gi|514486632|gb|KE346360.1|	1700770	1700782	AAATC	12	+	2	AATCA
gi|514486632|gb|KE346360.1|	1702076	1702088	AGCCC	12	-	2	GGGCT
gi|514486632|gb|KE346360.1|	1702448	1702460	AGGCGG	12	+	2	GAGGCG
gi|514486632|gb|KE346360.1|	1702962	1702985	ACCAGC	23	-	3	TGCTGG
gi|514486632|gb|KE346360.1|	1704047	1704064	AGCGGC	17	+	2	GCGGCA
gi|514486632|gb|KE346360.1|	1704977	1704989	AGC	12	+	4	GCA
gi|514486632|gb|KE346360.1|	1704990	1705011	AGC	21	+	7	CAG
gi|514486632|gb|KE346360.1|	1705190	1705202	AAG	12	+	4	AAG
gi|514486632|gb|KE346360.1|	1705234	1705252	AG	18	+	9	AG
gi|514486632|gb|KE346360.1|	1705479	1705492	AAAAC	13	-	2	TTTTG
gi|514486632|gb|KE346360.1|	1705582	1705595	AGC	13	+	4	CAG
gi|514486632|gb|KE346360.1|	1705665	1705682	ACGCCG	17	+	2	CCGACG
gi|514486632|gb|KE346360.1|	1705766	1705784	CCG	18	+	6	CGC
gi|514486632|gb|KE346360.1|	1705779	1705793	AGCCGC	14	+	2	GCCGCA
gi|514486632|gb|KE346360.1|	1705788	1705802	AGC	14	+	4	GCA
gi|514486632|gb|KE346360.1|	1706271	1706291	A	20	-	20	T
gi|514486632|gb|KE346360.1|	1706288	1706303	AAAC	15	-	3	TTTG
gi|514486632|gb|KE346360.1|	1706301	1706313	AAAC	12	-	3	TTTG
gi|514486632|gb|KE346360.1|	1706470	1706485	AAAC	15	+	3	AACA
gi|514486632|gb|KE346360.1|	1707586	1707598	AACCGC	12	+	2	GCAACC
gi|514486632|gb|KE346360.1|	1707921	1707945	AGCGCC	24	+	4	GCGCCA
gi|514486632|gb|KE346360.1|	1708474	1708486	AAGAC	12	+	2	AAGAC
gi|514486632|gb|KE346360.1|	1708973	1708986	ATCGGC	13	-	2	CGATGC
gi|514486632|gb|KE346360.1|	1708983	1708995	AAGGCC	12	+	2	GCCAAG
gi|514486632|gb|KE346360.1|	1710527	1710539	ACACCG	12	-	2	GGTGTC
gi|514486632|gb|KE346360.1|	1711251	1711263	AAACTC	12	+	2	CAAACT
gi|514486632|gb|KE346360.1|	1711941	1711961	AGC	20	+	6	CAG
gi|514486632|gb|KE346360.1|	1712137	1712149	ACATGT	12	+	2	TGTACA
gi|514486632|gb|KE346360.1|	1713018	1713033	AG	15	-	7	TC
gi|514486632|gb|KE346360.1|	1713643	1713658	CCG	15	+	5	CCG
gi|514486632|gb|KE346360.1|	1715748	1715766	AAAAAC	18	+	3	CAAAAA
gi|514486632|gb|KE346360.1|	1715783	1715796	A	13	-	13	T
gi|514486632|gb|KE346360.1|	1715797	1715812	A	15	-	15	T
gi|514486632|gb|KE346360.1|	1715826	1715844	A	18	-	18	T
gi|514486632|gb|KE346360.1|	1715872	1715890	A	18	-	18	T
gi|514486632|gb|KE346360.1|	1716051	1716081	A	30	-	30	T
gi|514486632|gb|KE346360.1|	1716290	1716314	AGC	24	+	8	CAG
gi|514486632|gb|KE346360.1|	1716412	1716424	AACAGC	12	+	2	ACAGCA
gi|514486632|gb|KE346360.1|	1716419	1716434	AGC	15	+	5	CAG
gi|514486632|gb|KE346360.1|	1716591	1716610	CCG	19	-	6	CGG
gi|514486632|gb|KE346360.1|	1716605	1716620	AGCCGC	15	-	2	GCGGCT
gi|514486632|gb|KE346360.1|	1717003	1717019	ACG	16	+	5	CGA
gi|514486632|gb|KE346360.1|	1717215	1717231	AGC	16	+	5	CAG
gi|514486632|gb|KE346360.1|	1717236	1717253	AGC	17	+	5	CAG
gi|514486632|gb|KE346360.1|	1718683	1718695	ACCTCG	12	+	2	CGACCT
gi|514486632|gb|KE346360.1|	1719358	1719385	AAAAAC	27	-	4	TTTTTG
gi|514486632|gb|KE346360.1|	1719386	1719405	AAAAAC	19	-	3	TGTTTT
gi|514486632|gb|KE346360.1|	1720261	1720275	AAG	14	+	4	GAA
gi|514486632|gb|KE346360.1|	1721084	1721098	ACC	14	+	4	CCA
gi|514486632|gb|KE346360.1|	1721251	1721265	AAC	14	-	4	TTG
gi|514486632|gb|KE346360.1|	1721294	1721307	ACGCTG	13	+	2	GACGCT
gi|514486632|gb|KE346360.1|	1721455	1721468	AAAAAC	13	-	2	TTTTTG
gi|514486632|gb|KE346360.1|	1721697	1721709	A	12	+	12	A
gi|514486632|gb|KE346360.1|	1721712	1721731	A	19	-	19	T
gi|514486632|gb|KE346360.1|	1721871	1721883	AACGAG	12	+	2	GAGAAC
gi|514486632|gb|KE346360.1|	1721897	1721916	A	19	-	19	T
gi|514486632|gb|KE346360.1|	1722166	1722184	A	18	-	18	T
gi|514486632|gb|KE346360.1|	1722327	1722343	AAAAAG	16	-	2	TTTTCT
gi|514486632|gb|KE346360.1|	1722382	1722403	A	21	-	21	T
gi|514486632|gb|KE346360.1|	1722711	1722723	AGGGC	12	-	2	CTGCC
gi|514486632|gb|KE346360.1|	1723940	1723952	AGGGGG	12	+	2	GGGGAG
gi|514486632|gb|KE346360.1|	1723949	1723963	AG	14	+	7	GA
gi|514486632|gb|KE346360.1|	1724454	1724474	A	20	-	20	T
gi|514486632|gb|KE346360.1|	1726510	1726524	AAGCCC	14	+	2	CCCAAG
gi|514486632|gb|KE346360.1|	1726600	1726616	A	16	+	16	A
gi|514486632|gb|KE346360.1|	1726645	1726661	AAAAAT	16	+	2	AAAAAT
gi|514486632|gb|KE346360.1|	1726831	1726843	A	12	-	12	T
gi|514486632|gb|KE346360.1|	1727300	1727329	A	29	-	29	T
gi|514486632|gb|KE346360.1|	1727385	1727405	A	20	-	20	T
gi|514486632|gb|KE346360.1|	1727461	1727474	AAG	13	-	4	CTT
gi|514486632|gb|KE346360.1|	1727490	1727503	AG	13	-	6	CT
gi|514486632|gb|KE346360.1|	1727905	1727921	CCG	16	+	5	CCG
gi|514486632|gb|KE346360.1|	1727973	1727986	AGCCTC	13	-	2	GAGGCT
gi|514486632|gb|KE346360.1|	1728401	1728414	AGC	13	+	4	CAG
gi|514486632|gb|KE346360.1|	1728683	1728697	AAACAG	14	-	2	TTTCTG
gi|514486632|gb|KE346360.1|	1729124	1729141	AACGGC	17	+	2	GCAACG
gi|514486632|gb|KE346360.1|	1729454	1729474	AGC	20	+	6	CAG
gi|514486632|gb|KE346360.1|	1729469	1729482	AACAGC	13	+	2	CAGCAA
gi|514486632|gb|KE346360.1|	1729916	1729931	AGC	15	-	5	TGC
gi|514486632|gb|KE346360.1|	1730153	1730169	AACTCC	16	+	2	CAACTC
gi|514486632|gb|KE346360.1|	1730300	1730314	AACAGC	14	+	2	CAACAG
gi|514486632|gb|KE346360.1|	1730446	1730461	AACAGC	15	+	2	ACAGCA
gi|514486632|gb|KE346360.1|	1731405	1731425	AC	20	-	10	TG
gi|514486632|gb|KE346360.1|	1731522	1731534	CCCCCG	12	-	2	GCGGGG
gi|514486632|gb|KE346360.1|	1731532	1731547	AGG	15	+	5	GGA
gi|514486632|gb|KE346360.1|	1731830	1731842	AAAGCC	12	+	2	GCCAAA
gi|514486632|gb|KE346360.1|	1732625	1732637	A	12	+	12	A
gi|514486632|gb|KE346360.1|	1735088	1735102	ACTGCG	14	+	2	TGCGAC
gi|514486632|gb|KE346360.1|	1735150	1735163	AAAAAC	13	+	2	ACAAAA
gi|514486632|gb|KE346360.1|	1735471	1735483	AAAAAC	12	-	2	TTTTTG
gi|514486632|gb|KE346360.1|	1735644	1735674	A	30	+	30	A
gi|514486632|gb|KE346360.1|	1735969	1735986	AGCATC	17	-	2	TGATGC
gi|514486632|gb|KE346360.1|	1735981	1736017	ATC	36	-	12	TGA
gi|514486632|gb|KE346360.1|	1736056	1736071	A	15	+	15	A
gi|514486632|gb|KE346360.1|	1736104	1736120	AC	16	+	8	CA
gi|514486632|gb|KE346360.1|	1736213	1736226	AGC	13	-	4	CTG
gi|514486632|gb|KE346360.1|	1736269	1736292	A	23	-	23	T
gi|514486632|gb|KE346360.1|	1736288	1736310	AAAAG	22	-	4	TTTTC
gi|514486632|gb|KE346360.1|	1736993	1737006	AAAAC	13	+	2	AAACA
gi|514486632|gb|KE346360.1|	1737002	1737018	A	16	+	16	A
gi|514486632|gb|KE346360.1|	1737319	1737332	AATGCG	13	-	2	GCATTC
gi|514486632|gb|KE346360.1|	1738167	1738181	AAG	14	+	4	AAG
gi|514486632|gb|KE346360.1|	1739221	1739233	AGCGCC	12	+	2	AGCGCC
gi|514486632|gb|KE346360.1|	1739964	1739983	A	19	+	19	A
gi|514486632|gb|KE346360.1|	1740890	1740903	AGGATG	13	-	2	CCTCAT
gi|514486632|gb|KE346360.1|	1740898	1740915	ATC	17	+	5	TCA
gi|514486632|gb|KE346360.1|	1740950	1740964	AAC	14	+	4	CAA
gi|514486632|gb|KE346360.1|	1740962	1740988	AGC	26	+	8	CAG
gi|514486632|gb|KE346360.1|	1741542	1741554	ACC	12	-	4	TGG
gi|514486632|gb|KE346360.1|	1741927	1741944	ACC	17	+	5	CAC
gi|514486632|gb|KE346360.1|	1743612	1743626	AGC	14	+	4	CAG
gi|514486632|gb|KE346360.1|	1744556	1744603	AAC	47	+	15	CAA
gi|514486632|gb|KE346360.1|	1744601	1744615	AGC	14	+	4	CAG
gi|514486632|gb|KE346360.1|	1744931	1744949	A	18	-	18	T
gi|514486632|gb|KE346360.1|	1745368	1745381	AAAAAC	13	+	2	AACAAA
gi|514486632|gb|KE346360.1|	1746456	1746468	ACGAGC	12	+	2	GAGCAC
gi|514486632|gb|KE346360.1|	1746859	1746871	ATCGGC	12	+	2	CGGCAT
gi|514486632|gb|KE346360.1|	1748957	1748975	CCG	18	-	6	CGG
gi|514486632|gb|KE346360.1|	1749414	1749426	CCG	12	+	4	CGC
gi|514486632|gb|KE346360.1|	1749804	1749856	ACC	52	-	17	GGT
gi|514486632|gb|KE346360.1|	1750460	1750473	ACTGCC	13	+	2	CACTGC
gi|514486632|gb|KE346360.1|	1750468	1750481	AGCGGC	13	-	2	CTGCCG
gi|514486632|gb|KE346360.1|	1752345	1752360	AACAGC	15	-	2	TTGCTG
gi|514486632|gb|KE346360.1|	1752355	1752387	AAC	32	-	10	TGT
gi|514486632|gb|KE346360.1|	1752394	1752414	AGC	20	-	6	TGC
gi|514486632|gb|KE346360.1|	1753312	1753331	AAC	19	+	6	ACA
gi|514486632|gb|KE346360.1|	1753348	1753361	AAAC	13	+	3	ACAA
gi|514486632|gb|KE346360.1|	1753457	1753489	A	32	-	32	T
gi|514486632|gb|KE346360.1|	1753664	1753676	AGCCGC	12	-	2	GCTGCG
gi|514486632|gb|KE346360.1|	1753696	1753710	ACCAGC	14	-	2	TGGTGC
gi|514486632|gb|KE346360.1|	1753810	1753824	AGCAGG	14	+	2	AGGAGC
gi|514486632|gb|KE346360.1|	1754145	1754158	ACTGC	13	+	2	CACTG
gi|514486632|gb|KE346360.1|	1755958	1755970	AAAGC	12	+	2	AAGCA
gi|514486632|gb|KE346360.1|	1756025	1756042	AGCATC	17	+	2	CATCAG
gi|514486632|gb|KE346360.1|	1757314	1757328	AGCCGG	14	-	2	CGGCTC
gi|514486632|gb|KE346360.1|	1757611	1757626	AGCCGC	15	+	2	CCGCAG
gi|514486632|gb|KE346360.1|	1758559	1758572	ACGGCG	13	+	2	CGGCGA
gi|514486632|gb|KE346360.1|	1758978	1758991	ACTCGG	13	-	2	GAGTCC
gi|514486632|gb|KE346360.1|	1762651	1762663	AATGAG	12	+	2	TGAGAA
gi|514486632|gb|KE346360.1|	1762938	1762950	AGGGGG	12	+	2	AGGGGG
gi|514486632|gb|KE346360.1|	1763153	1763168	A	15	+	15	A
gi|514486632|gb|KE346360.1|	1763180	1763193	A	13	+	13	A
gi|514486632|gb|KE346360.1|	1764304	1764362	A	58	-	58	T
gi|514486632|gb|KE346360.1|	1765167	1765179	AAAC	12	-	3	TGTT
gi|514486632|gb|KE346360.1|	1767991	1768003	AATGTG	12	+	2	TGTGAA
gi|514486632|gb|KE346360.1|	1768244	1768258	AAAAAG	14	+	2	AAAAGA
gi|514486632|gb|KE346360.1|	1769757	1769769	AAC	12	-	4	TTG
gi|514486632|gb|KE346360.1|	1771274	1771287	ACTGCG	13	-	2	GCAGTC
gi|514486632|gb|KE346360.1|	1772890	1772903	ACTCGC	13	+	2	GCACTC
gi|514486632|gb|KE346360.1|	1773367	1773380	AGCTCC	13	-	2	AGCTGG
gi|514486632|gb|KE346360.1|	1773457	1773469	AATCCG	12	-	2	TCGGAT
gi|514486632|gb|KE346360.1|	1776706	1776721	AAAC	15	-	3	TTTG
gi|514486632|gb|KE346360.1|	1776765	1776787	AAAC	22	-	5	TTTG
gi|514486632|gb|KE346360.1|	1777204	1777227	AAAC	23	+	5	AAAC
gi|514486632|gb|KE346360.1|	1778837	1778851	AAGAGC	14	+	2	CAAGAG
gi|514486632|gb|KE346360.1|	1778900	1778912	AATGAC	12	+	2	GACAAT
gi|514486632|gb|KE346360.1|	1779095	1779107	AGAGGG	12	+	2	GAGGGA
gi|514486632|gb|KE346360.1|	1780952	1780964	ACGCCG	12	-	2	GTCGGC
gi|514486632|gb|KE346360.1|	1781749	1781761	AACGGC	12	+	2	CGGCAA
gi|514486632|gb|KE346360.1|	1782021	1782033	AACGAC	12	-	2	TTGTCG
gi|514486632|gb|KE346360.1|	1782424	1782438	AAAAC	14	+	2	ACAAA
gi|514486632|gb|KE346360.1|	1782512	1782553	ACC	41	+	13	CCA
gi|514486632|gb|KE346360.1|	1783094	1783126	AAG	32	+	10	AAG
gi|514486632|gb|KE346360.1|	1783153	1783165	A	12	+	12	A
gi|514486632|gb|KE346360.1|	1783207	1783223	A	16	+	16	A
gi|514486632|gb|KE346360.1|	1783417	1783432	AG	15	+	7	GA
gi|514486632|gb|KE346360.1|	1783650	1783662	ACC	12	-	4	TGG
gi|514486632|gb|KE346360.1|	1784162	1784174	AAACCG	12	+	2	ACCGAA
gi|514486632|gb|KE346360.1|	1784727	1784739	A	12	-	12	T
gi|514486632|gb|KE346360.1|	1785173	1785187	AGC	14	-	4	CTG
gi|514486632|gb|KE346360.1|	1785661	1785676	A	15	-	15	T
gi|514486632|gb|KE346360.1|	1785675	1785776	AC	101	-	50	TG
gi|514486632|gb|KE346360.1|	1785773	1785786	AAAC	13	-	3	TGTT
gi|514486632|gb|KE346360.1|	1786445	1786460	A	15	-	15	T
gi|514486632|gb|KE346360.1|	1786466	1786479	ACCC	13	-	3	GGGT
gi|514486632|gb|KE346360.1|	1787698	1787710	AGAGG	12	+	2	GAGGA
gi|514486632|gb|KE346360.1|	1788074	1788087	ACGACT	13	-	2	GTAGTC
gi|514486632|gb|KE346360.1|	1788428	1788441	A	13	-	13	T
gi|514486632|gb|KE346360.1|	1788439	1788490	AAC	51	-	17	TTG
gi|514486632|gb|KE346360.1|	1789065	1789085	ACT	20	-	6	GTA
gi|514486632|gb|KE346360.1|	1789303	1789317	AAAAC	14	+	2	AAAAC
gi|514486632|gb|KE346360.1|	1789782	1789805	AG	23	-	11	CT
gi|514486632|gb|KE346360.1|	1789887	1789899	AAAAC	12	-	2	TTTGT
gi|514486632|gb|KE346360.1|	1790251	1790265	AAAAC	14	+	2	AAACA
gi|514486632|gb|KE346360.1|	1791074	1791103	ACC	29	-	9	GTG
gi|514486632|gb|KE346360.1|	1791302	1791327	AGC	25	-	8	TGC
gi|514486632|gb|KE346360.1|	1791433	1791447	ACAGT	14	+	2	GTACA
gi|514486632|gb|KE346360.1|	1791692	1791710	AACG	18	+	4	GAAC
gi|514486632|gb|KE346360.1|	1791711	1791730	AACG	19	+	4	CGAA
gi|514486632|gb|KE346360.1|	1791863	1791875	AACTGC	12	+	2	AACTGC
gi|514486632|gb|KE346360.1|	1793952	1793964	ACACGG	12	-	2	CGTGTC
gi|514486632|gb|KE346360.1|	1794799	1794824	A	25	-	25	T
gi|514486632|gb|KE346360.1|	1794940	1794954	A	14	-	14	T
gi|514486632|gb|KE346360.1|	1795541	1795567	AAT	26	-	8	TTA
gi|514486632|gb|KE346360.1|	1795622	1795635	AAACCC	13	+	2	CCAAAC
gi|514486632|gb|KE346360.1|	1796215	1796236	AAC	21	-	7	GTT
gi|514486632|gb|KE346360.1|	1798112	1798144	AGC	32	+	10	CAG
gi|514486632|gb|KE346360.1|	1798139	1798153	ACCAGC	14	+	2	CAGCAC
gi|514486632|gb|KE346360.1|	1798994	1799006	ATC	12	+	4	CAT
gi|514486632|gb|KE346360.1|	1799555	1799567	ACACGC	12	+	2	CACACG
gi|514486632|gb|KE346360.1|	1799936	1799948	AAAAC	12	+	2	AACAA
gi|514486632|gb|KE346360.1|	1799969	1800000	AGC	31	-	10	TGC
gi|514486632|gb|KE346360.1|	1800440	1800465	A	25	+	25	A
gi|514486632|gb|KE346360.1|	1800467	1800479	A	12	+	12	A
gi|514486632|gb|KE346360.1|	1800634	1800653	A	19	+	19	A
gi|514486632|gb|KE346360.1|	1800705	1800720	A	15	+	15	A
gi|514486632|gb|KE346360.1|	1801087	1801100	A	13	-	13	T
gi|514486632|gb|KE346360.1|	1801253	1801282	A	29	-	29	T
gi|514486632|gb|KE346360.1|	1801868	1801880	AAG	12	-	4	TCT
gi|514486632|gb|KE346360.1|	1801968	1801980	A	12	-	12	T
gi|514486632|gb|KE346360.1|	1802196	1802209	AG	13	-	6	CT
gi|514486632|gb|KE346360.1|	1802551	1802565	AAAAAT	14	-	2	TTTTTA
gi|514486632|gb|KE346360.1|	1802728	1802755	A	27	+	27	A
gi|514486632|gb|KE346360.1|	1802956	1802991	A	35	-	35	T
gi|514486632|gb|KE346360.1|	1803275	1803287	ACGCCG	12	-	2	TCGGCG
gi|514486632|gb|KE346360.1|	1804189	1804211	AC	22	-	11	TG
gi|514486632|gb|KE346360.1|	1804595	1804627	A	32	-	32	T
gi|514486632|gb|KE346360.1|	1804623	1804638	AAAAC	15	-	3	TTTTG
gi|514486632|gb|KE346360.1|	1804937	1804957	AGG	20	+	6	GAG
gi|514486632|gb|KE346360.1|	1805135	1805149	A	14	-	14	T
gi|514486632|gb|KE346360.1|	1806179	1806192	AAGCCG	13	-	2	TCGGCT
gi|514486632|gb|KE346360.1|	1806818	1806835	A	17	+	17	A
gi|514486632|gb|KE346360.1|	1806962	1806974	A	12	+	12	A
gi|514486632|gb|KE346360.1|	1807520	1807552	AGC	32	-	10	GCT
gi|514486632|gb|KE346360.1|	1808192	1808204	AGGCGG	12	-	2	CGCCTC
gi|514486632|gb|KE346360.1|	1808327	1808340	AACGC	13	+	2	ACGCA
gi|514486632|gb|KE346360.1|	1808994	1809006	AAC	12	+	4	AAC
gi|514486632|gb|KE346360.1|	1809014	1809027	AAAAAC	13	-	2	TTTTTG
gi|514486632|gb|KE346360.1|	1809271	1809283	AGC	12	+	4	AGC
gi|514486632|gb|KE346360.1|	1809547	1809568	AGG	21	+	7	GAG
gi|514486632|gb|KE346360.1|	1810911	1810924	AAAAAC	13	-	2	TGTTTT
gi|514486632|gb|KE346360.1|	1811952	1811968	AAGGGG	16	-	2	CCCCTT
gi|514486632|gb|KE346360.1|	1811974	1811986	AG	12	+	6	GA
gi|514486632|gb|KE346360.1|	1812647	1812659	AACTGG	12	-	2	TCCAGT
gi|514486632|gb|KE346360.1|	1813699	1813711	AAC	12	-	4	TTG
gi|514486632|gb|KE346360.1|	1814150	1814162	AATGGC	12	-	2	CATTGC
gi|514486632|gb|KE346360.1|	1815015	1815027	AAAGC	12	-	2	TGCTT
gi|514486632|gb|KE346360.1|	1816141	1816158	A	17	-	17	T
gi|514486632|gb|KE346360.1|	1816176	1816193	AAAACG	17	-	2	TCGTTT
gi|514486632|gb|KE346360.1|	1816536	1816553	AAAAAT	17	-	2	TTTTTA
gi|514486632|gb|KE346360.1|	1816742	1816772	AG	30	-	15	TC
gi|514486632|gb|KE346360.1|	1816844	1816856	ACGAGC	12	+	2	ACGAGC
gi|514486632|gb|KE346360.1|	1816866	1816885	AGAGGG	19	-	3	CCTCTC
gi|514486632|gb|KE346360.1|	1816917	1816945	A	28	-	28	T
gi|514486632|gb|KE346360.1|	1816954	1816967	ACTC	13	+	3	CACT
gi|514486632|gb|KE346360.1|	1816964	1816977	AGAGGG	13	-	2	CTCTCC
gi|514486632|gb|KE346360.1|	1817611	1817623	A	12	-	12	T
gi|514486632|gb|KE346360.1|	1817621	1817644	AAC	23	-	7	TTG
gi|514486632|gb|KE346360.1|	1818354	1818366	AAC	12	-	4	TTG
gi|514486632|gb|KE346360.1|	1818702	1818716	ACGAGC	14	+	2	GCACGA
gi|514486632|gb|KE346360.1|	1819466	1819479	ACGTGC	13	+	2	GTGCAC
gi|514486632|gb|KE346360.1|	1819733	1819745	AACGAC	12	-	2	GTTGTC
gi|514486632|gb|KE346360.1|	1819749	1819761	A	12	-	12	T
gi|514486632|gb|KE346360.1|	1819765	1819777	AACGAC	12	-	2	GTTGTC
gi|514486632|gb|KE346360.1|	1819848	1819860	AAAC	12	-	3	TTGT
gi|514486632|gb|KE346360.1|	1820243	1820256	ACCCAG	13	-	2	GGGTCT
gi|514486632|gb|KE346360.1|	1821722	1821736	AACTAC	14	-	2	GTTGTA
gi|514486632|gb|KE346360.1|	1822118	1822132	ACGCCG	14	+	2	GCCGAC
gi|514486632|gb|KE346360.1|	1822280	1822297	AGC	17	+	5	GCA
gi|514486632|gb|KE346360.1|	1822408	1822420	AGCCG	12	+	2	CGAGC
gi|514486632|gb|KE346360.1|	1822429	1822441	AGC	12	-	4	CTG
gi|514486632|gb|KE346360.1|	1822622	1822654	AGC	32	-	10	TGC
gi|514486632|gb|KE346360.1|	1825472	1825484	ACTCTC	12	-	2	GAGAGT
gi|514486632|gb|KE346360.1|	1825840	1825854	AGC	14	+	4	GCA
gi|514486632|gb|KE346360.1|	1827171	1827193	A	22	-	22	T
gi|514486632|gb|KE346360.1|	1827351	1827365	A	14	-	14	T
gi|514486632|gb|KE346360.1|	1827586	1827601	AAAAAT	15	-	2	TTTTTA
gi|514486632|gb|KE346360.1|	1827984	1827998	AACTG	14	+	2	CTGAA
gi|514486632|gb|KE346360.1|	1828009	1828021	AAACCG	12	-	2	GTTTCG
gi|514486632|gb|KE346360.1|	1828144	1828156	AAG	12	+	4	AAG
gi|514486632|gb|KE346360.1|	1828151	1828164	AAGCAG	13	+	2	AGAAGC
gi|514486632|gb|KE346360.1|	1828947	1828961	ACG	14	+	4	CGA
gi|514486632|gb|KE346360.1|	1829392	1829406	AAAC	14	+	3	ACAA
gi|514486632|gb|KE346360.1|	1829406	1829423	AAAC	17	+	4	CAAA
gi|514486632|gb|KE346360.1|	1829423	1829439	AAAC	16	+	4	CAAA
gi|514486632|gb|KE346360.1|	1831237	1831250	AACGGC	13	+	2	GCAACG
gi|514486632|gb|KE346360.1|	1831437	1831452	AGCTGC	15	+	2	AGCTGC
gi|514486632|gb|KE346360.1|	1831683	1831697	ACCGAG	14	-	2	CTCGGT
gi|514486632|gb|KE346360.1|	1831847	1831864	AGCATC	17	+	2	CAGCAT
gi|514486632|gb|KE346360.1|	1831924	1831936	AAGGAG	12	-	2	TCTCCT
gi|514486632|gb|KE346360.1|	1832337	1832349	AATGCG	12	-	2	CGCATT
gi|514486632|gb|KE346360.1|	1832406	1832418	AAACAG	12	+	2	AACAGA
gi|514486632|gb|KE346360.1|	1833111	1833125	AGCGCG	14	+	2	GCGCGA
gi|514486632|gb|KE346360.1|	1833475	1833488	AAAAAG	13	-	2	TTCTTT
gi|514486632|gb|KE346360.1|	1834185	1834197	ACCAG	12	-	2	GGTCT
gi|514486632|gb|KE346360.1|	1834564	1834576	AATTAC	12	+	2	TTACAA
gi|514486632|gb|KE346360.1|	1834706	1834720	AACAGC	14	+	2	CAACAG
gi|514486632|gb|KE346360.1|	1835530	1835554	A	24	-	24	T
gi|514486632|gb|KE346360.1|	1835551	1835570	AAAC	19	-	4	TTTG
gi|514486632|gb|KE346360.1|	1835579	1835591	AAAACC	12	-	2	TTTGGT
gi|514486632|gb|KE346360.1|	1837426	1837438	CCCGG	12	+	2	CGGCC
gi|514486632|gb|KE346360.1|	1837829	1837844	AGC	15	+	5	AGC
gi|514486632|gb|KE346360.1|	1837842	1837854	CCG	12	-	4	GCG
gi|514486632|gb|KE346360.1|	1838619	1838632	AAAGC	13	+	2	AAAGC
gi|514486632|gb|KE346360.1|	1838824	1838844	A	20	-	20	T
gi|514486632|gb|KE346360.1|	1838855	1838868	AACCAC	13	-	2	GTGGTT
gi|514486632|gb|KE346360.1|	1839162	1839183	A	21	+	21	A
gi|514486632|gb|KE346360.1|	1839364	1839384	A	20	-	20	T
gi|514486632|gb|KE346360.1|	1839529	1839541	AAAGC	12	+	2	AGCAA
gi|514486632|gb|KE346360.1|	1839741	1839768	A	27	-	27	T
gi|514486632|gb|KE346360.1|	1839769	1839785	AAAACC	16	-	2	GGTTTT
gi|514486632|gb|KE346360.1|	1841779	1841791	AAGCCG	12	-	2	CGGCTT
gi|514486632|gb|KE346360.1|	1843840	1843852	AAGAGG	12	-	2	TCCTCT
gi|514486632|gb|KE346360.1|	1845644	1845656	AGAGCG	12	-	2	CTCGCT
gi|514486632|gb|KE346360.1|	1845820	1845832	A	12	-	12	T
gi|514486632|gb|KE346360.1|	1845991	1846004	A	13	+	13	A
gi|514486632|gb|KE346360.1|	1846011	1846024	AAC	13	+	4	CAA
gi|514486632|gb|KE346360.1|	1846052	1846074	AAC	22	-	7	GTT
gi|514486632|gb|KE346360.1|	1846129	1846142	CCCCCG	13	-	2	GGGGGC
gi|514486632|gb|KE346360.1|	1846507	1846519	AAATTG	12	+	2	GAAATT
gi|514486632|gb|KE346360.1|	1847130	1847145	A	15	-	15	T
gi|514486632|gb|KE346360.1|	1847146	1847166	A	20	-	20	T
gi|514486632|gb|KE346360.1|	1847739	1847751	ACGGCG	12	-	2	TCGCCG
gi|514486632|gb|KE346360.1|	1848302	1848314	CCCG	12	+	3	GCCC
gi|514486632|gb|KE346360.1|	1849030	1849050	AAAC	20	-	5	TTTG
gi|514486632|gb|KE346360.1|	1849433	1849446	AAAAAC	13	-	2	TGTTTT
gi|514486632|gb|KE346360.1|	1850767	1850779	ACCTGC	12	+	2	GCACCT
gi|514486632|gb|KE346360.1|	1851999	1852022	ACTGCC	23	-	3	GTGGCA
gi|514486632|gb|KE346360.1|	1852061	1852075	ACCACG	14	-	2	GGTCGT
gi|514486632|gb|KE346360.1|	1852117	1852129	AATGGC	12	-	2	CATTGC
gi|514486632|gb|KE346360.1|	1852129	1852146	ACTAGT	17	+	2	TACTAG
gi|514486632|gb|KE346360.1|	1852230	1852242	AGC	12	-	4	TGC
gi|514486632|gb|KE346360.1|	1852262	1852284	AAC	22	-	7	TTG
gi|514486632|gb|KE346360.1|	1852839	1852859	AAG	20	-	6	CTT
gi|514486632|gb|KE346360.1|	1852860	1852872	AAGGAC	12	-	2	CTTGTC
gi|514486632|gb|KE346360.1|	1852924	1852936	AAAAAC	12	-	2	TGTTTT
gi|514486632|gb|KE346360.1|	1853027	1853040	A	13	-	13	T
gi|514486632|gb|KE346360.1|	1853037	1853054	AAAC	17	-	4	TTTG
gi|514486632|gb|KE346360.1|	1853055	1853067	AAAC	12	-	3	TGTT
gi|514486632|gb|KE346360.1|	1854132	1854145	ACCCCC	13	-	2	GTGGGG
gi|514486632|gb|KE346360.1|	1854567	1854579	AATGCG	12	-	2	GCATTC
gi|514486632|gb|KE346360.1|	1855006	1855026	AC	20	-	10	GT
gi|514486632|gb|KE346360.1|	1855131	1855143	AAAAC	12	+	2	AAACA
gi|514486632|gb|KE346360.1|	1855499	1855511	AGCGGC	12	-	2	GCCGCT
gi|514486632|gb|KE346360.1|	1856047	1856060	AGC	13	-	4	CTG
gi|514486632|gb|KE346360.1|	1857083	1857095	AAGCAG	12	+	2	AGAAGC
gi|514486632|gb|KE346360.1|	1857330	1857342	AGCATG	12	+	2	AGCATG
gi|514486632|gb|KE346360.1|	1857670	1857684	AGC	14	-	4	TGC
gi|514486632|gb|KE346360.1|	1858827	1858840	AGC	13	-	4	TGC
gi|514486632|gb|KE346360.1|	1859148	1859167	CCG	19	-	6	GCG
gi|514486632|gb|KE346360.1|	1860702	1860714	AGG	12	-	4	TCC
gi|514486632|gb|KE346360.1|	1861164	1861176	AGGCCG	12	+	2	GGCCGA
gi|514486632|gb|KE346360.1|	1862180	1862192	AAAC	12	+	3	CAAA
gi|514486632|gb|KE346360.1|	1862694	1862706	AAAAC	12	+	2	CAAAA
gi|514486632|gb|KE346360.1|	1863145	1863163	AAACC	18	+	3	ACCAA
gi|514486632|gb|KE346360.1|	1863193	1863206	AATAGC	13	+	2	GCAATA
gi|514486632|gb|KE346360.1|	1863497	1863514	ACG	17	+	5	GAC
gi|514486632|gb|KE346360.1|	1863624	1863644	A	20	+	20	A
gi|514486632|gb|KE346360.1|	1864239	1864255	AACAC	16	+	3	ACAAC
gi|514486632|gb|KE346360.1|	1864339	1864352	AAAGG	13	+	2	GAAAG
gi|514486632|gb|KE346360.1|	1864367	1864390	AAAG	23	-	5	TTTC
gi|514486632|gb|KE346360.1|	1864556	1864585	A	29	+	29	A
gi|514486632|gb|KE346360.1|	1864742	1864766	AAG	24	+	8	GAA
gi|514486632|gb|KE346360.1|	1864884	1864897	CCCCGG	13	-	2	GCCGGG
gi|514486632|gb|KE346360.1|	1864962	1864981	AG	19	-	9	CT
gi|514486632|gb|KE346360.1|	1865029	1865042	AAAAGC	13	-	2	CTTTTG
gi|514486632|gb|KE346360.1|	1866105	1866117	AACGCC	12	+	2	CGCCAA
gi|514486632|gb|KE346360.1|	1866551	1866571	AC	20	-	10	GT
gi|514486632|gb|KE346360.1|	1866676	1866691	A	15	-	15	T
gi|514486632|gb|KE346360.1|	1866714	1866731	AAG	17	-	5	TTC
gi|514486632|gb|KE346360.1|	1866839	1866852	AAAAC	13	+	2	AACAA
gi|514486632|gb|KE346360.1|	1867937	1867956	AGC	19	-	6	CTG
gi|514486632|gb|KE346360.1|	1868152	1868173	AAAC	21	-	5	TTGT
gi|514486632|gb|KE346360.1|	1868473	1868497	A	24	+	24	A
gi|514486632|gb|KE346360.1|	1868525	1868540	A	15	+	15	A
gi|514486632|gb|KE346360.1|	1868946	1868960	AAAAAG	14	-	2	TTCTTT
gi|514486632|gb|KE346360.1|	1869218	1869248	AAC	30	+	10	CAA
gi|514486632|gb|KE346360.1|	1870328	1870340	AGG	12	+	4	GAG
gi|514486632|gb|KE346360.1|	1870483	1870497	AAAG	14	-	3	TTTC
gi|514486632|gb|KE346360.1|	1871895	1871909	AGCGGC	14	+	2	GCAGCG
gi|514486632|gb|KE346360.1|	1872541	1872553	AGGATG	12	+	2	GAGGAT
gi|514486632|gb|KE346360.1|	1872659	1872671	AACTTC	12	-	2	AGTTGA
gi|514486632|gb|KE346360.1|	1873723	1873735	ACGTCC	12	+	2	GTCCAC
gi|514486632|gb|KE346360.1|	1873853	1873867	A	14	+	14	A
gi|514486632|gb|KE346360.1|	1873902	1873922	ACCCCG	20	+	3	GACCCC
gi|514486632|gb|KE346360.1|	1874685	1874702	ACTGCT	17	-	2	AGCAGT
gi|514486632|gb|KE346360.1|	1874908	1874933	A	25	+	25	A
gi|514486632|gb|KE346360.1|	1874972	1874989	A	17	-	17	T
gi|514486632|gb|KE346360.1|	1875374	1875386	ATCGGC	12	-	2	CGATGC
gi|514486632|gb|KE346360.1|	1875438	1875452	ATC	14	-	4	GAT
gi|514486632|gb|KE346360.1|	1875888	1875900	AGC	12	+	4	CAG
gi|514486632|gb|KE346360.1|	1876367	1876379	ACACCG	12	-	2	GTGTCG
gi|514486632|gb|KE346360.1|	1876653	1876667	A	14	+	14	A
gi|514486632|gb|KE346360.1|	1876735	1876747	AC	12	+	6	CA
gi|514486632|gb|KE346360.1|	1876919	1876936	AGG	17	-	5	CCT
gi|514486632|gb|KE346360.1|	1877277	1877289	ACTATG	12	-	2	TCATAG
gi|514486632|gb|KE346360.1|	1877571	1877583	AACCCC	12	+	2	CCCAAC
gi|514486632|gb|KE346360.1|	1877836	1877850	AAGGGC	14	+	2	CAAGGG
gi|514486632|gb|KE346360.1|	1878481	1878501	A	20	+	20	A
gi|514486632|gb|KE346360.1|	1878875	1878888	AACCCC	13	-	2	GGGTTG
gi|514486632|gb|KE346360.1|	1879334	1879346	ACT	12	+	4	TAC
gi|514486632|gb|KE346360.1|	1879422	1879451	A	29	-	29	T
gi|514486632|gb|KE346360.1|	1879552	1879564	ACACTC	12	-	2	TGTGAG
gi|514486632|gb|KE346360.1|	1880163	1880183	A	20	-	20	T
gi|514486632|gb|KE346360.1|	1880185	1880209	A	24	-	24	T
gi|514486632|gb|KE346360.1|	1880228	1880241	C	13	+	13	C
gi|514486632|gb|KE346360.1|	1880565	1880580	AGCAGG	15	+	2	AGCAGG
gi|514486632|gb|KE346360.1|	1880886	1880899	AAAAGC	13	-	2	TTGCTT
gi|514486632|gb|KE346360.1|	1881101	1881118	AAAAAC	17	-	2	TGTTTT
gi|514486632|gb|KE346360.1|	1881400	1881412	AAAAC	12	-	2	TTGTT
gi|514486632|gb|KE346360.1|	1881946	1881958	AAAACG	12	+	2	CGAAAA
gi|514486632|gb|KE346360.1|	1882027	1882044	AC	17	-	8	GT
gi|514486632|gb|KE346360.1|	1882506	1882520	AGGCGG	14	-	2	CCTCCG
gi|514486632|gb|KE346360.1|	1882515	1882531	CCG	16	+	5	CCG
gi|514486632|gb|KE346360.1|	1882537	1882550	ACGCAG	13	-	2	TGCGTC
gi|514486632|gb|KE346360.1|	1883141	1883153	AGGCCC	12	-	2	CTGGGC
gi|514486632|gb|KE346360.1|	1883907	1883921	AAAAC	14	+	2	AAAAC
gi|514486632|gb|KE346360.1|	1884476	1884502	A	26	+	26	A
gi|514486632|gb|KE346360.1|	1884568	1884587	AAC	19	-	6	TTG
gi|514486632|gb|KE346360.1|	1884588	1884602	AAC	14	-	4	GTT
gi|514486632|gb|KE346360.1|	1884611	1884626	ACTC	15	+	3	CTCA
gi|514486632|gb|KE346360.1|	1884849	1884868	AGC	19	-	6	TGC
gi|514486632|gb|KE346360.1|	1886111	1886123	AAAC	12	-	3	TGTT
gi|514486632|gb|KE346360.1|	1886377	1886390	AAAACC	13	-	2	TTGGTT
gi|514486632|gb|KE346360.1|	1886398	1886415	A	17	-	17	T
gi|514486632|gb|KE346360.1|	1886738	1886750	AAAAAC	12	-	2	GTTTTT
gi|514486632|gb|KE346360.1|	1887391	1887405	A	14	+	14	A
gi|514486632|gb|KE346360.1|	1887651	1887684	AC	33	-	16	TG
gi|514486632|gb|KE346360.1|	1888024	1888036	AACGC	12	+	2	GCAAC
gi|514486632|gb|KE346360.1|	1888059	1888095	A	36	-	36	T
gi|514486632|gb|KE346360.1|	1888275	1888287	ACG	12	+	4	CGA
gi|514486632|gb|KE346360.1|	1888348	1888362	AAAG	14	+	3	AAAG
gi|514486632|gb|KE346360.1|	1888623	1888636	AC	13	-	6	TG
gi|514486632|gb|KE346360.1|	1888671	1888685	ACGATG	14	+	2	GATGAC
gi|514486632|gb|KE346360.1|	1888881	1888895	ATC	14	-	4	TGA
gi|514486632|gb|KE346360.1|	1888955	1888968	AAAGGC	13	+	2	GGCAAA
gi|514486632|gb|KE346360.1|	1889245	1889258	AAAAC	13	-	2	TTTTG
gi|514486632|gb|KE346360.1|	1890216	1890231	AAAG	15	-	3	TTTC
gi|514486632|gb|KE346360.1|	1890240	1890263	A	23	-	23	T
gi|514486632|gb|KE346360.1|	1890636	1890649	A	13	-	13	T
gi|514486632|gb|KE346360.1|	1890858	1890872	A	14	+	14	A
gi|514486632|gb|KE346360.1|	1890884	1890897	A	13	+	13	A
gi|514486632|gb|KE346360.1|	1891119	1891134	A	15	-	15	T
gi|514486632|gb|KE346360.1|	1891778	1891831	AC	53	-	26	TG
gi|514486632|gb|KE346360.1|	1892254	1892266	AACGAC	12	+	2	CGACAA
gi|514486632|gb|KE346360.1|	1892381	1892400	AAAC	19	-	4	TTTG
gi|514486632|gb|KE346360.1|	1894388	1894407	AAC	19	-	6	GTT
gi|514486632|gb|KE346360.1|	1894496	1894510	AAGGGG	14	-	2	TTCCCC
gi|514486632|gb|KE346360.1|	1894608	1894622	AAGGGG	14	-	2	TTCCCC
gi|514486632|gb|KE346360.1|	1895401	1895413	AGGCCC	12	-	2	CCTGGG
gi|514486632|gb|KE346360.1|	1896528	1896540	ACGCG	12	-	2	CGTCG
gi|514486632|gb|KE346360.1|	1898216	1898229	ACGAGC	13	-	2	CTCGTG
gi|514486632|gb|KE346360.1|	1898343	1898357	ACG	14	+	4	GAC
gi|514486632|gb|KE346360.1|	1898860	1898872	ACACGG	12	-	2	TGTCCG
gi|514486632|gb|KE346360.1|	1898973	1898986	ACAGGC	13	+	2	GGCACA
gi|514486632|gb|KE346360.1|	1899111	1899123	AGCTCG	12	+	2	AGCTCG
gi|514486632|gb|KE346360.1|	1899195	1899208	ACGAGT	13	-	2	TCGTAC
gi|514486632|gb|KE346360.1|	1900241	1900254	ACC	13	-	4	GGT
gi|514486632|gb|KE346360.1|	1900365	1900385	AAC	20	+	6	AAC
gi|514486632|gb|KE346360.1|	1900473	1900487	ACT	14	+	4	CTA
gi|514486632|gb|KE346360.1|	1900527	1900539	AGGCG	12	+	2	GGCGA
gi|514486632|gb|KE346360.1|	1900598	1900614	A	16	-	16	T
gi|514486632|gb|KE346360.1|	1900797	1900809	AAC	12	-	4	TTG
gi|514486632|gb|KE346360.1|	1900894	1900906	AAACAC	12	-	2	GTGTTT
gi|514486632|gb|KE346360.1|	1901872	1901884	AAAGCC	12	-	2	TGGCTT
gi|514486632|gb|KE346360.1|	1901904	1901953	AGAGCC	49	-	8	GCTCTG
gi|514486632|gb|KE346360.1|	1902161	1902174	AGGGG	13	-	2	CCCCT
gi|514486632|gb|KE346360.1|	1902345	1902359	ACACGG	14	-	2	CGTGTC
gi|514486632|gb|KE346360.1|	1902663	1902676	AACAC	13	+	2	ACAAC
gi|514486632|gb|KE346360.1|	1902755	1902769	CCCG	14	-	3	GGGC
gi|514486632|gb|KE346360.1|	1902949	1902961	AAAAAG	12	+	2	AAAAGA
gi|514486632|gb|KE346360.1|	1903408	1903421	A	13	+	13	A
gi|514486632|gb|KE346360.1|	1903829	1903842	AAGATG	13	-	2	TCATCT
gi|514486632|gb|KE346360.1|	1904458	1904470	ACACG	12	+	2	CGACA
gi|514486632|gb|KE346360.1|	1904730	1904752	A	22	+	22	A
gi|514486632|gb|KE346360.1|	1904791	1904803	A	12	+	12	A
gi|514486632|gb|KE346360.1|	1905052	1905064	AGAGGC	12	+	2	GCAGAG
gi|514486632|gb|KE346360.1|	1905150	1905168	A	18	+	18	A
gi|514486632|gb|KE346360.1|	1905184	1905200	AAAATG	16	+	2	AAAATG
gi|514486632|gb|KE346360.1|	1905303	1905316	AGGGGG	13	+	2	GGGGAG
gi|514486632|gb|KE346360.1|	1905394	1905407	A	13	+	13	A
gi|514486632|gb|KE346360.1|	1905744	1905763	A	19	-	19	T
gi|514486632|gb|KE346360.1|	1905945	1905959	A	14	+	14	A
gi|514486632|gb|KE346360.1|	1906118	1906133	AC	15	+	7	CA
gi|514486632|gb|KE346360.1|	1906170	1906184	AAAG	14	-	3	TTTC
gi|514486632|gb|KE346360.1|	1906408	1906420	AAGCTC	12	-	2	AGCTTG
gi|514486632|gb|KE346360.1|	1906464	1906479	AGCC	15	-	3	GGCT
gi|514486632|gb|KE346360.1|	1907061	1907073	ACGCCG	12	+	2	CGCCGA
gi|514486632|gb|KE346360.1|	1907124	1907136	AAGAGC	12	+	2	GCAAGA
gi|514486632|gb|KE346360.1|	1909452	1909464	AAACTC	12	+	2	AAACTC
gi|514486632|gb|KE346360.1|	1909525	1909542	ACC	17	+	5	CAC
gi|514486632|gb|KE346360.1|	1909547	1909560	AACACC	13	+	2	AACACC
gi|514486632|gb|KE346360.1|	1909789	1909806	AAT	17	+	5	AAT
gi|514486632|gb|KE346360.1|	1910148	1910163	AGC	15	+	5	CAG
gi|514486632|gb|KE346360.1|	1910851	1910863	AACCAC	12	+	2	CAACCA
gi|514486632|gb|KE346360.1|	1911217	1911230	AAT	13	-	4	TAT
gi|514486632|gb|KE346360.1|	1911695	1911707	ACG	12	-	4	GTC
gi|514486632|gb|KE346360.1|	1911729	1911741	ACG	12	-	4	TCG
gi|514486632|gb|KE346360.1|	1912009	1912022	AAC	13	+	4	CAA
gi|514486632|gb|KE346360.1|	1912893	1912905	AAAGG	12	-	2	TCCTT
gi|514486632|gb|KE346360.1|	1913515	1913530	A	15	+	15	A
gi|514486632|gb|KE346360.1|	1913680	1913696	AGATG	16	-	3	TCTCA
gi|514486632|gb|KE346360.1|	1913796	1913811	A	15	-	15	T
gi|514486632|gb|KE346360.1|	1913826	1913847	A	21	-	21	T
gi|514486632|gb|KE346360.1|	1913945	1913957	AAAAAC	12	+	2	ACAAAA
gi|514486632|gb|KE346360.1|	1913996	1914008	AATCT	12	-	2	TTAGA
gi|514486632|gb|KE346360.1|	1914010	1914022	A	12	+	12	A
gi|514486632|gb|KE346360.1|	1914144	1914163	ACACGC	19	+	3	CACACG
gi|514486632|gb|KE346360.1|	1914568	1914580	ACCATC	12	-	2	ATGGTG
gi|514486632|gb|KE346360.1|	1915107	1915121	AAGGAC	14	+	2	GACAAG
gi|514486632|gb|KE346360.1|	1916150	1916163	ACCGC	13	-	2	TGCGG
gi|514486632|gb|KE346360.1|	1917465	1917477	AAAAG	12	+	2	GAAAA
gi|514486632|gb|KE346360.1|	1918474	1918506	CCG	32	-	10	GGC
gi|514486632|gb|KE346360.1|	1918552	1918565	AACC	13	+	3	CAAC
gi|514486632|gb|KE346360.1|	1919451	1919463	AGCTGC	12	+	2	TGCAGC
gi|514486632|gb|KE346360.1|	1921254	1921267	ACCACG	13	-	2	GTGGTC
gi|514486632|gb|KE346360.1|	1921492	1921505	AGGCGC	13	-	2	CCTGCG
gi|514486632|gb|KE346360.1|	1921856	1921868	ATCGCC	12	+	2	GCCATC
gi|514486632|gb|KE346360.1|	1922137	1922157	A	20	-	20	T
gi|514486632|gb|KE346360.1|	1922319	1922334	ACGCCG	15	-	2	CGGCGT
gi|514486632|gb|KE346360.1|	1922537	1922549	AGCGCC	12	+	2	GCGCCA
gi|514486632|gb|KE346360.1|	1922551	1922568	CCG	17	+	5	GCC
gi|514486632|gb|KE346360.1|	1922642	1922658	ACG	16	+	5	GAC
gi|514486632|gb|KE346360.1|	1922705	1922726	AGCCTG	21	-	3	GCTCAG
gi|514486632|gb|KE346360.1|	1923051	1923063	AACAGG	12	+	2	AACAGG
gi|514486632|gb|KE346360.1|	1924086	1924098	AACGAC	12	+	2	ACGACA
gi|514486632|gb|KE346360.1|	1924690	1924703	ACCCC	13	-	2	GGGGT
gi|514486632|gb|KE346360.1|	1925031	1925051	AC	20	+	10	CA
gi|514486632|gb|KE346360.1|	1925592	1925607	ACGCTG	15	-	2	CAGCGT
gi|514486632|gb|KE346360.1|	1925727	1925740	AAGAGC	13	+	2	GAGCAA
gi|514486632|gb|KE346360.1|	1925860	1925956	AC	96	+	48	CA
gi|514486632|gb|KE346360.1|	1926052	1926064	ACG	12	-	4	TCG
gi|514486632|gb|KE346360.1|	1926452	1926464	ACTCGG	12	+	2	GACTCG
gi|514486632|gb|KE346360.1|	1926628	1926640	AGAGCC	12	+	2	GAGCCA
gi|514486632|gb|KE346360.1|	1926838	1926852	ACC	14	-	4	GGT
gi|514486632|gb|KE346360.1|	1926916	1926945	A	29	+	29	A
gi|514486632|gb|KE346360.1|	1927204	1927221	AC	17	+	8	CA
gi|514486632|gb|KE346360.1|	1927761	1927773	AAAAAC	12	+	2	CAAAAA
gi|514486632|gb|KE346360.1|	1928266	1928281	A	15	-	15	T
gi|514486632|gb|KE346360.1|	1928277	1928291	AAAAC	14	-	2	TTTTG
gi|514486632|gb|KE346360.1|	1929236	1929260	AATGC	24	+	4	ATGCA
gi|514486632|gb|KE346360.1|	1929469	1929491	ACG	22	-	7	TCG
gi|514486632|gb|KE346360.1|	1930265	1930277	AAGC	12	-	3	GCTT
gi|514486632|gb|KE346360.1|	1930290	1930303	AAAAAG	13	+	2	AGAAAA
gi|514486632|gb|KE346360.1|	1931055	1931067	AAC	12	-	4	TTG
gi|514486632|gb|KE346360.1|	1931116	1931144	ACAG	28	+	7	ACAG
gi|514486632|gb|KE346360.1|	1932070	1932084	ATC	14	-	4	ATG
gi|514486632|gb|KE346360.1|	1932127	1932139	AAGGGG	12	-	2	TTCCCC
gi|514486632|gb|KE346360.1|	1932357	1932371	AAC	14	+	4	AAC
gi|514486632|gb|KE346360.1|	1932366	1932378	AACAAT	12	+	2	AACAAT
gi|514486632|gb|KE346360.1|	1932458	1932470	AAAGCG	12	-	2	CGCTTT
gi|514486632|gb|KE346360.1|	1932742	1932754	ATCCCC	12	+	2	CCCATC
gi|514486632|gb|KE346360.1|	1932773	1932785	AACATC	12	+	2	CATCAA
gi|514486632|gb|KE346360.1|	1933172	1933197	A	25	-	25	T
gi|514486632|gb|KE346360.1|	1934063	1934075	AG	12	-	6	TC
gi|514486632|gb|KE346360.1|	1936078	1936098	A	20	-	20	T
gi|514486632|gb|KE346360.1|	1936238	1936252	AAGCAG	14	-	2	TCTGCT
gi|514486632|gb|KE346360.1|	1936508	1936533	A	25	-	25	T
gi|514486632|gb|KE346360.1|	1937182	1937194	AACCCC	12	-	2	GGGTTG
gi|514486632|gb|KE346360.1|	1937223	1937236	AGCG	13	-	3	TCGC
gi|514486632|gb|KE346360.1|	1937323	1937349	A	26	-	26	T
gi|514486632|gb|KE346360.1|	1938526	1938561	ACC	35	+	11	CCA
gi|514486632|gb|KE346360.1|	1940007	1940035	AGC	28	-	9	GCT
gi|514486632|gb|KE346360.1|	1942887	1942899	AAGATC	12	+	2	ATCAAG
gi|514486632|gb|KE346360.1|	1943700	1943714	ACCGCG	14	+	2	GCGACC
gi|514486632|gb|KE346360.1|	1943892	1943904	AGC	12	-	4	GCT
gi|514486632|gb|KE346360.1|	1945059	1945071	AAACCC	12	+	2	CCCAAA
gi|514486632|gb|KE346360.1|	1946131	1946143	AACGAC	12	-	2	TGTCGT
gi|514486632|gb|KE346360.1|	1946857	1946888	A	31	+	31	A
gi|514486632|gb|KE346360.1|	1947091	1947103	A	12	+	12	A
gi|514486632|gb|KE346360.1|	1947101	1947115	AAT	14	+	4	AAT
gi|514486632|gb|KE346360.1|	1947149	1947161	AAAAAG	12	-	2	TTTTTC
gi|514486632|gb|KE346360.1|	1947175	1947188	AAGG	13	-	3	CTTC
gi|514486632|gb|KE346360.1|	1947696	1947708	A	12	-	12	T
gi|514486632|gb|KE346360.1|	1947747	1947763	ATCGCC	16	+	2	TCGCCA
gi|514486632|gb|KE346360.1|	1947928	1947963	A	35	-	35	T
gi|514486632|gb|KE346360.1|	1949253	1949267	ATCCCC	14	+	2	CCATCC
gi|514486632|gb|KE346360.1|	1950268	1950285	ACAGCG	17	+	2	GCGACA
gi|514486632|gb|KE346360.1|	1950337	1950368	AC	31	-	15	GT
gi|514486632|gb|KE346360.1|	1950641	1950654	A	13	+	13	A
gi|514486632|gb|KE346360.1|	1951957	1951969	ACTCGG	12	+	2	TCGGAC
gi|514486632|gb|KE346360.1|	1952310	1952324	ACC	14	-	4	GTG
gi|514486632|gb|KE346360.1|	1952334	1952352	ACC	18	-	6	GTG
gi|514486632|gb|KE346360.1|	1952532	1952544	ACTAGC	12	-	2	AGTGCT
gi|514486632|gb|KE346360.1|	1952539	1952561	ACCAGC	22	-	3	GTGCTG
gi|514486632|gb|KE346360.1|	1953319	1953342	ACC	23	-	7	GTG
gi|514486632|gb|KE346360.1|	1953357	1953371	ACC	14	-	4	TGG
gi|514486632|gb|KE346360.1|	1953432	1953446	AACATC	14	-	2	TGTTGA
gi|514486632|gb|KE346360.1|	1953481	1953512	AGC	31	+	10	GCA
gi|514486632|gb|KE346360.1|	1953676	1953692	AAGGGG	16	+	2	GGGGAA
gi|514486632|gb|KE346360.1|	1953695	1953845	AG	150	+	75	GA
gi|514486632|gb|KE346360.1|	1954028	1954055	A	27	+	27	A
gi|514486632|gb|KE346360.1|	1954052	1954064	AAAGG	12	+	2	AAAGG
gi|514486632|gb|KE346360.1|	1954072	1954084	A	12	+	12	A
gi|514486632|gb|KE346360.1|	1954106	1954119	AAGCAG	13	-	2	TGCTTC
gi|514486632|gb|KE346360.1|	1954258	1954281	A	23	+	23	A
gi|514486632|gb|KE346360.1|	1954460	1954476	ACG	16	+	5	GAC
gi|514486632|gb|KE346360.1|	1954502	1954538	A	36	+	36	A
gi|514486632|gb|KE346360.1|	1954653	1954665	C	12	+	12	C
gi|514486632|gb|KE346360.1|	1955104	1955120	A	16	+	16	A
gi|514486632|gb|KE346360.1|	1955249	1955261	AAAAC	12	-	2	TTGTT
gi|514486632|gb|KE346360.1|	1955260	1955272	AG	12	-	6	TC
gi|514486632|gb|KE346360.1|	1955358	1955370	AAAC	12	+	3	ACAA
gi|514486632|gb|KE346360.1|	1955704	1955716	AAATGG	12	-	2	TTTCCA
gi|514486632|gb|KE346360.1|	1956402	1956415	AACAAG	13	+	2	AGAACA
gi|514486632|gb|KE346360.1|	1956455	1956469	AAAGG	14	+	2	AAAGG
gi|514486632|gb|KE346360.1|	1957387	1957400	AAAAAC	13	+	2	AAACAA
gi|514486632|gb|KE346360.1|	1957416	1957433	A	17	+	17	A
gi|514486632|gb|KE346360.1|	1958969	1958990	A	21	+	21	A
gi|514486632|gb|KE346360.1|	1959305	1959320	A	15	+	15	A
gi|514486632|gb|KE346360.1|	1959752	1959765	ACTCTC	13	-	2	GAGTGA
gi|514486632|gb|KE346360.1|	1959798	1959810	A	12	+	12	A
gi|514486632|gb|KE346360.1|	1959982	1959994	A	12	+	12	A
gi|514486632|gb|KE346360.1|	1960221	1960235	A	14	+	14	A
gi|514486632|gb|KE346360.1|	1960250	1960263	AAAAAT	13	+	2	AAAAAT
gi|514486632|gb|KE346360.1|	1960440	1960457	A	17	+	17	A
gi|514486632|gb|KE346360.1|	1960673	1960695	A	22	-	22	T
gi|514486632|gb|KE346360.1|	1960759	1960771	ACAGTG	12	-	2	GTCACT
gi|514486632|gb|KE346360.1|	1960875	1960889	A	14	+	14	A
gi|514486632|gb|KE346360.1|	1961297	1961310	ATGGCC	13	+	2	GGCCAT
gi|514486632|gb|KE346360.1|	1962207	1962219	AAGGAG	12	-	2	CTTCTC
gi|514486632|gb|KE346360.1|	1963098	1963116	A	18	-	18	T
gi|514486632|gb|KE346360.1|	1963995	1964009	AAACAG	14	-	2	GTTTCT
gi|514486632|gb|KE346360.1|	1964532	1964546	AGCTGC	14	+	2	GCAGCT
gi|514486632|gb|KE346360.1|	1965528	1965540	AGC	12	-	4	TGC
gi|514486632|gb|KE346360.1|	1965604	1965619	AG	15	-	7	CT
gi|514486632|gb|KE346360.1|	1965701	1965713	AGCGGC	12	-	2	GCTGCC
gi|514486632|gb|KE346360.1|	1966183	1966195	AAGCTG	12	+	2	AAGCTG
gi|514486632|gb|KE346360.1|	1966534	1966546	ACCCGC	12	+	2	CCGCAC
gi|514486632|gb|KE346360.1|	1966599	1966611	AAACTT	12	-	2	TTTAAG
gi|514486632|gb|KE346360.1|	1966978	1966990	AGGGGG	12	-	2	CCCCCT
gi|514486632|gb|KE346360.1|	1967425	1967437	AAAAAC	12	+	2	CAAAAA
gi|514486632|gb|KE346360.1|	1968248	1968262	AAAAAG	14	-	2	TTTTCT
gi|514486632|gb|KE346360.1|	1968525	1968541	AGCC	16	+	4	CAGC
gi|514486632|gb|KE346360.1|	1968637	1968650	AACCTC	13	-	2	GTTGAG
gi|514486632|gb|KE346360.1|	1970589	1970603	AGCTCG	14	+	2	GCTCGA
gi|514486632|gb|KE346360.1|	1971425	1971437	ACGCAG	12	+	2	GCAGAC
gi|514486632|gb|KE346360.1|	1971607	1971621	AAGCAG	14	+	2	AGCAGA
gi|514486632|gb|KE346360.1|	1972169	1972227	AAC	58	+	19	ACA
gi|514486632|gb|KE346360.1|	1974370	1974386	AGC	16	-	5	TGC
gi|514486632|gb|KE346360.1|	1974388	1974404	AGC	16	-	5	TGC
gi|514486632|gb|KE346360.1|	1977596	1977608	ACCGCT	12	+	2	CGCTAC
gi|514486632|gb|KE346360.1|	1978434	1978446	AATGGG	12	-	2	CCATTC
gi|514486632|gb|KE346360.1|	1979055	1979070	AAGACC	15	+	2	CAAGAC
gi|514486632|gb|KE346360.1|	1980687	1980701	A	14	-	14	T
gi|514486632|gb|KE346360.1|	1980708	1980720	AAC	12	-	4	TGT
gi|514486632|gb|KE346360.1|	1980723	1980736	AAACTG	13	-	2	TTTCAG
gi|514486632|gb|KE346360.1|	1980954	1980966	AAGTCC	12	+	2	AAGTCC
gi|514486632|gb|KE346360.1|	1981128	1981141	CCCCGG	13	-	2	GGGGCC
gi|514486632|gb|KE346360.1|	1981735	1981749	AAGCAG	14	+	2	CAGAAG
gi|514486632|gb|KE346360.1|	1983290	1983307	AAGGGC	17	-	2	CCTTGC
gi|514486632|gb|KE346360.1|	1983302	1983320	AAGGCC	18	-	3	CCTTGG
gi|514486632|gb|KE346360.1|	1983568	1983585	ACGAGG	17	-	2	TCGTCC
gi|514486632|gb|KE346360.1|	1983719	1983731	AGC	12	-	4	GCT
gi|514486632|gb|KE346360.1|	1983979	1983991	A	12	-	12	T
gi|514486632|gb|KE346360.1|	1984075	1984096	ACCCTC	21	-	3	GGGTGA
gi|514486632|gb|KE346360.1|	1984167	1984179	ACGC	12	-	3	GTGC
gi|514486632|gb|KE346360.1|	1984639	1984658	A	19	-	19	T
gi|514486632|gb|KE346360.1|	1985304	1985316	ACG	12	+	4	CGA
gi|514486632|gb|KE346360.1|	1989120	1989132	AGCTGC	12	+	2	AGCTGC
gi|514486632|gb|KE346360.1|	1989711	1989723	AAGAGC	12	+	2	CAAGAG
gi|514486632|gb|KE346360.1|	1989815	1989827	ACGAGC	12	-	2	TGCTCG
gi|514486632|gb|KE346360.1|	1991317	1991329	AGCTCG	12	+	2	TCGAGC
gi|514486632|gb|KE346360.1|	1991599	1991611	AAAGAC	12	+	2	ACAAAG
gi|514486632|gb|KE346360.1|	1992723	1992736	ACGCGC	13	-	2	GCGCGT
gi|514486632|gb|KE346360.1|	1992787	1992799	AAGGAC	12	-	2	TCCTTG
gi|514486632|gb|KE346360.1|	1993831	1993852	ACC	21	-	7	GTG
gi|514486632|gb|KE346360.1|	1994926	1994938	ACACCG	12	-	2	TCGGTG
gi|514486632|gb|KE346360.1|	1995593	1995606	AATATG	13	-	2	ATTCAT
gi|514486632|gb|KE346360.1|	1995768	1995793	AG	25	-	12	TC
gi|514486632|gb|KE346360.1|	1995873	1995914	A	41	+	41	A
gi|514486632|gb|KE346360.1|	1996070	1996082	A	12	+	12	A
gi|514486632|gb|KE346360.1|	1996208	1996220	AAGGCC	12	-	2	CTTGGC
gi|514486632|gb|KE346360.1|	1996402	1996423	A	21	+	21	A
gi|514486632|gb|KE346360.1|	1997057	1997070	AC	13	+	6	CA
gi|514486632|gb|KE346360.1|	1997071	1997095	A	24	+	24	A
gi|514486632|gb|KE346360.1|	1997372	1997384	AATTGC	12	+	2	GCAATT
gi|514486632|gb|KE346360.1|	1997433	1997445	AACAGC	12	+	2	CAGCAA
gi|514486632|gb|KE346360.1|	1998049	1998062	AGGATG	13	+	2	GATGAG
gi|514486632|gb|KE346360.1|	1998822	1998836	AGGGGG	14	+	2	GGGAGG
gi|514486632|gb|KE346360.1|	1999371	1999385	AAAAGC	14	-	2	GCTTTT
gi|514486632|gb|KE346360.1|	1999421	1999434	ACCTCC	13	-	2	GGAGGT
gi|514486632|gb|KE346360.1|	1999684	1999700	AC	16	+	8	CA
gi|514486632|gb|KE346360.1|	1999864	1999876	AAGGAC	12	-	2	TTGTCC
gi|514486632|gb|KE346360.1|	2000290	2000313	ACG	23	+	7	GAC
gi|514486632|gb|KE346360.1|	2000331	2000348	A	17	+	17	A
gi|514486632|gb|KE346360.1|	2000346	2000363	AATG	17	+	4	AATG
gi|514486632|gb|KE346360.1|	2000365	2000379	AAAGC	14	-	2	TTGCT
gi|514486632|gb|KE346360.1|	2000664	2000685	ATCGCC	21	+	3	CCATCG
gi|514486632|gb|KE346360.1|	2001501	2001514	ACCCAG	13	-	2	GGTCTG
gi|514486632|gb|KE346360.1|	2007326	2007339	AAACC	13	+	2	AAACC
gi|514486632|gb|KE346360.1|	2007518	2007531	AAAC	13	+	3	ACAA
gi|514486632|gb|KE346360.1|	2007525	2007539	AAAAAC	14	+	2	AACAAA
gi|514486632|gb|KE346360.1|	2008032	2008045	AAAC	13	+	3	CAAA
gi|514486632|gb|KE346360.1|	2008056	2008071	AAAAC	15	+	3	ACAAA
gi|514486632|gb|KE346360.1|	2008841	2008859	AAAAC	18	+	3	AAAAC
gi|514486632|gb|KE346360.1|	2008855	2008870	AAACC	15	+	3	CAAAC
gi|514486632|gb|KE346360.1|	2008892	2008912	AAAC	20	+	5	CAAA
gi|514486632|gb|KE346360.1|	2009541	2009553	AACATC	12	-	2	TTGATG
gi|514486632|gb|KE346360.1|	2009733	2009755	A	22	+	22	A
gi|514486632|gb|KE346360.1|	2009878	2009909	AGC	31	+	10	CAG
gi|514486632|gb|KE346360.1|	2010100	2010124	AG	24	+	12	GA
gi|514486632|gb|KE346360.1|	2010129	2010146	A	17	+	17	A
gi|514486632|gb|KE346360.1|	2012014	2012026	A	12	-	12	T
gi|514486632|gb|KE346360.1|	2012184	2012196	A	12	+	12	A
gi|514486632|gb|KE346360.1|	2012802	2012815	A	13	+	13	A
gi|514486632|gb|KE346360.1|	2012847	2012859	AAACG	12	+	2	AAACG
gi|514486632|gb|KE346360.1|	2013353	2013374	AC	21	+	10	CA
gi|514486632|gb|KE346360.1|	2014117	2014129	AAGCAC	12	-	2	CTTGTG
gi|514486632|gb|KE346360.1|	2014127	2014142	AAAAC	15	-	3	TGTTT
gi|514486632|gb|KE346360.1|	2014441	2014454	A	13	-	13	T
gi|514486632|gb|KE346360.1|	2015000	2015012	ACAGCG	12	+	2	AGCGAC
gi|514486632|gb|KE346360.1|	2015630	2015648	ACCATC	18	+	3	TCACCA
gi|514486632|gb|KE346360.1|	2015729	2015743	AAAAC	14	+	2	AAAAC
gi|514486632|gb|KE346360.1|	2015875	2015887	AACGGC	12	+	2	CGGCAA
gi|514486632|gb|KE346360.1|	2016193	2016205	AG	12	+	6	GA
gi|514486632|gb|KE346360.1|	2016319	2016331	AAGATG	12	+	2	GATGAA
gi|514486632|gb|KE346360.1|	2018386	2018408	AACAAG	22	-	3	TTGTTC
gi|514486632|gb|KE346360.1|	2018441	2018454	AAAC	13	-	3	TGTT
gi|514486632|gb|KE346360.1|	2018571	2018588	AG	17	+	8	GA
gi|514486632|gb|KE346360.1|	2021997	2022009	A	12	+	12	A
gi|514486632|gb|KE346360.1|	2022504	2022516	AAAAGC	12	+	2	AAAAGC
gi|514486632|gb|KE346360.1|	2022530	2022543	A	13	+	13	A
gi|514486632|gb|KE346360.1|	2022544	2022557	A	13	+	13	A
gi|514486632|gb|KE346360.1|	2022736	2022753	AAC	17	-	5	GTT
gi|514486632|gb|KE346360.1|	2023239	2023252	AGCGGC	13	+	2	CAGCGG
gi|514486632|gb|KE346360.1|	2023376	2023388	AAAAC	12	+	2	ACAAA
gi|514486632|gb|KE346360.1|	2023392	2023404	AACAAG	12	+	2	AAGAAC
gi|514486632|gb|KE346360.1|	2023569	2023582	A	13	-	13	T
gi|514486632|gb|KE346360.1|	2023690	2023710	AG	20	+	10	AG
gi|514486632|gb|KE346360.1|	2023785	2023800	AGGGGG	15	-	2	TCCCCC
gi|514486632|gb|KE346360.1|	2023928	2023940	ACGAGG	12	-	2	CCTCGT
gi|514486632|gb|KE346360.1|	2023946	2023970	A	24	-	24	T
gi|514486632|gb|KE346360.1|	2024000	2024012	ACTGCC	12	-	2	CAGTGG
gi|514486632|gb|KE346360.1|	2024090	2024103	CCG	13	+	4	CGC
gi|514486632|gb|KE346360.1|	2024607	2024621	AGCCGG	14	+	2	GGAGCC
gi|514486632|gb|KE346360.1|	2024706	2024719	CCGGCG	13	+	2	GCCGGC
gi|514486632|gb|KE346360.1|	2024723	2024735	ACCAGC	12	-	2	TGGTGC
gi|514486632|gb|KE346360.1|	2024736	2024750	AGGCGC	14	+	2	GGCGCA
gi|514486632|gb|KE346360.1|	2024964	2024979	ATGCCC	15	-	2	GGCATG
gi|514486632|gb|KE346360.1|	2025024	2025038	ATGCCC	14	-	2	GGCATG
gi|514486632|gb|KE346360.1|	2025060	2025075	ATGCCC	15	-	2	GGCATG
gi|514486632|gb|KE346360.1|	2025081	2025095	ATGCCC	14	-	2	GGCATG
gi|514486632|gb|KE346360.1|	2025141	2025155	ATGCCC	14	-	2	GGCATG
gi|514486632|gb|KE346360.1|	2025201	2025216	ATGCCC	15	-	2	GGCATG
gi|514486632|gb|KE346360.1|	2025222	2025243	ATGCCC	21	-	3	GGCATG
gi|514486632|gb|KE346360.1|	2025249	2025264	ATGCCC	15	-	2	GGCATG
gi|514486632|gb|KE346360.1|	2026685	2026707	ACAGCC	22	+	3	CAGCCA
gi|514486632|gb|KE346360.1|	2026703	2026732	AGC	29	+	9	CAG
gi|514486632|gb|KE346360.1|	2027053	2027065	AGATGG	12	-	2	CCATCT
gi|514486632|gb|KE346360.1|	2027754	2027773	AGC	19	+	6	AGC
gi|514486632|gb|KE346360.1|	2027929	2027942	ACC	13	+	4	CCA
gi|514486632|gb|KE346360.1|	2028555	2028571	AGC	16	+	5	AGC
gi|514486632|gb|KE346360.1|	2028885	2028897	ACTC	12	+	3	TCAC
gi|514486632|gb|KE346360.1|	2029212	2029224	ACGAGC	12	+	2	GAGCAC
gi|514486632|gb|KE346360.1|	2030463	2030477	A	14	+	14	A
gi|514486632|gb|KE346360.1|	2031347	2031367	A	20	-	20	T
gi|514486632|gb|KE346360.1|	2031811	2031823	AACC	12	+	3	CAAC
gi|514486632|gb|KE346360.1|	2031899	2031917	AG	18	+	9	GA
gi|514486632|gb|KE346360.1|	2032429	2032444	AAGGG	15	-	3	CCTTC
gi|514486632|gb|KE346360.1|	2032522	2032535	AAATTG	13	+	2	TGAAAT
gi|514486632|gb|KE346360.1|	2032723	2032740	AAAAAC	17	-	2	TTTTTG
gi|514486632|gb|KE346360.1|	2033888	2033901	AAGCAC	13	-	2	GTGCTT
gi|514486632|gb|KE346360.1|	2034081	2034098	A	17	-	17	T
gi|514486632|gb|KE346360.1|	2034310	2034327	AGC	17	-	5	TGC
gi|514486632|gb|KE346360.1|	2034322	2034336	AACAGC	14	-	2	TGCTGT
gi|514486632|gb|KE346360.1|	2034331	2034347	AAC	16	-	5	TGT
gi|514486632|gb|KE346360.1|	2034971	2034984	AGCCGC	13	+	2	CGCAGC
gi|514486632|gb|KE346360.1|	2035824	2035836	AAAATG	12	-	2	TTTTCA
gi|514486632|gb|KE346360.1|	2035876	2035897	AGC	21	+	7	CAG
gi|514486632|gb|KE346360.1|	2035956	2035970	AGC	14	+	4	GCA
gi|514486632|gb|KE346360.1|	2036215	2036227	AGCCCC	12	-	2	GCTGGG
gi|514486632|gb|KE346360.1|	2036517	2036530	AGGCGG	13	+	2	GAGGCG
gi|514486632|gb|KE346360.1|	2036557	2036571	ACC	14	-	4	GTG
gi|514486632|gb|KE346360.1|	2036574	2036597	AACAGC	23	-	3	TGCTGT
gi|514486632|gb|KE346360.1|	2036606	2036619	AACAGC	13	-	2	CTGTTG
gi|514486632|gb|KE346360.1|	2037267	2037309	AGC	42	+	14	GCA
gi|514486632|gb|KE346360.1|	2037345	2037364	ATCCGC	19	-	3	GATGCG
gi|514486632|gb|KE346360.1|	2037362	2037375	AACCAC	13	-	2	GGTTGT
gi|514486632|gb|KE346360.1|	2037618	2037635	AAC	17	-	5	TGT
gi|514486632|gb|KE346360.1|	2037642	2037665	AAC	23	-	7	TGT
gi|514486632|gb|KE346360.1|	2037663	2037677	AGC	14	-	4	TGC
gi|514486632|gb|KE346360.1|	2038042	2038054	AG	12	+	6	GA
gi|514486632|gb|KE346360.1|	2038142	2038159	AC	17	-	8	GT
gi|514486632|gb|KE346360.1|	2038248	2038276	A	28	+	28	A
gi|514486632|gb|KE346360.1|	2038294	2038320	A	26	+	26	A
gi|514486632|gb|KE346360.1|	2038325	2038338	AAAATC	13	+	2	AATCAA
gi|514486632|gb|KE346360.1|	2038622	2038634	ACAGC	12	+	2	ACAGC
gi|514486632|gb|KE346360.1|	2039450	2039462	AAAAAC	12	-	2	TTTTTG
gi|514486632|gb|KE346360.1|	2039622	2039634	ACGAGG	12	+	2	AGGACG
gi|514486632|gb|KE346360.1|	2041282	2041295	AAAACC	13	+	2	AAACCA
gi|514486632|gb|KE346360.1|	2041307	2041319	AAAAAC	12	+	2	CAAAAA
gi|514486632|gb|KE346360.1|	2041328	2041340	AAAACC	12	+	2	CAAAAC
gi|514486632|gb|KE346360.1|	2042442	2042456	AGC	14	+	4	AGC
gi|514486632|gb|KE346360.1|	2042633	2042645	AAAAAC	12	-	2	TTTTGT
gi|514486632|gb|KE346360.1|	2044492	2044507	ACAGGC	15	+	2	CACAGG
gi|514486632|gb|KE346360.1|	2044584	2044607	A	23	-	23	T
gi|514486632|gb|KE346360.1|	2044631	2044645	AACAGG	14	-	2	CTGTTC
gi|514486632|gb|KE346360.1|	2044715	2044727	CCCCCG	12	-	2	GCGGGG
gi|514486632|gb|KE346360.1|	2045320	2045332	AATGGC	12	-	2	CATTGC
gi|514486632|gb|KE346360.1|	2046073	2046091	A	18	-	18	T
gi|514486632|gb|KE346360.1|	2046132	2046144	AG	12	-	6	TC
gi|514486632|gb|KE346360.1|	2048282	2048296	AAAAT	14	+	2	AAAAT
gi|514486632|gb|KE346360.1|	2048991	2049006	AAACG	15	+	3	CGAAA
gi|514486632|gb|KE346360.1|	2049166	2049178	AAGAG	12	+	2	AGAAG
gi|514486632|gb|KE346360.1|	2049408	2049435	CCG	27	-	9	GGC
gi|514486632|gb|KE346360.1|	2049561	2049575	CCG	14	-	4	GGC
gi|514486632|gb|KE346360.1|	2049670	2049695	CCG	25	-	8	GCG
gi|514486632|gb|KE346360.1|	2049820	2049832	ACAGTC	12	-	2	ACTGTG
gi|514486632|gb|KE346360.1|	2049940	2049954	CCG	14	-	4	GGC
gi|514486632|gb|KE346360.1|	2050503	2050516	AGGCG	13	-	2	CCTCG
gi|514486632|gb|KE346360.1|	2050524	2050538	AAACAC	14	-	2	TTTGTG
gi|514486632|gb|KE346360.1|	2051452	2051468	ACACAG	16	-	2	TCTGTG
gi|514486632|gb|KE346360.1|	2054958	2054970	ACAGG	12	+	2	ACAGG
gi|514486632|gb|KE346360.1|	2054968	2054983	AACGAG	15	+	2	ACGAGA
gi|514486632|gb|KE346360.1|	2055010	2055022	AGGGCG	12	-	2	CTCGCC
gi|514486632|gb|KE346360.1|	2055462	2055476	ACCTCC	14	+	2	CCTCCA
gi|514486632|gb|KE346360.1|	2055471	2055484	ACC	13	+	4	CCA
gi|514486632|gb|KE346360.1|	2055720	2055734	ACG	14	-	4	GTC
gi|514486632|gb|KE346360.1|	2055742	2055755	ACC	13	-	4	TGG
gi|514486632|gb|KE346360.1|	2056035	2056050	ACTC	15	-	3	GAGT
gi|514486632|gb|KE346360.1|	2056386	2056398	AACTTC	12	-	2	TTGAAG
gi|514486632|gb|KE346360.1|	2056456	2056476	ACTC	20	+	5	CTCA
gi|514486632|gb|KE346360.1|	2056772	2056786	ACAGCG	14	-	2	GTCGCT
gi|514486632|gb|KE346360.1|	2056837	2056854	ATCC	17	+	4	CCAT
gi|514486632|gb|KE346360.1|	2057319	2057352	AAC	33	+	11	AAC
gi|514486632|gb|KE346360.1|	2060149	2060161	AAAAC	12	+	2	CAAAA
gi|514486632|gb|KE346360.1|	2061247	2061284	AGG	37	+	12	GAG
gi|514486632|gb|KE346360.1|	2061285	2061299	AGGCGG	14	+	2	GGCGGA
gi|514486632|gb|KE346360.1|	2061808	2061820	ACG	12	+	4	GAC
gi|514486632|gb|KE346360.1|	2062291	2062313	AGC	22	-	7	TGC
gi|514486632|gb|KE346360.1|	2062584	2062601	AGAGAT	17	-	2	TCTCTA
gi|514486632|gb|KE346360.1|	2062873	2062886	AAGTGG	13	-	2	TCCACT
gi|514486632|gb|KE346360.1|	2064572	2064586	AGGG	14	+	3	GAGG
gi|514486632|gb|KE346360.1|	2064581	2064594	AAAGGG	13	+	2	AGGGAA
gi|514486632|gb|KE346360.1|	2064931	2064957	AG	26	+	13	AG
gi|514486632|gb|KE346360.1|	2065166	2065184	ATC	18	+	6	TCA
gi|514486632|gb|KE346360.1|	2065408	2065420	C	12	-	12	G
gi|514486632|gb|KE346360.1|	2065655	2065676	AAG	21	+	7	GAA
gi|514486632|gb|KE346360.1|	2065724	2065736	ACAGTG	12	+	2	CAGTGA
gi|514486632|gb|KE346360.1|	2066524	2066544	AAC	20	-	6	TGT
gi|514486632|gb|KE346360.1|	2066553	2066571	AGC	18	-	6	CTG
gi|514486632|gb|KE346360.1|	2066766	2066779	ACGGG	13	+	2	GGGAC
gi|514486632|gb|KE346360.1|	2068237	2068250	AAGGTC	13	+	2	GTCAAG
gi|514486632|gb|KE346360.1|	2069157	2069169	AACAGC	12	+	2	CAACAG
gi|514486632|gb|KE346360.1|	2069866	2069880	AGCGGC	14	-	2	GCCGCT
gi|514486632|gb|KE346360.1|	2070878	2070895	ATC	17	-	5	TGA
gi|514486632|gb|KE346360.1|	2071027	2071050	AGAGCC	23	-	3	TGGCTC
gi|514486632|gb|KE346360.1|	2071332	2071345	AGC	13	-	4	CTG
gi|514486632|gb|KE346360.1|	2072225	2072244	A	19	+	19	A
gi|514486632|gb|KE346360.1|	2072252	2072265	AACAAG	13	+	2	CAAGAA
gi|514486632|gb|KE346360.1|	2072415	2072427	ACTCG	12	-	2	GTCGA
gi|514486632|gb|KE346360.1|	2072749	2072761	ACCAG	12	+	2	AGACC
gi|514486632|gb|KE346360.1|	2072852	2072869	AAAAAG	17	-	2	TTTTTC
gi|514486632|gb|KE346360.1|	2073227	2073239	AACTGG	12	+	2	TGGAAC
gi|514486632|gb|KE346360.1|	2073242	2073267	A	25	+	25	A
gi|514486632|gb|KE346360.1|	2073641	2073654	AAAAAT	13	+	2	AAAAAT
gi|514486632|gb|KE346360.1|	2074196	2074212	A	16	-	16	T
gi|514486632|gb|KE346360.1|	2074230	2074243	AAACCG	13	-	2	CGGTTT
gi|514486632|gb|KE346360.1|	2074554	2074568	CCG	14	-	4	GCG
gi|514486632|gb|KE346360.1|	2074782	2074794	AAAAAC	12	-	2	TTTTTG
gi|514486632|gb|KE346360.1|	2075272	2075284	AACGTT	12	+	2	CGTTAA
gi|514486632|gb|KE346360.1|	2076172	2076185	AAGGAC	13	+	2	GGACAA
gi|514486632|gb|KE346360.1|	2076570	2076582	AAAAC	12	+	2	AAAAC
gi|514486632|gb|KE346360.1|	2077532	2077544	AACATC	12	-	2	TTGATG
gi|514486632|gb|KE346360.1|	2077676	2077689	AAAAC	13	+	2	AAAAC
gi|514486632|gb|KE346360.1|	2077738	2077758	A	20	-	20	T
gi|514486632|gb|KE346360.1|	2077861	2077876	AGC	15	+	5	GCA
gi|514486632|gb|KE346360.1|	2078055	2078068	ACAGCC	13	-	2	GTGGCT
gi|514486632|gb|KE346360.1|	2078824	2078836	AGGATG	12	+	2	AGGATG
gi|514486632|gb|KE346360.1|	2079609	2079621	AGCATG	12	-	2	CATGCT
gi|514486632|gb|KE346360.1|	2079875	2079888	AAC	13	-	4	GTT
gi|514486632|gb|KE346360.1|	2080382	2080394	AATGCG	12	+	2	TGCGAA
gi|514486632|gb|KE346360.1|	2080541	2080562	A	21	+	21	A
gi|514486632|gb|KE346360.1|	2080765	2080777	AAAC	12	+	3	ACAA
gi|514486632|gb|KE346360.1|	2080778	2080796	A	18	+	18	A
gi|514486632|gb|KE346360.1|	2081122	2081136	AGC	14	+	4	CAG
gi|514486632|gb|KE346360.1|	2081218	2081241	AGC	23	+	7	CAG
gi|514486632|gb|KE346360.1|	2081703	2081717	AAAC	14	-	3	TTGT
gi|514486632|gb|KE346360.1|	2081732	2081745	AAAC	13	-	3	TTGT
gi|514486632|gb|KE346360.1|	2081798	2081814	AAAC	16	-	4	TTTG
gi|514486632|gb|KE346360.1|	2082075	2082090	AACGAC	15	-	2	GTCGTT
gi|514486632|gb|KE346360.1|	2082241	2082256	ACAGCG	15	-	2	TCGCTG
gi|514486632|gb|KE346360.1|	2082424	2082438	ACTCGG	14	+	2	GACTCG
gi|514486632|gb|KE346360.1|	2082848	2082868	ACG	20	-	6	CGT
gi|514486632|gb|KE346360.1|	2083688	2083700	C	12	+	12	C
gi|514486632|gb|KE346360.1|	2084063	2084077	AAC	14	+	4	ACA
gi|514486632|gb|KE346360.1|	2084682	2084696	AAC	14	+	4	ACA
gi|514486632|gb|KE346360.1|	2085227	2085240	ATCGGC	13	-	2	ATGCCG
gi|514486632|gb|KE346360.1|	2085527	2085539	AAACG	12	+	2	AAACG
gi|514486632|gb|KE346360.1|	2085775	2085789	ACGATC	14	-	2	ATCGTG
gi|514486632|gb|KE346360.1|	2086045	2086071	A	26	-	26	T
gi|514486632|gb|KE346360.1|	2086528	2086540	AGATGG	12	+	2	ATGGAG
gi|514486632|gb|KE346360.1|	2087101	2087113	AGC	12	-	4	TGC
gi|514486632|gb|KE346360.1|	2087108	2087131	AGCCGC	23	-	3	GCTGCG
gi|514486632|gb|KE346360.1|	2088182	2088196	AAGCAG	14	-	2	CTGCTT
gi|514486632|gb|KE346360.1|	2088358	2088391	AAAC	33	+	8	CAAA
gi|514486632|gb|KE346360.1|	2089250	2089264	A	14	-	14	T
gi|514486632|gb|KE346360.1|	2089604	2089625	A	21	+	21	A
gi|514486632|gb|KE346360.1|	2089862	2089876	ACC	14	-	4	GTG
gi|514486632|gb|KE346360.1|	2090039	2090054	A	15	+	15	A
gi|514486632|gb|KE346360.1|	2091230	2091252	AGC	22	-	7	GCT
gi|514486632|gb|KE346360.1|	2091247	2091261	ACCAGC	14	-	2	TGCTGG
gi|514486632|gb|KE346360.1|	2091346	2091358	AGCG	12	-	3	CGCT
gi|514486632|gb|KE346360.1|	2092607	2092621	AAAGAG	14	-	2	CTTTCT
gi|514486632|gb|KE346360.1|	2092892	2092904	AGCATG	12	+	2	TGAGCA
gi|514486632|gb|KE346360.1|	2093194	2093208	CCG	14	+	4	CCG
gi|514486632|gb|KE346360.1|	2094212	2094224	A	12	+	12	A
gi|514486632|gb|KE346360.1|	2094332	2094349	ACC	17	-	5	TGG
gi|514486632|gb|KE346360.1|	2094440	2094454	AAAGGG	14	-	2	TCCCTT
gi|514486632|gb|KE346360.1|	2094587	2094603	AAAAAG	16	-	2	TTTTTC
gi|514486632|gb|KE346360.1|	2095218	2095238	A	20	-	20	T
gi|514486632|gb|KE346360.1|	2096122	2096136	AAACAC	14	-	2	GTTTGT
gi|514486632|gb|KE346360.1|	2097232	2097244	ACCACG	12	-	2	TGGTCG
gi|514486632|gb|KE346360.1|	2097619	2097633	AAGCTC	14	-	2	GCTTGA
gi|514486632|gb|KE346360.1|	2098077	2098090	AACGAC	13	-	2	TCGTTG
gi|514486632|gb|KE346360.1|	2100348	2100360	AGCAGG	12	-	2	TGCTCC
gi|514486632|gb|KE346360.1|	2100374	2100391	ACG	17	+	5	CGA
gi|514486632|gb|KE346360.1|	2100539	2100556	AGCATG	17	-	2	ATGCTC
gi|514486632|gb|KE346360.1|	2100949	2100970	AAC	21	-	7	TGT
gi|514486632|gb|KE346360.1|	2100971	2100983	AAC	12	-	4	TGT
gi|514486632|gb|KE346360.1|	2101591	2101603	AATCAC	12	-	2	GTGATT
gi|514486632|gb|KE346360.1|	2103502	2103519	AGCGCC	17	-	2	GCTGGC
gi|514486632|gb|KE346360.1|	2103981	2103997	A	16	+	16	A
gi|514486632|gb|KE346360.1|	2104459	2104471	AAAAC	12	+	2	AACAA
gi|514486632|gb|KE346360.1|	2104493	2104547	A	54	+	54	A
gi|514486632|gb|KE346360.1|	2105041	2105053	AAACAC	12	+	2	CACAAA
gi|514486632|gb|KE346360.1|	2105324	2105336	AAAAGT	12	+	2	AAAGTA
gi|514486632|gb|KE346360.1|	2105780	2105793	AACTGG	13	+	2	GAACTG
gi|514486632|gb|KE346360.1|	2106566	2106613	AC	47	+	23	CA
gi|514486632|gb|KE346360.1|	2106614	2106632	AC	18	+	9	CA
gi|514486632|gb|KE346360.1|	2106633	2106653	AC	20	+	10	AC
gi|514486632|gb|KE346360.1|	2106757	2106826	AC	69	+	34	AC
gi|514486632|gb|KE346360.1|	2106836	2106848	AAAAGC	12	+	2	GCAAAA
gi|514486632|gb|KE346360.1|	2107361	2107383	A	22	+	22	A
gi|514486632|gb|KE346360.1|	2107659	2107671	A	12	+	12	A
gi|514486632|gb|KE346360.1|	2107866	2107881	AAG	15	-	5	CTT
gi|514486632|gb|KE346360.1|	2108226	2108238	ACCTCG	12	-	2	GAGGTC
gi|514486632|gb|KE346360.1|	2108866	2108878	C	12	-	12	G
gi|514486632|gb|KE346360.1|	2109409	2109435	A	26	+	26	A
gi|514486632|gb|KE346360.1|	2110070	2110084	AGAGCG	14	+	2	GAGCGA
gi|514486632|gb|KE346360.1|	2110159	2110171	AACAAT	12	+	2	ACAATA
gi|514486632|gb|KE346360.1|	2110233	2110245	AATTCC	12	-	2	GGAATT
gi|514486632|gb|KE346360.1|	2110285	2110303	AC	18	+	9	AC
gi|514486632|gb|KE346360.1|	2110382	2110398	AAAG	16	+	4	GAAA
gi|514486632|gb|KE346360.1|	2110395	2110416	A	21	+	21	A
gi|514486632|gb|KE346360.1|	2110556	2110573	ACTC	17	-	4	GTGA
gi|514486632|gb|KE346360.1|	2110980	2110995	A	15	+	15	A
gi|514486632|gb|KE346360.1|	2110991	2111005	AAAAG	14	+	2	AAAAG
gi|514486632|gb|KE346360.1|	2111026	2111040	AGATC	14	-	2	TCTGA
gi|514486632|gb|KE346360.1|	2111161	2111184	AG	23	-	11	TC
gi|514486632|gb|KE346360.1|	2111185	2111201	AAACG	16	-	3	TTCGT
gi|514486632|gb|KE346360.1|	2111260	2111272	ACG	12	+	4	CGA
gi|514486632|gb|KE346360.1|	2111326	2111353	AGCAGG	27	+	4	AGGAGC
gi|514486632|gb|KE346360.1|	2111424	2111438	AGC	14	-	4	CTG
gi|514486632|gb|KE346360.1|	2111441	2111464	AGCCGC	23	-	3	GCTGCG
gi|514486632|gb|KE346360.1|	2112328	2112340	AAAAAC	12	-	2	TTTTTG
gi|514486632|gb|KE346360.1|	2114120	2114132	AGCGC	12	+	2	AGCGC
gi|514486632|gb|KE346360.1|	2114362	2114382	AGC	20	+	6	GCA
gi|514486632|gb|KE346360.1|	2114706	2114718	ACGGCG	12	-	2	TCGCCG
gi|514486632|gb|KE346360.1|	2114833	2114845	ACC	12	-	4	GGT
gi|514486632|gb|KE346360.1|	2114972	2114984	AAAAG	12	+	2	AAAAG
gi|514486632|gb|KE346360.1|	2115011	2115028	ACC	17	-	5	TGG
gi|514486632|gb|KE346360.1|	2115077	2115090	ACTC	13	+	3	CTCA
gi|514486632|gb|KE346360.1|	2116197	2116210	A	13	-	13	T
gi|514486632|gb|KE346360.1|	2116227	2116240	AAAAAG	13	-	2	TTTTTC
gi|514486632|gb|KE346360.1|	2116520	2116532	ACGGCG	12	-	2	CGTCGC
gi|514486632|gb|KE346360.1|	2116602	2116615	AAAACC	13	+	2	CCAAAA
gi|514486632|gb|KE346360.1|	2116613	2116632	AC	19	+	9	AC
gi|514486632|gb|KE346360.1|	2117017	2117070	AG	53	+	26	AG
gi|514486632|gb|KE346360.1|	2117256	2117269	AACACC	13	+	2	CAACAC
gi|514486632|gb|KE346360.1|	2119033	2119045	AGC	12	+	4	AGC
gi|514486632|gb|KE346360.1|	2120328	2120343	AGCG	15	+	3	GCGA
gi|514486632|gb|KE346360.1|	2120350	2120363	ACG	13	-	4	TCG
gi|514486632|gb|KE346360.1|	2121042	2121055	ATC	13	-	4	GAT
gi|514486632|gb|KE346360.1|	2121130	2121147	AGC	17	-	5	TGC
gi|514486632|gb|KE346360.1|	2121148	2121162	ACCAGC	14	-	2	TGGTGC
gi|514486632|gb|KE346360.1|	2121179	2121195	AACCAC	16	-	2	GTGGTT
gi|514486632|gb|KE346360.1|	2121274	2121286	AAAAAC	12	+	2	CAAAAA
gi|514486632|gb|KE346360.1|	2121376	2121400	AATG	24	-	6	TCAT
gi|514486632|gb|KE346360.1|	2121490	2121505	AAGC	15	+	3	CAAG
gi|514486632|gb|KE346360.1|	2121554	2121587	A	33	-	33	T
gi|514486632|gb|KE346360.1|	2121954	2121967	AGCCTG	13	-	2	TCAGGC
gi|514486632|gb|KE346360.1|	2122164	2122176	AAGCTC	12	+	2	TCAAGC
gi|514486632|gb|KE346360.1|	2122253	2122267	AACACC	14	-	2	TGTTGG
gi|514486632|gb|KE346360.1|	2122491	2122507	AGC	16	-	5	CTG
gi|514486632|gb|KE346360.1|	2123725	2123737	AATGC	12	-	2	TTGCA
gi|514486632|gb|KE346360.1|	2123743	2123769	A	26	-	26	T
gi|514486632|gb|KE346360.1|	2123960	2123972	AGCAGG	12	-	2	TGCTCC
gi|514486632|gb|KE346360.1|	2124723	2124736	A	13	+	13	A
gi|514486632|gb|KE346360.1|	2125773	2125790	AAAAAC	17	+	2	AAACAA
gi|514486632|gb|KE346360.1|	2125807	2125827	AAC	20	+	6	AAC
gi|514486632|gb|KE346360.1|	2126043	2126062	ACAGCG	19	-	3	GTCGCT
gi|514486632|gb|KE346360.1|	2126294	2126306	AGCGCC	12	-	2	TGGCGC
gi|514486632|gb|KE346360.1|	2128357	2128375	ACGGC	18	-	3	CCGTG
gi|514486632|gb|KE346360.1|	2128617	2128629	AACTGC	12	-	2	GTTGCA
gi|514486632|gb|KE346360.1|	2129376	2129389	ACCGGC	13	-	2	GCCGGT
gi|514486632|gb|KE346360.1|	2130087	2130100	AGCG	13	+	3	GAGC
gi|514486632|gb|KE346360.1|	2130969	2130983	AGCGGC	14	-	2	GCTGCC
gi|514486632|gb|KE346360.1|	2131128	2131155	A	27	+	27	A
gi|514486632|gb|KE346360.1|	2131674	2131689	AAAC	15	+	3	AAAC
gi|514486632|gb|KE346360.1|	2131807	2131828	AG	21	+	10	AG
gi|514486632|gb|KE346360.1|	2132686	2132777	AAAC	91	+	22	AAAC
gi|514486632|gb|KE346360.1|	2132774	2132788	AAAAAT	14	+	2	AAATAA
gi|514486632|gb|KE346360.1|	2132981	2132993	AAAACC	12	+	2	ACCAAA
gi|514486632|gb|KE346360.1|	2132990	2133002	AAAAAG	12	+	2	AAAGAA
gi|514486632|gb|KE346360.1|	2133368	2133380	ACCGAG	12	-	2	GGTCTC
gi|514486632|gb|KE346360.1|	2134863	2134878	AGCGGC	15	+	2	GCGGCA
gi|514486632|gb|KE346360.1|	2136227	2136239	AAC	12	-	4	TTG
gi|514486632|gb|KE346360.1|	2136351	2136367	AGCGGC	16	+	2	CGGCAG
gi|514486632|gb|KE346360.1|	2136429	2136441	AACGGC	12	-	2	CCGTTG
gi|514486632|gb|KE346360.1|	2136854	2136867	ACAGCG	13	-	2	TCGCTG
gi|514486632|gb|KE346360.1|	2137243	2137255	CCG	12	+	4	CGC
gi|514486632|gb|KE346360.1|	2137461	2137474	AGCCGC	13	-	2	CGGCTG
gi|514486632|gb|KE346360.1|	2137532	2137544	AGC	12	+	4	GCA
gi|514486632|gb|KE346360.1|	2137860	2137876	AGC	16	+	5	CAG
gi|514486632|gb|KE346360.1|	2138610	2138635	A	25	+	25	A
gi|514486632|gb|KE346360.1|	2138989	2139003	AAT	14	+	4	AAT
gi|514486632|gb|KE346360.1|	2138998	2139010	AAAAAT	12	+	2	AATAAA
gi|514486632|gb|KE346360.1|	2139007	2139020	AAAAT	13	+	2	AAATA
gi|514486632|gb|KE346360.1|	2139051	2139073	A	22	+	22	A
gi|514486632|gb|KE346360.1|	2139189	2139208	CCCCCG	19	-	3	GCGGGG
gi|514486632|gb|KE346360.1|	2139324	2139336	AGGCGC	12	+	2	GCGCAG
gi|514486632|gb|KE346360.1|	2139442	2139458	A	16	+	16	A
gi|514486632|gb|KE346360.1|	2139453	2139465	AAAAAG	12	+	2	AAAAAG
gi|514486632|gb|KE346360.1|	2140295	2140308	A	13	+	13	A
gi|514486632|gb|KE346360.1|	2141789	2141801	AAAGCC	12	+	2	CAAAGC
gi|514486632|gb|KE346360.1|	2142334	2142346	ACTGG	12	+	2	TGGAC
gi|514486632|gb|KE346360.1|	2142405	2142417	AACTCG	12	-	2	TTCGAG
gi|514486632|gb|KE346360.1|	2143268	2143285	AC	17	+	8	AC
gi|514486632|gb|KE346360.1|	2143284	2143297	A	13	+	13	A
gi|514486632|gb|KE346360.1|	2143344	2143356	AACAGC	12	+	2	AGCAAC
gi|514486632|gb|KE346360.1|	2144613	2144625	ACG	12	+	4	CGA
gi|514486632|gb|KE346360.1|	2144869	2144881	AGCGGC	12	+	2	GCAGCG
gi|514486632|gb|KE346360.1|	2144942	2144959	AACAGC	17	+	2	CAACAG
gi|514486632|gb|KE346360.1|	2145037	2145052	ACG	15	+	5	ACG
gi|514486632|gb|KE346360.1|	2145212	2145233	A	21	+	21	A
gi|514486632|gb|KE346360.1|	2145527	2145547	AG	20	+	10	GA
gi|514486632|gb|KE346360.1|	2145691	2145703	AATGAC	12	+	2	ACAATG
gi|514486632|gb|KE346360.1|	2146895	2146907	AAAC	12	+	3	CAAA
gi|514486632|gb|KE346360.1|	2146901	2146914	AAAAC	13	+	2	AACAA
gi|514486632|gb|KE346360.1|	2146908	2146920	AAAACC	12	+	2	CAAAAC
gi|514486632|gb|KE346360.1|	2147038	2147050	ACGTCG	12	+	2	CGACGT
gi|514486632|gb|KE346360.1|	2147854	2147867	AAAAAC	13	+	2	AAACAA
gi|514486632|gb|KE346360.1|	2147861	2147915	AAAC	54	+	13	AACA
gi|514486632|gb|KE346360.1|	2147912	2147924	A	12	+	12	A
gi|514486632|gb|KE346360.1|	2148515	2148529	A	14	+	14	A
gi|514486632|gb|KE346360.1|	2148524	2148539	AAAAAC	15	+	2	AAAAAC
gi|514486632|gb|KE346360.1|	2149114	2149126	AACAGC	12	+	2	CAACAG
gi|514486632|gb|KE346360.1|	2149457	2149479	A	22	+	22	A
gi|514486632|gb|KE346360.1|	2149550	2149573	A	23	+	23	A
gi|514486632|gb|KE346360.1|	2151084	2151096	AACC	12	+	3	CAAC
gi|514486632|gb|KE346360.1|	2151965	2151981	ACTCCC	16	+	2	CTCCCA
gi|514486632|gb|KE346360.1|	2152079	2152096	A	17	+	17	A
gi|514486632|gb|KE346360.1|	2153115	2153139	A	24	-	24	T
gi|514486632|gb|KE346360.1|	2153322	2153340	A	18	-	18	T
gi|514486632|gb|KE346360.1|	2153542	2153580	A	38	-	38	T
gi|514486632|gb|KE346360.1|	2154439	2154451	ACTGG	12	+	2	GACTG
gi|514486632|gb|KE346360.1|	2154984	2154997	A	13	+	13	A
gi|514486632|gb|KE346360.1|	2155436	2155451	AAAGC	15	+	3	GCAAA
gi|514486632|gb|KE346360.1|	2155456	2155468	AAAAAC	12	+	2	AACAAA
gi|514486632|gb|KE346360.1|	2155462	2155488	AAAC	26	+	6	AACA
gi|514486632|gb|KE346360.1|	2155485	2155503	A	18	+	18	A
gi|514486632|gb|KE346360.1|	2155506	2155519	AAAC	13	+	3	CAAA
gi|514486632|gb|KE346360.1|	2155741	2155756	AAAGTC	15	+	2	TCAAAG
gi|514486632|gb|KE346360.1|	2156599	2156613	AGAGCG	14	+	2	AGCGAG
gi|514486632|gb|KE346360.1|	2156608	2156620	AG	12	+	6	GA
gi|514486632|gb|KE346360.1|	2157515	2157531	ACCCAG	16	+	2	CCAGAC
gi|514486632|gb|KE346360.1|	2157572	2157606	ACAGTC	34	-	5	GACTGT
gi|514486632|gb|KE346360.1|	2157855	2157924	AC	69	+	34	CA
gi|514486632|gb|KE346360.1|	2158518	2158530	ACCAGC	12	-	2	TGCTGG
gi|514486632|gb|KE346360.1|	2159787	2159799	AGC	12	+	4	GCA
gi|514486632|gb|KE346360.1|	2160106	2160119	A	13	+	13	A
gi|514486632|gb|KE346360.1|	2161162	2161175	ACCGAG	13	-	2	GTCTCG
gi|514486632|gb|KE346360.1|	2162283	2162301	AAC	18	+	6	AAC
gi|514486632|gb|KE346360.1|	2163050	2163072	A	22	-	22	T
gi|514486632|gb|KE346360.1|	2163677	2163694	ACCCCC	17	+	2	CCCCCA
gi|514486632|gb|KE346360.1|	2163702	2163716	AAAAAG	14	+	2	GAAAAA
gi|514486632|gb|KE346360.1|	2164315	2164327	C	12	-	12	G
gi|514486632|gb|KE346360.1|	2164615	2164627	A	12	+	12	A
gi|514486632|gb|KE346360.1|	2165071	2165090	A	19	+	19	A
gi|514486632|gb|KE346360.1|	2165089	2165103	ACTCTG	14	-	2	AGAGTC
gi|514486632|gb|KE346360.1|	2165890	2165904	A	14	+	14	A
gi|514486632|gb|KE346360.1|	2165932	2165944	AATACG	12	+	2	ACGAAT
gi|514486632|gb|KE346360.1|	2166105	2166121	ACG	16	-	5	CGT
gi|514486632|gb|KE346360.1|	2166148	2166161	ACG	13	+	4	GAC
gi|514486632|gb|KE346360.1|	2166452	2166464	AAACCG	12	+	2	GAAACC
gi|514486632|gb|KE346360.1|	2166465	2166483	A	18	+	18	A
gi|514486632|gb|KE346360.1|	2168102	2168115	ACGCCG	13	-	2	GTCGGC
gi|514486632|gb|KE346360.1|	2170862	2170876	ACACGT	14	+	2	GTACAC
gi|514486632|gb|KE346360.1|	2171537	2171549	AAAAAC	12	+	2	AAAAAC
gi|514486632|gb|KE346360.1|	2171712	2171727	A	15	-	15	T
gi|514486632|gb|KE346360.1|	2171735	2171752	AAAAAC	17	-	2	TTTTTG
gi|514486632|gb|KE346360.1|	2172335	2172348	A	13	-	13	T
gi|514486632|gb|KE346360.1|	2172364	2172377	AAAAC	13	-	2	TTTTG
gi|514486632|gb|KE346360.1|	2172993	2173005	AAG	12	-	4	TTC
gi|514486632|gb|KE346360.1|	2173065	2173077	AAAAC	12	-	2	TTTTG
gi|514486632|gb|KE346360.1|	2173313	2173325	AG	12	+	6	GA
gi|514486632|gb|KE346360.1|	2173559	2173571	ACTC	12	+	3	CTCA
gi|514486632|gb|KE346360.1|	2173615	2173633	ACTCTC	18	+	3	CACTCT
gi|514486632|gb|KE346360.1|	2174223	2174237	ACGCCG	14	+	2	CGCCGA
gi|514486632|gb|KE346360.1|	2174390	2174421	AAAC	31	-	7	TTTG
gi|514486632|gb|KE346360.1|	2174893	2174906	ACACAG	13	-	2	TCTGTG
gi|514486632|gb|KE346360.1|	2175389	2175404	AGCGGC	15	-	2	CCGCTG
gi|514486632|gb|KE346360.1|	2176840	2176852	AAATTC	12	+	2	TTCAAA
gi|514486632|gb|KE346360.1|	2177728	2177740	AACCAC	12	-	2	GTTGTG
gi|514486632|gb|KE346360.1|	2178333	2178346	ACGGCG	13	+	2	ACGGCG
gi|514486632|gb|KE346360.1|	2178611	2178623	AACGG	12	+	2	AACGG
gi|514486632|gb|KE346360.1|	2179438	2179463	AAC	25	-	8	TTG
gi|514486632|gb|KE346360.1|	2179466	2179492	AGC	26	-	8	TGC
gi|514486632|gb|KE346360.1|	2179799	2179811	AATGCC	12	+	2	ATGCCA
gi|514486632|gb|KE346360.1|	2180469	2180488	ACGAGG	19	+	3	GAGGAC
gi|514486632|gb|KE346360.1|	2180603	2180616	CCCCG	13	-	2	CGGGG
gi|514486632|gb|KE346360.1|	2180625	2180637	C	12	-	12	G
gi|514486632|gb|KE346360.1|	2180957	2180969	AGCATC	12	-	2	GATGCT
gi|514486632|gb|KE346360.1|	2181372	2181391	A	19	-	19	T
gi|514486632|gb|KE346360.1|	2181615	2181627	AGC	12	+	4	CAG
gi|514486632|gb|KE346360.1|	2181697	2181723	AGC	26	+	8	CAG
gi|514486632|gb|KE346360.1|	2182436	2182458	AC	22	-	11	TG
gi|514486632|gb|KE346360.1|	2182568	2182580	AAACC	12	-	2	TTTGG
gi|514486632|gb|KE346360.1|	2183054	2183068	AAAAAC	14	-	2	TTGTTT
gi|514486632|gb|KE346360.1|	2183083	2183095	AAAGCG	12	-	2	TCGCTT
gi|514486632|gb|KE346360.1|	2183512	2183524	AACTAC	12	-	2	GTTGTA
gi|514486632|gb|KE346360.1|	2183560	2183572	AAAAAG	12	-	2	TTTTTC
gi|514486632|gb|KE346360.1|	2184775	2184788	AAC	13	+	4	AAC
gi|514486632|gb|KE346360.1|	2185671	2185683	AATCGC	12	-	2	CGATTG
gi|514486632|gb|KE346360.1|	2186216	2186231	AAAAAG	15	+	2	AAAGAA
gi|514486632|gb|KE346360.1|	2186853	2186881	A	28	+	28	A
gi|514486632|gb|KE346360.1|	2187959	2187972	ACTCGG	13	+	2	ACTCGG
gi|514486632|gb|KE346360.1|	2189826	2189846	ACG	20	+	6	CGA
gi|514486632|gb|KE346360.1|	2190743	2190756	A	13	-	13	T
gi|514486632|gb|KE346360.1|	2191033	2191050	A	17	+	17	A
gi|514486632|gb|KE346360.1|	2191225	2191250	A	25	+	25	A
gi|514486632|gb|KE346360.1|	2191281	2191301	A	20	-	20	T
gi|514486632|gb|KE346360.1|	2191305	2191322	AACTG	17	-	3	TCAGT
gi|514486632|gb|KE346360.1|	2191886	2191898	AC	12	-	6	TG
gi|514486632|gb|KE346360.1|	2193928	2193940	ACCGCG	12	-	2	GTCGCG
gi|514486632|gb|KE346360.1|	2194633	2194653	A	20	+	20	A
gi|514486632|gb|KE346360.1|	2196054	2196068	AGCCGC	14	+	2	CGCAGC
gi|514486632|gb|KE346360.1|	2196319	2196332	AAACC	13	+	2	ACCAA
gi|514486632|gb|KE346360.1|	2197221	2197235	AGATGG	14	+	2	TGGAGA
gi|514486632|gb|KE346360.1|	2198185	2198200	AGCCGC	15	+	2	CGCAGC
gi|514486632|gb|KE346360.1|	2200461	2200474	AACAC	13	+	2	AACAC
gi|514486632|gb|KE346360.1|	2200698	2200721	AAGTGC	23	+	3	GCAAGT
gi|514486632|gb|KE346360.1|	2200738	2200752	AGC	14	+	4	GCA
gi|514486632|gb|KE346360.1|	2201491	2201504	AAGTAC	13	+	2	CAAGTA
gi|514486632|gb|KE346360.1|	2201534	2201619	AC	85	-	42	GT
gi|514486632|gb|KE346360.1|	2201616	2201628	ACCGCC	12	-	2	GTGGCG
gi|514486632|gb|KE346360.1|	2201933	2201946	A	13	-	13	T
gi|514486632|gb|KE346360.1|	2201941	2201953	AAAAAC	12	-	2	TTTTTG
gi|514486632|gb|KE346360.1|	2202437	2202449	AATGTC	12	-	2	TTGACA
gi|514486632|gb|KE346360.1|	2202818	2202837	A	19	-	19	T
gi|514486632|gb|KE346360.1|	2202835	2202850	AACAGC	15	-	2	TTGCTG
gi|514486632|gb|KE346360.1|	2203176	2203188	A	12	+	12	A
gi|514486632|gb|KE346360.1|	2205260	2205272	ACGAG	12	-	2	GTCTC
gi|514486632|gb|KE346360.1|	2205943	2205956	AAC	13	+	4	CAA
gi|514486632|gb|KE346360.1|	2205959	2205987	ACG	28	+	9	CGA
gi|514486632|gb|KE346360.1|	2206280	2206292	AGGGGG	12	+	2	GGGGGA
gi|514486632|gb|KE346360.1|	2206600	2206616	A	16	+	16	A
gi|514486632|gb|KE346360.1|	2206771	2206797	A	26	+	26	A
gi|514486632|gb|KE346360.1|	2207021	2207034	AGGG	13	+	3	GGGA
gi|514486632|gb|KE346360.1|	2207254	2207266	AAAAAC	12	-	2	GTTTTT
gi|514486632|gb|KE346360.1|	2207268	2207291	AAAAAT	23	-	3	TTTTTA
gi|514486632|gb|KE346360.1|	2207330	2207343	ACAGCC	13	+	2	CAGCCA
gi|514486632|gb|KE346360.1|	2208533	2208546	ACATGG	13	+	2	GACATG
gi|514486632|gb|KE346360.1|	2209261	2209274	AAAATG	13	+	2	AATGAA
gi|514486632|gb|KE346360.1|	2210708	2210720	AGCGCG	12	-	2	CGCTCG
gi|514486632|gb|KE346360.1|	2212202	2212214	AGCTCG	12	+	2	AGCTCG
gi|514486632|gb|KE346360.1|	2212663	2212675	AGAGCC	12	+	2	GCCAGA
gi|514486632|gb|KE346360.1|	2212949	2212971	AAC	22	+	7	AAC
gi|514486632|gb|KE346360.1|	2213334	2213347	AGC	13	-	4	TGC
gi|514486632|gb|KE346360.1|	2213582	2213594	ACCCTC	12	-	2	GTGAGG
gi|514486632|gb|KE346360.1|	2213667	2213682	ACCC	15	-	3	TGGG
gi|514486632|gb|KE346360.1|	2215483	2215497	AGCAGG	14	+	2	AGCAGG
gi|514486632|gb|KE346360.1|	2215933	2215946	AATGTC	13	+	2	AATGTC
gi|514486632|gb|KE346360.1|	2215951	2215969	AATGGG	18	+	3	AATGGG
gi|514486632|gb|KE346360.1|	2216294	2216313	AGCTCC	19	+	3	CTCCAG
gi|514486632|gb|KE346360.1|	2216313	2216327	AATACC	14	+	2	ACCAAT
gi|514486632|gb|KE346360.1|	2216532	2216544	AAAAGC	12	+	2	AGCAAA
gi|514486632|gb|KE346360.1|	2218269	2218282	AACAGC	13	-	2	TGCTGT
gi|514486632|gb|KE346360.1|	2218316	2218360	AGC	44	-	14	CTG
gi|514486632|gb|KE346360.1|	2220407	2220419	AGCGC	12	-	2	GCGCT
gi|514486632|gb|KE346360.1|	2221092	2221104	AAGTGC	12	-	2	CACTTG
gi|514486632|gb|KE346360.1|	2221195	2221214	A	19	-	19	T
gi|514486632|gb|KE346360.1|	2221555	2221567	A	12	-	12	T
gi|514486632|gb|KE346360.1|	2221570	2221584	AAAAAG	14	-	2	TTTTTC
gi|514486632|gb|KE346360.1|	2221582	2221594	AAAAG	12	-	2	TTCTT
gi|514486632|gb|KE346360.1|	2221590	2221604	A	14	-	14	T
gi|514486632|gb|KE346360.1|	2221784	2221803	A	19	+	19	A
gi|514486632|gb|KE346360.1|	2221992	2222007	A	15	+	15	A
gi|514486632|gb|KE346360.1|	2222011	2222024	AAATG	13	+	2	AAATG
gi|514486632|gb|KE346360.1|	2222018	2222035	AAAATG	17	+	2	ATGAAA
gi|514486632|gb|KE346360.1|	2222042	2222071	A	29	-	29	T
gi|514486632|gb|KE346360.1|	2222237	2222258	AAG	21	-	7	TTC
gi|514486632|gb|KE346360.1|	2222334	2222347	AAG	13	-	4	TCT
gi|514486632|gb|KE346360.1|	2222346	2222362	AC	16	-	8	TG
gi|514486632|gb|KE346360.1|	2222498	2222511	ACGCCG	13	-	2	CGTCGG
gi|514486632|gb|KE346360.1|	2223357	2223372	AGCGGG	15	+	2	GGGAGC
gi|514486632|gb|KE346360.1|	2223666	2223679	ACTCGC	13	+	2	CACTCG
gi|514486632|gb|KE346360.1|	2225238	2225275	ACG	37	+	12	ACG
gi|514486632|gb|KE346360.1|	2225401	2225414	ATCCGC	13	+	2	CATCCG
gi|514486632|gb|KE346360.1|	2225732	2225744	ACTGGG	12	-	2	CAGTCC
gi|514486632|gb|KE346360.1|	2226028	2226050	AAAC	22	-	5	TTGT
gi|514486632|gb|KE346360.1|	2226990	2227002	AGAGAT	12	+	2	TAGAGA
gi|514486632|gb|KE346360.1|	2228833	2228846	A	13	-	13	T
gi|514486632|gb|KE346360.1|	2228871	2228890	AAAC	19	-	4	TTTG
gi|514486632|gb|KE346360.1|	2229480	2229494	ACACC	14	+	2	CACCA
gi|514486632|gb|KE346360.1|	2229749	2229764	AAAAAC	15	-	2	TTTTGT
gi|514486632|gb|KE346360.1|	2230205	2230218	AAAAAC	13	-	2	TGTTTT
gi|514486632|gb|KE346360.1|	2230250	2230270	A	20	-	20	T
gi|514486632|gb|KE346360.1|	2231035	2231050	A	15	-	15	T
gi|514486632|gb|KE346360.1|	2231795	2231811	ATC	16	-	5	ATG
gi|514486632|gb|KE346360.1|	2232099	2232111	ACCAGC	12	-	2	GTGCTG
gi|514486632|gb|KE346360.1|	2232933	2232945	AGAGCC	12	-	2	TCTGGC
gi|514486632|gb|KE346360.1|	2233028	2233048	AGG	20	-	6	CTC
gi|514486632|gb|KE346360.1|	2233358	2233380	ACG	22	-	7	TCG
gi|514486632|gb|KE346360.1|	2234120	2234132	AACAGC	12	-	2	GTTGCT
gi|514486632|gb|KE346360.1|	2234312	2234332	A	20	-	20	T
gi|514486632|gb|KE346360.1|	2234979	2234999	A	20	+	20	A
gi|514486632|gb|KE346360.1|	2235696	2235709	AG	13	+	6	AG
gi|514486632|gb|KE346360.1|	2235708	2235720	AC	12	+	6	AC
gi|514486632|gb|KE346360.1|	2235816	2235836	A	20	+	20	A
gi|514486632|gb|KE346360.1|	2235914	2235927	ACCAG	13	+	2	AGACC
gi|514486632|gb|KE346360.1|	2236025	2236038	A	13	-	13	T
gi|514486632|gb|KE346360.1|	2236076	2236095	A	19	-	19	T
gi|514486632|gb|KE346360.1|	2236464	2236477	AG	13	-	6	TC
gi|514486632|gb|KE346360.1|	2236577	2236590	ACGCTG	13	+	2	GACGCT
gi|514486632|gb|KE346360.1|	2236714	2236726	AAACTC	12	-	2	AGTTTG
gi|514486632|gb|KE346360.1|	2237361	2237375	AAAAAG	14	-	2	TTTTCT
gi|514486632|gb|KE346360.1|	2237472	2237486	AAGG	14	-	3	TTCC
gi|514486632|gb|KE346360.1|	2238682	2238694	AAGCCC	12	+	2	CAAGCC
gi|514486632|gb|KE346360.1|	2238824	2238837	AGC	13	+	4	GCA
gi|514486632|gb|KE346360.1|	2238911	2238931	AGC	20	+	6	GCA
gi|514486632|gb|KE346360.1|	2239041	2239060	ACCTGC	19	+	3	CACCTG
gi|514486632|gb|KE346360.1|	2239254	2239273	AAAC	19	-	4	TTGT
gi|514486632|gb|KE346360.1|	2239268	2239281	AAACGC	13	-	2	GTTTGC
gi|514486632|gb|KE346360.1|	2239674	2239688	AAATC	14	-	2	GATTT
gi|514486632|gb|KE346360.1|	2239779	2239791	A	12	-	12	T
gi|514486632|gb|KE346360.1|	2240097	2240110	AAGATC	13	-	2	TGATCT
gi|514486632|gb|KE346360.1|	2240380	2240392	ACGAGG	12	+	2	CGAGGA
gi|514486632|gb|KE346360.1|	2241343	2241355	AACAC	12	-	2	TTGTG
gi|514486632|gb|KE346360.1|	2241527	2241539	A	12	-	12	T
gi|514486632|gb|KE346360.1|	2241564	2241577	A	13	-	13	T
gi|514486632|gb|KE346360.1|	2242214	2242226	AACAGC	12	-	2	TTGCTG
gi|514486632|gb|KE346360.1|	2242668	2242690	A	22	-	22	T
gi|514486632|gb|KE346360.1|	2243053	2243066	AAACCG	13	-	2	GGTTTC
gi|514486632|gb|KE346360.1|	2243291	2243321	AAGACG	30	+	5	ACGAAG
gi|514486632|gb|KE346360.1|	2243320	2243337	AGGGCG	17	+	2	GGCGAG
gi|514486632|gb|KE346360.1|	2243808	2243821	ACCTGC	13	+	2	CTGCAC
gi|514486632|gb|KE346360.1|	2244376	2244392	AACAC	16	-	3	TGTTG
gi|514486632|gb|KE346360.1|	2245919	2245932	AAAAAG	13	+	2	AAAAAG
gi|514486632|gb|KE346360.1|	2246363	2246375	AAAAC	12	+	2	AACAA
gi|514486632|gb|KE346360.1|	2247063	2247076	ACATGT	13	+	2	GTACAT
gi|514486632|gb|KE346360.1|	2247162	2247175	AACC	13	+	3	CCAA
gi|514486632|gb|KE346360.1|	2248712	2248724	AACAAT	12	+	2	CAATAA
gi|514486632|gb|KE346360.1|	2249067	2249081	A	14	+	14	A
gi|514486632|gb|KE346360.1|	2249276	2249288	AAGGCC	12	-	2	CCTTGG
gi|514486632|gb|KE346360.1|	2249769	2249783	A	14	+	14	A
gi|514486632|gb|KE346360.1|	2249953	2249965	AAAAAG	12	+	2	GAAAAA
gi|514486632|gb|KE346360.1|	2250076	2250090	AACCC	14	+	2	CAACC
gi|514486632|gb|KE346360.1|	2250431	2250444	AACATC	13	+	2	AACATC
gi|514486632|gb|KE346360.1|	2250511	2250523	AAAAAC	12	+	2	CAAAAA
gi|514486632|gb|KE346360.1|	2250518	2250532	A	14	+	14	A
gi|514486632|gb|KE346360.1|	2250739	2250751	A	12	+	12	A
gi|514486632|gb|KE346360.1|	2250748	2250761	AAACC	13	+	2	AAACC
gi|514486632|gb|KE346360.1|	2251090	2251106	AAAAAC	16	+	2	AAAAAC
gi|514486632|gb|KE346360.1|	2251155	2251173	A	18	+	18	A
gi|514486632|gb|KE346360.1|	2251194	2251206	AAAAAG	12	-	2	TTTTTC
gi|514486632|gb|KE346360.1|	2251402	2251432	A	30	+	30	A
gi|514486632|gb|KE346360.1|	2251796	2251813	AAAAAG	17	+	2	AAAAAG
gi|514486632|gb|KE346360.1|	2251808	2251820	A	12	+	12	A
gi|514486632|gb|KE346360.1|	2251846	2251858	AAAAAT	12	+	2	AATAAA
gi|514486632|gb|KE346360.1|	2251856	2251868	AACC	12	+	3	AACC
gi|514486632|gb|KE346360.1|	2252027	2252044	A	17	+	17	A
gi|514486632|gb|KE346360.1|	2252242	2252266	A	24	-	24	T
gi|514486632|gb|KE346360.1|	2252442	2252458	A	16	-	16	T
gi|514486632|gb|KE346360.1|	2252472	2252489	A	17	-	17	T
gi|514486632|gb|KE346360.1|	2252980	2252992	A	12	-	12	T
gi|514486632|gb|KE346360.1|	2253333	2253346	AAGTAC	13	+	2	CAAGTA
gi|514486632|gb|KE346360.1|	2254046	2254058	AAACG	12	-	2	TTCGT
gi|514486632|gb|KE346360.1|	2254214	2254226	AGAGCG	12	+	2	GAGAGC
gi|514486632|gb|KE346360.1|	2254392	2254404	AAAAAC	12	-	2	TTTGTT
gi|514486632|gb|KE346360.1|	2255603	2255621	AGC	18	+	6	GCA
gi|514486632|gb|KE346360.1|	2255747	2255759	AGAGCG	12	+	2	GAGCGA
gi|514486632|gb|KE346360.1|	2256187	2256200	AC	13	+	6	CA
gi|514486632|gb|KE346360.1|	2256211	2256223	AAAC	12	+	3	AACA
gi|514486632|gb|KE346360.1|	2256242	2256256	A	14	+	14	A
gi|514486632|gb|KE346360.1|	2256285	2256298	AACATC	13	+	2	CAACAT
gi|514486632|gb|KE346360.1|	2257482	2257498	AAAAC	16	+	3	ACAAA
gi|514486632|gb|KE346360.1|	2257492	2257505	AAAAAC	13	+	2	ACAAAA
gi|514486632|gb|KE346360.1|	2257567	2257579	AACC	12	+	3	CAAC
gi|514486632|gb|KE346360.1|	2259265	2259279	AAGGAC	14	-	2	TCCTTG
gi|514486632|gb|KE346360.1|	2259303	2259336	AGCAGG	33	-	5	TGCTCC
gi|514486632|gb|KE346360.1|	2259734	2259748	ACTGAG	14	-	2	TCAGTC
gi|514486632|gb|KE346360.1|	2259760	2259773	ACTGAG	13	-	2	TCAGTC
gi|514486632|gb|KE346360.1|	2260281	2260295	AGGATG	14	+	2	GAGGAT
gi|514486632|gb|KE346360.1|	2260451	2260463	AGGGGG	12	+	2	GAGGGG
gi|514486632|gb|KE346360.1|	2261546	2261558	AACCAG	12	+	2	CCAGAA
gi|514486632|gb|KE346360.1|	2261616	2261632	ACCCCG	16	+	2	CCCCGA
gi|514486632|gb|KE346360.1|	2261735	2261747	ACGAGT	12	+	2	AGTACG
gi|514486632|gb|KE346360.1|	2261797	2261815	AAAAC	18	-	3	TTTTG
gi|514486632|gb|KE346360.1|	2262545	2262559	AAC	14	-	4	TTG
gi|514486632|gb|KE346360.1|	2263366	2263378	AAACG	12	-	2	TTCGT
gi|514486632|gb|KE346360.1|	2263819	2263847	A	28	-	28	T
gi|514486632|gb|KE346360.1|	2263886	2263898	AAAAAC	12	-	2	TTTGTT
gi|514486632|gb|KE346360.1|	2264174	2264191	ATCGCC	17	-	2	GGCGAT
gi|514486632|gb|KE346360.1|	2264210	2264222	ACCATG	12	+	2	CATGAC
gi|514486632|gb|KE346360.1|	2264592	2264604	AAG	12	-	4	CTT
gi|514486632|gb|KE346360.1|	2264654	2264667	AGCGCC	13	-	2	TGGCGC
gi|514486632|gb|KE346360.1|	2265813	2265825	AAAGGG	12	-	2	CCCTTT
gi|514486632|gb|KE346360.1|	2266051	2266063	CCG	12	+	4	GCC
gi|514486632|gb|KE346360.1|	2266308	2266322	ACGCT	14	+	2	CTACG
gi|514486632|gb|KE346360.1|	2266492	2266504	A	12	-	12	T
gi|514486632|gb|KE346360.1|	2266656	2266679	AC	23	+	11	AC
gi|514486632|gb|KE346360.1|	2267593	2267605	ATC	12	+	4	CAT
gi|514486632|gb|KE346360.1|	2268001	2268013	AATCC	12	-	2	GATTG
gi|514486632|gb|KE346360.1|	2268081	2268095	ACTG	14	-	3	AGTC
gi|514486632|gb|KE346360.1|	2268225	2268247	A	22	+	22	A
gi|514486632|gb|KE346360.1|	2268328	2268354	AACGAC	26	+	4	ACAACG
gi|514486632|gb|KE346360.1|	2268901	2268916	CCG	15	-	5	GGC
gi|514486632|gb|KE346360.1|	2269065	2269080	ATGCCC	15	-	2	GGCATG
gi|514486632|gb|KE346360.1|	2269729	2269741	AACAGC	12	-	2	TGTTGC
gi|514486632|gb|KE346360.1|	2270508	2270525	ACTCGG	17	-	2	AGTCCG
gi|514486632|gb|KE346360.1|	2270547	2270559	AATCC	12	+	2	AATCC
gi|514486632|gb|KE346360.1|	2270678	2270691	AAAC	13	+	3	AAAC
gi|514486632|gb|KE346360.1|	2271091	2271104	A	13	-	13	T
gi|514486632|gb|KE346360.1|	2274345	2274358	AAACCG	13	-	2	GTTTCG
gi|514486632|gb|KE346360.1|	2275381	2275393	C	12	-	12	G
gi|514486632|gb|KE346360.1|	2276355	2276367	ACTGCT	12	-	2	AGTAGC
gi|514486632|gb|KE346360.1|	2276433	2276448	AGC	15	+	5	GCA
gi|514486632|gb|KE346360.1|	2276556	2276570	AGC	14	+	4	CAG
gi|514486632|gb|KE346360.1|	2276704	2276716	ACTGAG	12	-	2	CTCAGT
gi|514486632|gb|KE346360.1|	2277185	2277197	AGCGCG	12	+	2	CGCGAG
gi|514486632|gb|KE346360.1|	2277413	2277436	ACG	23	-	7	TCG
gi|514486632|gb|KE346360.1|	2278098	2278117	AC	19	+	9	AC
gi|514486632|gb|KE346360.1|	2278790	2278802	AAGG	12	+	3	GGAA
gi|514486632|gb|KE346360.1|	2278869	2278884	ACAGCG	15	+	2	GACAGC
gi|514486632|gb|KE346360.1|	2278899	2278911	AGCTCG	12	+	2	CGAGCT
gi|514486632|gb|KE346360.1|	2279721	2279733	AAAGCC	12	+	2	GCCAAA
gi|514486632|gb|KE346360.1|	2280399	2280411	AGCGGC	12	+	2	GGCAGC
gi|514486632|gb|KE346360.1|	2280975	2280990	AAAAAC	15	+	2	AAAACA
gi|514486632|gb|KE346360.1|	2280991	2281003	AAAAAC	12	+	2	CAAAAA
gi|514486632|gb|KE346360.1|	2281018	2281031	AATGAC	13	-	2	GTCATT
gi|514486632|gb|KE346360.1|	2281076	2281103	AAC	27	+	9	ACA
gi|514486632|gb|KE346360.1|	2281110	2281123	AACG	13	+	3	ACGA
gi|514486632|gb|KE346360.1|	2281117	2281129	AAACG	12	+	2	AACGA
gi|514486632|gb|KE346360.1|	2281159	2281174	A	15	+	15	A
gi|514486632|gb|KE346360.1|	2281355	2281367	AGG	12	+	4	GAG
gi|514486632|gb|KE346360.1|	2281622	2281635	AAAAG	13	+	2	AAAGA
gi|514486632|gb|KE346360.1|	2281631	2281652	A	21	+	21	A
gi|514486632|gb|KE346360.1|	2282897	2282910	ATCC	13	-	3	GATG
gi|514486632|gb|KE346360.1|	2283325	2283337	AACAAG	12	+	2	AGAACA
gi|514486632|gb|KE346360.1|	2283358	2283383	A	25	+	25	A
gi|514486632|gb|KE346360.1|	2283408	2283420	A	12	+	12	A
gi|514486632|gb|KE346360.1|	2283452	2283468	AAC	16	+	5	AAC
gi|514486632|gb|KE346360.1|	2283882	2283899	AAAC	17	+	4	CAAA
gi|514486632|gb|KE346360.1|	2285206	2285221	A	15	+	15	A
gi|514486632|gb|KE346360.1|	2285233	2285245	AAAAAG	12	+	2	AAGAAA
gi|514486632|gb|KE346360.1|	2285499	2285512	AATGAC	13	+	2	GACAAT
gi|514486632|gb|KE346360.1|	2286913	2286926	AGCGC	13	+	2	GCGCA
gi|514486632|gb|KE346360.1|	2287319	2287331	AAAAAC	12	-	2	TTTTTG
gi|514486632|gb|KE346360.1|	2287570	2287583	AAAGG	13	+	2	GGAAA
gi|514486632|gb|KE346360.1|	2287651	2287664	A	13	+	13	A
gi|514486632|gb|KE346360.1|	2288205	2288291	AG	86	+	43	GA
gi|514486632|gb|KE346360.1|	2288294	2288306	AAG	12	+	4	AAG
gi|514486632|gb|KE346360.1|	2290007	2290019	AAACTC	12	-	2	GTTTGA
gi|514486632|gb|KE346360.1|	2290365	2290377	AAAC	12	+	3	CAAA
gi|514486632|gb|KE346360.1|	2292048	2292062	AAAAT	14	+	2	AAAAT
gi|514486632|gb|KE346360.1|	2292168	2292187	AG	19	+	9	GA
gi|514486632|gb|KE346360.1|	2292186	2292205	AC	19	-	9	GT
gi|514486632|gb|KE346360.1|	2292741	2292766	A	25	+	25	A
gi|514486632|gb|KE346360.1|	2292768	2292793	A	25	+	25	A
gi|514486632|gb|KE346360.1|	2292824	2292837	AAAAAC	13	+	2	AAAACA
gi|514486632|gb|KE346360.1|	2293019	2293031	AACTGC	12	+	2	CTGCAA
gi|514486632|gb|KE346360.1|	2293638	2293661	AC	23	+	11	CA
gi|514486632|gb|KE346360.1|	2294214	2294226	ACTCGC	12	-	2	CGAGTG
gi|514486632|gb|KE346360.1|	2295244	2295256	ACGAGG	12	-	2	CTCGTC
gi|514486632|gb|KE346360.1|	2295719	2295734	AAATGG	15	-	2	ATTTCC
gi|514486632|gb|KE346360.1|	2296550	2296567	AC	17	+	8	CA
gi|514486632|gb|KE346360.1|	2297233	2297246	ACTATC	13	-	2	GATAGT
gi|514486632|gb|KE346360.1|	2298639	2298651	AAATAC	12	-	2	ATTTGT
gi|514486632|gb|KE346360.1|	2298675	2298687	ACACC	12	-	2	TGGTG
gi|514486632|gb|KE346360.1|	2298970	2298983	AAAAAG	13	-	2	TCTTTT
gi|514486632|gb|KE346360.1|	2299751	2299775	AG	24	+	12	AG
gi|514486632|gb|KE346360.1|	2299774	2299787	AC	13	-	6	GT
gi|514486632|gb|KE346360.1|	2299887	2299899	A	12	+	12	A
gi|514486632|gb|KE346360.1|	2300030	2300044	A	14	+	14	A
gi|514486632|gb|KE346360.1|	2301074	2301098	AAC	24	+	8	CAA
gi|514486632|gb|KE346360.1|	2301160	2301172	ACC	12	+	4	ACC
gi|514486632|gb|KE346360.1|	2301209	2301226	ACAGC	17	+	3	CACAG
gi|514486632|gb|KE346360.1|	2301542	2301560	A	18	+	18	A
gi|514486632|gb|KE346360.1|	2301733	2301757	A	24	-	24	T
gi|514486632|gb|KE346360.1|	2306215	2306227	AATGCG	12	+	2	AATGCG
gi|514486632|gb|KE346360.1|	2306545	2306557	AAAGAC	12	-	2	TTGTCT
gi|514486632|gb|KE346360.1|	2306723	2306737	AACGTC	14	-	2	TTGACG
gi|514486632|gb|KE346360.1|	2307548	2307560	ACGCCG	12	+	2	ACGCCG
gi|514486632|gb|KE346360.1|	2307920	2307932	ACCATG	12	+	2	CCATGA
gi|514486632|gb|KE346360.1|	2307934	2307946	ACCAGC	12	+	2	CAGCAC
gi|514486632|gb|KE346360.1|	2309050	2309199	AG	149	+	74	AG
gi|514486632|gb|KE346360.1|	2309730	2309854	AG	124	+	62	AG
gi|514486632|gb|KE346360.1|	2309871	2309961	AG	90	+	45	GA
gi|514486632|gb|KE346360.1|	2311438	2311451	AAGAC	13	+	2	GACAA
gi|514486632|gb|KE346360.1|	2312053	2312071	AG	18	+	9	GA
gi|514486632|gb|KE346360.1|	2312262	2312291	AG	29	-	14	CT
gi|514486632|gb|KE346360.1|	2312403	2312419	AGC	16	-	5	CTG
gi|514486632|gb|KE346360.1|	2312776	2312789	AGCCGC	13	+	2	CAGCCG
gi|514486632|gb|KE346360.1|	2313133	2313150	AGC	17	+	5	AGC
gi|514486632|gb|KE346360.1|	2313148	2313160	ACT	12	-	4	AGT
gi|514486632|gb|KE346360.1|	2313494	2313507	ACCAGC	13	-	2	GGTGCT
gi|514486632|gb|KE346360.1|	2313525	2313538	CCG	13	+	4	CCG
gi|514486632|gb|KE346360.1|	2313783	2313795	AAACAC	12	-	2	TGTTTG
gi|514486632|gb|KE346360.1|	2314311	2314323	AGCAGG	12	-	2	CTCCTG
gi|514486632|gb|KE346360.1|	2314928	2314940	AAATTC	12	-	2	TTGAAT
gi|514486632|gb|KE346360.1|	2315029	2315041	AATACC	12	-	2	TTGGTA
gi|514486632|gb|KE346360.1|	2315405	2315418	AATC	13	-	3	TTGA
gi|514486632|gb|KE346360.1|	2315415	2315431	ATCC	16	-	4	GATG
gi|514486632|gb|KE346360.1|	2315468	2315482	AAAAAC	14	+	2	AAAAAC
gi|514486632|gb|KE346360.1|	2317263	2317276	AGCCTC	13	-	2	GAGGCT
gi|514486632|gb|KE346360.1|	2317925	2317939	AAAAAG	14	-	2	TTCTTT
gi|514486632|gb|KE346360.1|	2318528	2318545	AACAAG	17	+	2	AACAAG
gi|514486632|gb|KE346360.1|	2319470	2319482	AGCGGC	12	-	2	TGCCGC
gi|514486632|gb|KE346360.1|	2319477	2319491	CCG	14	+	4	GCC
gi|514486632|gb|KE346360.1|	2319489	2319502	AGC	13	-	4	GCT
gi|514486632|gb|KE346360.1|	2319609	2319635	A	26	-	26	T
gi|514486632|gb|KE346360.1|	2320027	2320040	ACTCG	13	+	2	ACTCG
gi|514486632|gb|KE346360.1|	2320767	2320781	AACAGC	14	+	2	CAGCAA
gi|514486632|gb|KE346360.1|	2320785	2320802	AAC	17	+	5	CAA
gi|514486632|gb|KE346360.1|	2321540	2321554	ACGGCG	14	+	2	CGGCGA
gi|514486632|gb|KE346360.1|	2322379	2322391	AGCTC	12	-	2	GCTGA
gi|514486632|gb|KE346360.1|	2322514	2322526	AGATCC	12	-	2	TGGATC
gi|514486632|gb|KE346360.1|	2323984	2324003	AC	19	+	9	CA
gi|514486632|gb|KE346360.1|	2324004	2324023	AC	19	+	9	CA
gi|514486632|gb|KE346360.1|	2324092	2324106	AAAAAC	14	-	2	TTTGTT
gi|514486632|gb|KE346360.1|	2324393	2324405	ACTCCC	12	+	2	TCCCAC
gi|514486632|gb|KE346360.1|	2324512	2324529	AC	17	-	8	TG
gi|514486632|gb|KE346360.1|	2324620	2324633	AG	13	-	6	CT
gi|514486632|gb|KE346360.1|	2325383	2325395	ACGCTC	12	+	2	GCTCAC
gi|514486632|gb|KE346360.1|	2326095	2326112	AAC	17	-	5	TGT
gi|514486632|gb|KE346360.1|	2326368	2326386	AAAC	18	+	4	CAAA
gi|514486632|gb|KE346360.1|	2326658	2326670	ACGATG	12	-	2	GTCATC
gi|514486632|gb|KE346360.1|	2329460	2329472	ACGCGT	12	+	2	GTACGC
gi|514486632|gb|KE346360.1|	2330129	2330141	ACCATG	12	+	2	CATGAC
gi|514486632|gb|KE346360.1|	2330708	2330720	AAAGAC	12	+	2	AGACAA
gi|514486632|gb|KE346360.1|	2330718	2330734	AAAAAG	16	+	2	AAGAAA
gi|514486632|gb|KE346360.1|	2330895	2330907	ACAGAT	12	-	2	GTATCT
gi|514486632|gb|KE346360.1|	2330972	2330984	C	12	+	12	C
gi|514486632|gb|KE346360.1|	2331906	2331923	AAC	17	-	5	TGT
gi|514486632|gb|KE346360.1|	2331924	2331936	AAAAC	12	-	2	TTTGT
gi|514486632|gb|KE346360.1|	2333329	2333341	ACGCGG	12	-	2	GCGTCC
gi|514486632|gb|KE346360.1|	2335507	2335522	AGCG	15	-	3	CTCG
gi|514486632|gb|KE346360.1|	2335795	2335807	ACGCG	12	+	2	CGCGA
gi|514486632|gb|KE346360.1|	2336103	2336117	A	14	-	14	T
gi|514486632|gb|KE346360.1|	2336491	2336506	AACC	15	+	3	CAAC
gi|514486632|gb|KE346360.1|	2336504	2336521	AAAAC	17	+	3	AAACA
gi|514486632|gb|KE346360.1|	2337361	2337389	ACC	28	-	9	GTG
gi|514486632|gb|KE346360.1|	2337774	2337786	AGCTCG	12	+	2	TCGAGC
gi|514486632|gb|KE346360.1|	2338459	2338471	AAGCGG	12	+	2	GCGGAA
gi|514486632|gb|KE346360.1|	2338624	2338636	ACACAG	12	-	2	TGTCTG
gi|514486632|gb|KE346360.1|	2340234	2340258	A	24	-	24	T
gi|514486632|gb|KE346360.1|	2342711	2342729	AGC	18	-	6	TGC
gi|514486632|gb|KE346360.1|	2342814	2342831	AGCCGC	17	-	2	GCTGCG
gi|514486632|gb|KE346360.1|	2342831	2342843	AACAGC	12	-	2	TGCTGT
gi|514486632|gb|KE346360.1|	2342949	2342961	AGC	12	-	4	GCT
gi|514486632|gb|KE346360.1|	2343088	2343104	AAAGCC	16	+	2	AAGCCA
gi|514486632|gb|KE346360.1|	2343191	2343204	AAAGC	13	+	2	AAAGC
gi|514486632|gb|KE346360.1|	2343547	2343576	ATC	29	+	9	CAT
gi|514486632|gb|KE346360.1|	2343609	2343623	AGC	14	+	4	GCA
gi|514486632|gb|KE346360.1|	2343706	2343720	ACC	14	+	4	ACC
gi|514486632|gb|KE346360.1|	2343723	2343746	AGC	23	+	7	CAG
gi|514486632|gb|KE346360.1|	2343753	2343767	AACAGC	14	+	2	CAGCAA
gi|514486632|gb|KE346360.1|	2345726	2345741	AC	15	-	7	GT
gi|514486632|gb|KE346360.1|	2346432	2346445	AGC	13	-	4	CTG
gi|514486632|gb|KE346360.1|	2347361	2347374	AGCTGC	13	+	2	CAGCTG
gi|514486632|gb|KE346360.1|	2348022	2348038	AACC	16	-	4	GTTG
gi|514486632|gb|KE346360.1|	2348359	2348374	ACG	15	-	5	CGT
gi|514486632|gb|KE346360.1|	2348392	2348405	A	13	-	13	T
gi|514486632|gb|KE346360.1|	2348414	2348429	AAAAAG	15	-	2	TTTTTC
gi|514486632|gb|KE346360.1|	2348822	2348835	AGAGGG	13	-	2	CTCTCC
gi|514486632|gb|KE346360.1|	2348989	2349015	A	26	-	26	T
gi|514486632|gb|KE346360.1|	2349044	2349056	AAAGC	12	-	2	TTTGC
gi|514486632|gb|KE346360.1|	2349130	2349144	AAG	14	-	4	TTC
gi|514486632|gb|KE346360.1|	2349335	2349351	AAG	16	-	5	TTC
gi|514486632|gb|KE346360.1|	2349546	2349559	AAAAG	13	-	2	TTTTC
gi|514486632|gb|KE346360.1|	2350156	2350168	AACAGC	12	-	2	GCTGTT
gi|514486632|gb|KE346360.1|	2350352	2350364	AAAAGG	12	-	2	TTTTCC
gi|514486632|gb|KE346360.1|	2350571	2350583	AAAAAC	12	-	2	TTTTTG
gi|514486632|gb|KE346360.1|	2351335	2351347	AACAGC	12	+	2	CAGCAA
gi|514486632|gb|KE346360.1|	2351422	2351445	AGC	23	+	7	CAG
gi|514486632|gb|KE346360.1|	2351917	2351933	AAC	16	+	5	CAA
gi|514486632|gb|KE346360.1|	2351938	2351952	AACAGC	14	+	2	CAACAG
gi|514486632|gb|KE346360.1|	2351956	2351978	AGC	22	+	7	CAG
gi|514486632|gb|KE346360.1|	2352543	2352556	AAAAC	13	-	2	TGTTT
gi|514486632|gb|KE346360.1|	2352643	2352698	AAAC	55	-	13	TTTG
gi|514486632|gb|KE346360.1|	2352692	2352704	AAAAAC	12	-	2	TTGTTT
gi|514486632|gb|KE346360.1|	2354149	2354173	A	24	+	24	A
gi|514486632|gb|KE346360.1|	2354210	2354223	ACATGC	13	+	2	ACATGC
gi|514486632|gb|KE346360.1|	2354531	2354543	AAC	12	-	4	TTG
gi|514486632|gb|KE346360.1|	2355751	2355764	ACTGC	13	+	2	CACTG
gi|514486632|gb|KE346360.1|	2356833	2356845	AGGGGG	12	+	2	GGGGGA
gi|514486632|gb|KE346360.1|	2357193	2357206	ATGC	13	+	3	ATGC
gi|514486632|gb|KE346360.1|	2357810	2357825	AAAGAG	15	+	2	AAAGAG
gi|514486632|gb|KE346360.1|	2358062	2358074	AAAACG	12	-	2	CGTTTT
gi|514486632|gb|KE346360.1|	2358639	2358652	AAC	13	+	4	ACA
gi|514486632|gb|KE346360.1|	2358746	2358761	ACCGCC	15	+	2	GCCACC
gi|514486632|gb|KE346360.1|	2358897	2358910	ACCCCG	13	+	2	CGACCC
gi|514486632|gb|KE346360.1|	2358905	2358918	ACCCCC	13	+	2	ACCCCC
gi|514486632|gb|KE346360.1|	2358946	2358961	ACC	15	-	5	TGG
gi|514486632|gb|KE346360.1|	2359119	2359138	AGC	19	+	6	CAG
gi|514486632|gb|KE346360.1|	2359202	2359219	ACGAGG	17	-	2	TCCTCG
gi|514486632|gb|KE346360.1|	2359512	2359531	AC	19	+	9	CA
gi|514486632|gb|KE346360.1|	2360011	2360023	AAG	12	+	4	AGA
gi|514486632|gb|KE346360.1|	2360640	2360652	AGGCGG	12	-	2	CTCCGC
gi|514486632|gb|KE346360.1|	2360720	2360732	ACCGCC	12	-	2	GGTGGC
gi|514486632|gb|KE346360.1|	2362966	2362978	ACGAGG	12	+	2	GGACGA
gi|514486632|gb|KE346360.1|	2362976	2362990	ACGAGG	14	+	2	GACGAG
gi|514486632|gb|KE346360.1|	2364715	2364727	AATGGC	12	+	2	TGGCAA
gi|514486632|gb|KE346360.1|	2365768	2365781	ACCC	13	+	3	CCAC
gi|514486632|gb|KE346360.1|	2365972	2365990	A	18	-	18	T
gi|514486632|gb|KE346360.1|	2366175	2366187	AAAAT	12	-	2	TTTTA
gi|514486632|gb|KE346360.1|	2366255	2366270	AGCG	15	-	3	CTCG
gi|514486632|gb|KE346360.1|	2366309	2366324	ACT	15	-	5	AGT
gi|514486632|gb|KE346360.1|	2366408	2366428	A	20	-	20	T
gi|514486632|gb|KE346360.1|	2366745	2366761	AGGGGG	16	+	2	GGAGGG
gi|514486632|gb|KE346360.1|	2368970	2368986	AGCTCC	16	+	2	CAGCTC
gi|514486632|gb|KE346360.1|	2368982	2369001	AGC	19	+	6	CAG
gi|514486632|gb|KE346360.1|	2369131	2369146	AGC	15	+	5	GCA
gi|514486632|gb|KE346360.1|	2369147	2369159	AGC	12	+	4	CAG
gi|514486632|gb|KE346360.1|	2369412	2369424	AACGAC	12	+	2	CAACGA
gi|514486632|gb|KE346360.1|	2369807	2369831	AAAC	24	+	6	CAAA
gi|514486632|gb|KE346360.1|	2369829	2369844	AAAC	15	+	3	AAAC
gi|514486632|gb|KE346360.1|	2370898	2370924	ACG	26	-	8	TCG
gi|514486632|gb|KE346360.1|	2371482	2371494	AGC	12	-	4	GCT
gi|514486632|gb|KE346360.1|	2371499	2371511	AATTGC	12	+	2	ATTGCA
gi|514486632|gb|KE346360.1|	2371711	2371723	AG	12	-	6	TC
gi|514486632|gb|KE346360.1|	2372210	2372231	A	21	-	21	T
gi|514486632|gb|KE346360.1|	2372403	2372417	A	14	-	14	T
gi|514486632|gb|KE346360.1|	2372622	2372636	AAAAT	14	-	2	TATTT
gi|514486632|gb|KE346360.1|	2372634	2372656	AAAAT	22	-	4	TTATT
gi|514486632|gb|KE346360.1|	2372658	2372694	AATG	36	-	9	ATTC
gi|514486632|gb|KE346360.1|	2372707	2372754	AATG	47	-	11	TTCA
gi|514486632|gb|KE346360.1|	2372770	2372783	AAAAAC	13	-	2	TGTTTT
gi|514486632|gb|KE346360.1|	2372964	2372977	ACTGCG	13	-	2	AGTCGC
gi|514486632|gb|KE346360.1|	2376679	2376691	AACAGC	12	-	2	TGTTGC
gi|514486632|gb|KE346360.1|	2377266	2377279	AGC	13	-	4	GCT
gi|514486632|gb|KE346360.1|	2377384	2377401	AGCGGC	17	+	2	GCGGCA
gi|514486632|gb|KE346360.1|	2377479	2377491	AATCAT	12	+	2	CATAAT
gi|514486632|gb|KE346360.1|	2379941	2379957	AACCCT	16	-	2	AGGGTT
gi|514486632|gb|KE346360.1|	2380360	2380374	AAACC	14	+	2	AACCA
gi|514486632|gb|KE346360.1|	2380425	2380441	ACACAT	16	+	2	CACATA
gi|514486632|gb|KE346360.1|	2380436	2380453	AC	17	+	8	AC
gi|514486632|gb|KE346360.1|	2381097	2381109	ACTGGC	12	-	2	CCAGTG
gi|514486632|gb|KE346360.1|	2381900	2381914	AAAAAC	14	-	2	TTTTGT
gi|514486632|gb|KE346360.1|	2382820	2382835	AAAC	15	+	3	AAAC
gi|514486632|gb|KE346360.1|	2382829	2382846	AAAAC	17	+	3	AACAA
gi|514486632|gb|KE346360.1|	2382842	2382855	A	13	+	13	A
gi|514486632|gb|KE346360.1|	2383581	2383599	AATAGC	18	+	3	CAATAG
gi|514486632|gb|KE346360.1|	2384403	2384415	AGAGCG	12	+	2	GAGCGA
gi|514486632|gb|KE346360.1|	2385080	2385092	AAGCCC	12	-	2	GGCTTG
gi|514486632|gb|KE346360.1|	2385106	2385127	ACG	21	+	7	CGA
gi|514486632|gb|KE346360.1|	2385128	2385141	ACGTCG	13	+	2	GTCGAC
gi|514486632|gb|KE346360.1|	2385394	2385407	ACC	13	-	4	GTG
gi|514486632|gb|KE346360.1|	2385927	2385939	ACCCCC	12	-	2	GTGGGG
gi|514486632|gb|KE346360.1|	2386084	2386098	AG	14	-	7	CT
gi|514486632|gb|KE346360.1|	2386684	2386696	A	12	+	12	A
gi|514486632|gb|KE346360.1|	2386697	2386712	ACTG	15	+	3	GACT
gi|514486632|gb|KE346360.1|	2387148	2387167	AGGCCG	19	+	3	CCGAGG
gi|514486632|gb|KE346360.1|	2387453	2387465	AGAGCC	12	+	2	CCAGAG
gi|514486632|gb|KE346360.1|	2389440	2389452	ACCAGC	12	+	2	AGCACC
gi|514486632|gb|KE346360.1|	2389587	2389602	A	15	+	15	A
gi|514486632|gb|KE346360.1|	2390421	2390444	ACG	23	-	7	GTC
gi|514486632|gb|KE346360.1|	2390470	2390482	AAGCTC	12	-	2	TGAGCT
gi|514486632|gb|KE346360.1|	2390619	2390631	AGAGCG	12	+	2	AGCGAG
gi|514486632|gb|KE346360.1|	2390686	2390698	AAAAGC	12	+	2	AAAGCA
gi|514486632|gb|KE346360.1|	2390708	2390720	ACTCTC	12	-	2	GAGAGT
gi|514486632|gb|KE346360.1|	2392473	2392493	AAG	20	+	6	AGA
gi|514486632|gb|KE346360.1|	2393547	2393559	ACGG	12	+	3	GACG
gi|514486632|gb|KE346360.1|	2394172	2394187	AGCG	15	+	3	GAGC
gi|514486632|gb|KE346360.1|	2394582	2394597	AC	15	+	7	AC
gi|514486632|gb|KE346360.1|	2394596	2394625	A	29	+	29	A
gi|514486632|gb|KE346360.1|	2395480	2395494	AAAAC	14	+	2	AAAAC
gi|514486632|gb|KE346360.1|	2396292	2396311	ATC	19	+	6	CAT
gi|514486632|gb|KE346360.1|	2396867	2396881	AAC	14	+	4	AAC
gi|514486632|gb|KE346360.1|	2396876	2396894	AAAC	18	+	4	AACA
gi|514486632|gb|KE346360.1|	2397064	2397079	ACGC	15	-	3	TGCG
gi|514486632|gb|KE346360.1|	2397508	2397523	AACGTG	15	+	2	TGAACG
gi|514486632|gb|KE346360.1|	2397646	2397659	ACC	13	-	4	GGT
gi|514486632|gb|KE346360.1|	2397760	2397772	ACAGC	12	+	2	GCACA
gi|514486632|gb|KE346360.1|	2397895	2397925	A	30	-	30	T
gi|514486632|gb|KE346360.1|	2398156	2398168	AATGCC	12	-	2	ATTGGC
gi|514486632|gb|KE346360.1|	2398172	2398192	A	20	-	20	T
gi|514486632|gb|KE346360.1|	2398593	2398605	ATC	12	+	4	CAT
gi|514486632|gb|KE346360.1|	2399896	2399970	AC	74	-	37	TG
gi|514486632|gb|KE346360.1|	2401106	2401120	ACCGC	14	-	2	GTGCG
gi|514486632|gb|KE346360.1|	2402180	2402192	ACG	12	+	4	CGA
gi|514486632|gb|KE346360.1|	2402343	2402357	AAAAC	14	-	2	TTTTG
gi|514486632|gb|KE346360.1|	2402563	2402575	AAAGC	12	-	2	TGCTT
gi|514486632|gb|KE346360.1|	2402929	2402941	AAC	12	+	4	CAA
gi|514486632|gb|KE346360.1|	2403688	2403701	AAAAC	13	+	2	AAACA
gi|514486632|gb|KE346360.1|	2404525	2404537	ATCGGC	12	-	2	ATGCCG
gi|514486632|gb|KE346360.1|	2405968	2405985	AAG	17	-	5	TTC
gi|514486632|gb|KE346360.1|	2406001	2406023	AAC	22	+	7	AAC
gi|514486632|gb|KE346360.1|	2406508	2406557	A	49	+	49	A
gi|514486632|gb|KE346360.1|	2406762	2406790	A	28	-	28	T
gi|514486632|gb|KE346360.1|	2406970	2406983	A	13	+	13	A
gi|514486632|gb|KE346360.1|	2407005	2407020	AGC	15	-	5	CTG
gi|514486632|gb|KE346360.1|	2407104	2407116	AGGGGG	12	+	2	GAGGGG
gi|514486632|gb|KE346360.1|	2407216	2407320	AC	104	+	52	AC
gi|514486632|gb|KE346360.1|	2407862	2407876	ACAGCT	14	+	2	CAGCTA
gi|514486632|gb|KE346360.1|	2408419	2408431	AAAAAG	12	+	2	AAAAAG
gi|514486632|gb|KE346360.1|	2409114	2409129	AAAGAG	15	-	2	TCTTTC
gi|514486632|gb|KE346360.1|	2409712	2409726	AACGAC	14	-	2	GTTGTC
gi|514486632|gb|KE346360.1|	2410118	2410133	A	15	-	15	T
gi|514486632|gb|KE346360.1|	2410207	2410226	AAAAT	19	-	3	TTTTA
gi|514486632|gb|KE346360.1|	2410717	2410729	ACCGGG	12	-	2	GTCCCG
gi|514486632|gb|KE346360.1|	2411009	2411021	AAAGC	12	-	2	TTTGC
gi|514486632|gb|KE346360.1|	2411205	2411218	C	13	+	13	C
gi|514486632|gb|KE346360.1|	2412464	2412479	A	15	+	15	A
gi|514486632|gb|KE346360.1|	2413680	2413692	AAGCGC	12	-	2	CTTGCG
gi|514486632|gb|KE346360.1|	2413893	2413907	A	14	+	14	A
gi|514486632|gb|KE346360.1|	2415407	2415419	A	12	+	12	A
gi|514486632|gb|KE346360.1|	2415494	2415509	AG	15	+	7	GA
gi|514486632|gb|KE346360.1|	2415588	2415614	A	26	+	26	A
gi|514486632|gb|KE346360.1|	2415825	2415837	AGGGG	12	+	2	GGAGG
gi|514486632|gb|KE346360.1|	2415893	2415912	A	19	-	19	T
gi|514486632|gb|KE346360.1|	2416055	2416072	A	17	-	17	T
gi|514486632|gb|KE346360.1|	2416577	2416591	A	14	+	14	A
gi|514486632|gb|KE346360.1|	2416642	2416655	AGAGC	13	+	2	GAGCA
gi|514486632|gb|KE346360.1|	2416891	2416903	ACCAGG	12	+	2	GACCAG
gi|514486632|gb|KE346360.1|	2417195	2417214	ACC	19	-	6	GGT
gi|514486632|gb|KE346360.1|	2417427	2417439	AAAGC	12	-	2	TGCTT
gi|514486632|gb|KE346360.1|	2417593	2417605	AAGAG	12	-	2	TTCTC
gi|514486632|gb|KE346360.1|	2419907	2419919	AAC	12	+	4	CAA
gi|514486632|gb|KE346360.1|	2419921	2419933	AAC	12	+	4	AAC
gi|514486632|gb|KE346360.1|	2420099	2420114	AGGGG	15	+	3	GGGGA
gi|514486632|gb|KE346360.1|	2420465	2420484	A	19	-	19	T
gi|514486632|gb|KE346360.1|	2420497	2420529	A	32	-	32	T
gi|514486632|gb|KE346360.1|	2420856	2420870	AGCCGC	14	+	2	GCAGCC
gi|514486632|gb|KE346360.1|	2421133	2421145	CCG	12	+	4	GCC
gi|514486632|gb|KE346360.1|	2421459	2421476	AGG	17	-	5	CTC
gi|514486632|gb|KE346360.1|	2421613	2421627	A	14	-	14	T
gi|514486632|gb|KE346360.1|	2421702	2421714	AAGCAG	12	+	2	GCAGAA
gi|514486632|gb|KE346360.1|	2423078	2423090	ACCAGC	12	+	2	GCACCA
gi|514486632|gb|KE346360.1|	2423110	2423122	ACCAGC	12	+	2	AGCACC
gi|514486632|gb|KE346360.1|	2423358	2423370	ATCGCC	12	-	2	GCGATG
gi|514486632|gb|KE346360.1|	2423434	2423448	AGCCCC	14	+	2	GCCCCA
gi|514486632|gb|KE346360.1|	2423447	2423461	AAC	14	+	4	CAA
gi|514486632|gb|KE346360.1|	2423456	2423473	AACAGC	17	+	2	CAACAG
gi|514486632|gb|KE346360.1|	2423468	2423536	AAC	68	+	22	CAA
gi|514486632|gb|KE346360.1|	2424243	2424271	AGC	28	-	9	CTG
gi|514486632|gb|KE346360.1|	2424455	2424472	AACAGC	17	+	2	CAGCAA
gi|514486632|gb|KE346360.1|	2424947	2424964	AACAGC	17	+	2	CAACAG
gi|514486632|gb|KE346360.1|	2424965	2424982	AGC	17	+	5	CAG
gi|514486632|gb|KE346360.1|	2425316	2425330	AATGTG	14	+	2	AATGTG
gi|514486632|gb|KE346360.1|	2425351	2425371	AGC	20	+	6	GCA
gi|514486632|gb|KE346360.1|	2425406	2425422	AACAGC	16	+	2	CAGCAA
gi|514486632|gb|KE346360.1|	2425451	2425468	AGC	17	+	5	CAG
gi|514486632|gb|KE346360.1|	2425537	2425552	ACCTCC	15	-	2	TGGAGG
gi|514486632|gb|KE346360.1|	2425598	2425610	AGGCGC	12	+	2	GCGCAG
gi|514486632|gb|KE346360.1|	2425670	2425687	AACAGC	17	+	2	CAGCAA
gi|514486632|gb|KE346360.1|	2425682	2425705	AGC	23	+	7	CAG
gi|514486632|gb|KE346360.1|	2425703	2425721	AAC	18	+	6	CAA
gi|514486632|gb|KE346360.1|	2425745	2425758	AACAGC	13	+	2	CAGCAA
gi|514486632|gb|KE346360.1|	2426186	2426198	AAAAG	12	+	2	AAAGA
gi|514486632|gb|KE346360.1|	2426924	2426936	ATCCCG	12	+	2	GATCCC
gi|514486632|gb|KE346360.1|	2428771	2428788	AAAAAC	17	+	2	AAAACA
gi|514486632|gb|KE346360.1|	2429034	2429046	AACAGC	12	-	2	TGCTGT
gi|514486632|gb|KE346360.1|	2429465	2429477	AGCGC	12	-	2	CGCTG
gi|514486632|gb|KE346360.1|	2430206	2430218	ACGCG	12	+	2	CGACG
gi|514486632|gb|KE346360.1|	2430912	2430925	ATCGCC	13	+	2	GCCATC
gi|514486632|gb|KE346360.1|	2430956	2430969	ACGATG	13	-	2	CATCGT
gi|514486632|gb|KE346360.1|	2431345	2431360	A	15	+	15	A
gi|514486632|gb|KE346360.1|	2432044	2432076	AGC	32	-	10	TGC
gi|514486632|gb|KE346360.1|	2432882	2432904	AGC	22	+	7	GCA
gi|514486632|gb|KE346360.1|	2432929	2432943	AATTCC	14	-	2	TGGAAT
gi|514486632|gb|KE346360.1|	2433039	2433053	A	14	-	14	T
gi|514486632|gb|KE346360.1|	2433364	2433376	AAAAAC	12	-	2	TTTTTG
gi|514486632|gb|KE346360.1|	2433427	2433442	A	15	-	15	T
gi|514486632|gb|KE346360.1|	2433749	2433774	A	25	-	25	T
gi|514486632|gb|KE346360.1|	2433973	2433998	A	25	+	25	A
gi|514486632|gb|KE346360.1|	2434963	2434985	AAAC	22	-	5	TTGT
gi|514486632|gb|KE346360.1|	2435265	2435280	ACCCT	15	-	3	GGTAG
gi|514486632|gb|KE346360.1|	2435521	2435537	AGG	16	+	5	GAG
gi|514486632|gb|KE346360.1|	2435614	2435628	ATGCCC	14	+	2	CCCATG
gi|514486632|gb|KE346360.1|	2437046	2437060	ACTGC	14	+	2	TGCAC
gi|514486632|gb|KE346360.1|	2437194	2437211	A	17	-	17	T
gi|514486632|gb|KE346360.1|	2437212	2437231	A	19	-	19	T
gi|514486632|gb|KE346360.1|	2437242	2437258	A	16	-	16	T
gi|514486632|gb|KE346360.1|	2437268	2437283	A	15	-	15	T
gi|514486632|gb|KE346360.1|	2437718	2437738	AG	20	+	10	AG
gi|514486632|gb|KE346360.1|	2438289	2438301	AGG	12	-	4	CTC
gi|514486632|gb|KE346360.1|	2439726	2439739	AAAGTC	13	-	2	TTTGAC
gi|514486632|gb|KE346360.1|	2441895	2441908	AGCTGC	13	+	2	AGCTGC
gi|514486632|gb|KE346360.1|	2442632	2442652	ATC	20	-	6	TGA
gi|514486632|gb|KE346360.1|	2442898	2442910	AAACAC	12	-	2	TGTTTG
gi|514486632|gb|KE346360.1|	2444213	2444226	ACACG	13	-	2	GTCGT
gi|514486632|gb|KE346360.1|	2445316	2445328	ACTGGC	12	-	2	AGTGCC
gi|514486632|gb|KE346360.1|	2446487	2446499	ACCGGG	12	-	2	TCCCGG
gi|514486632|gb|KE346360.1|	2446776	2446794	ACG	18	-	6	TCG
gi|514486632|gb|KE346360.1|	2447509	2447522	AAAC	13	-	3	TTGT
gi|514486632|gb|KE346360.1|	2447533	2447556	AAAC	23	-	5	TTGT
gi|514486632|gb|KE346360.1|	2447582	2447594	AACG	12	-	3	CGTT
gi|514486632|gb|KE346360.1|	2448058	2448070	AGC	12	-	4	GCT
gi|514486632|gb|KE346360.1|	2448236	2448251	AACCCC	15	-	2	TGGGGT
gi|514486632|gb|KE346360.1|	2449197	2449215	AGC	18	-	6	CTG
gi|514486632|gb|KE346360.1|	2450070	2450082	A	12	+	12	A
gi|514486632|gb|KE346360.1|	2452104	2452118	ATGCC	14	+	2	GCCAT
gi|514486632|gb|KE346360.1|	2452952	2452965	ACATCC	13	-	2	GGATGT
gi|514486632|gb|KE346360.1|	2453296	2453310	AAGCGC	14	-	2	TGCGCT
gi|514486632|gb|KE346360.1|	2453369	2453387	AAC	18	-	6	TGT
gi|514486632|gb|KE346360.1|	2454426	2454438	AGC	12	+	4	CAG
gi|514486632|gb|KE346360.1|	2454711	2454732	ACCCTG	21	-	3	GGTCAG
gi|514486632|gb|KE346360.1|	2454737	2454751	ACCCG	14	-	2	TCGGG
gi|514486632|gb|KE346360.1|	2454920	2454942	ACACGC	22	+	3	CACACG
gi|514486632|gb|KE346360.1|	2454987	2455003	A	16	+	16	A
gi|514486632|gb|KE346360.1|	2455022	2455034	A	12	+	12	A
gi|514486632|gb|KE346360.1|	2455206	2455230	A	24	+	24	A
gi|514486632|gb|KE346360.1|	2456032	2456055	ATC	23	+	7	TCA
gi|514486632|gb|KE346360.1|	2456456	2456472	ACC	16	+	5	ACC
gi|514486632|gb|KE346360.1|	2457816	2457828	AGCCCC	12	+	2	CAGCCC
gi|514486632|gb|KE346360.1|	2457877	2457889	AGATCC	12	-	2	GATCTG
gi|514486632|gb|KE346360.1|	2457978	2457990	AGGCGC	12	-	2	TGCGCC
gi|514486632|gb|KE346360.1|	2459936	2459952	ACGCCG	16	-	2	CGTCGG
gi|514486632|gb|KE346360.1|	2460662	2460676	AAGAGC	14	-	2	TGCTCT
gi|514486632|gb|KE346360.1|	2462253	2462265	AGCG	12	-	3	GCTC
gi|514486632|gb|KE346360.1|	2463272	2463284	AGATGC	12	+	2	CAGATG
gi|514486632|gb|KE346360.1|	2463582	2463605	AACAGC	23	-	3	TGTTGC
gi|514486632|gb|KE346360.1|	2463618	2463632	AAC	14	-	4	TGT
gi|514486632|gb|KE346360.1|	2464528	2464546	AAC	18	+	6	CAA
gi|514486632|gb|KE346360.1|	2464874	2464886	AAGCCG	12	-	2	CTTCGG
gi|514486632|gb|KE346360.1|	2465228	2465245	A	17	-	17	T
gi|514486632|gb|KE346360.1|	2465300	2465314	AAAAC	14	+	2	AAAAC
gi|514486632|gb|KE346360.1|	2465310	2465328	A	18	+	18	A
gi|514486632|gb|KE346360.1|	2465468	2465493	AAC	25	+	8	AAC
gi|514486632|gb|KE346360.1|	2465565	2465578	A	13	-	13	T
gi|514486632|gb|KE346360.1|	2465780	2465794	ACG	14	-	4	TCG
gi|514486632|gb|KE346360.1|	2465792	2465809	ATC	17	+	5	TCA
gi|514486632|gb|KE346360.1|	2466030	2466044	AAGCTG	14	-	2	CAGCTT
gi|514486632|gb|KE346360.1|	2466195	2466207	CCG	12	+	4	CGC
gi|514486632|gb|KE346360.1|	2466284	2466298	ACTG	14	+	3	GACT
gi|514486632|gb|KE346360.1|	2468165	2468177	ACATG	12	+	2	CATGA
gi|514486632|gb|KE346360.1|	2468371	2468384	AAATCC	13	+	2	ATCCAA
gi|514486632|gb|KE346360.1|	2468473	2468486	AAGAGC	13	+	2	CAAGAG
gi|514486632|gb|KE346360.1|	2468486	2468503	ACG	17	-	5	TCG
gi|514486632|gb|KE346360.1|	2468612	2468624	AGGCG	12	-	2	CTCGC
gi|514486632|gb|KE346360.1|	2468625	2468638	ACGAGG	13	-	2	CGTCCT
gi|514486632|gb|KE346360.1|	2468738	2468751	AGCAGG	13	+	2	GCAGGA
gi|514486632|gb|KE346360.1|	2469645	2469661	AGCCTC	16	+	2	CAGCCT
gi|514486632|gb|KE346360.1|	2469922	2469934	AAG	12	-	4	CTT
gi|514486632|gb|KE346360.1|	2470065	2470078	A	13	+	13	A
gi|514486632|gb|KE346360.1|	2470219	2470232	AAAG	13	+	3	AAGA
gi|514486632|gb|KE346360.1|	2470277	2470289	AAG	12	-	4	TTC
gi|514486632|gb|KE346360.1|	2472985	2472999	AAAAT	14	-	2	ATTTT
gi|514486632|gb|KE346360.1|	2473302	2473315	AAAAAC	13	-	2	TTTTTG
gi|514486632|gb|KE346360.1|	2473485	2473497	AAAAAG	12	-	2	TTTTTC
gi|514486632|gb|KE346360.1|	2473940	2473953	AAGGGC	13	+	2	GGCAAG
gi|514486632|gb|KE346360.1|	2474586	2474598	A	12	+	12	A
gi|514486632|gb|KE346360.1|	2474837	2474863	A	26	-	26	T
gi|514486632|gb|KE346360.1|	2474860	2474880	AAACC	20	-	4	TTTGG
gi|514486632|gb|KE346360.1|	2474875	2474887	AAAGCC	12	-	2	TTTGGC
gi|514486632|gb|KE346360.1|	2475052	2475086	A	34	-	34	T
gi|514486632|gb|KE346360.1|	2475265	2475283	A	18	+	18	A
gi|514486632|gb|KE346360.1|	2475863	2475875	AAATGC	12	-	2	CATTTG
gi|514486632|gb|KE346360.1|	2477809	2477821	ACCTCC	12	+	2	ACCTCC
gi|514486632|gb|KE346360.1|	2477839	2477851	AACGGC	12	+	2	GCAACG
gi|514486632|gb|KE346360.1|	2479104	2479116	CCCGGG	12	+	2	GGCCCG
gi|514486632|gb|KE346360.1|	2479610	2479623	AACAGC	13	+	2	ACAGCA
gi|514486632|gb|KE346360.1|	2480117	2480129	ACCCC	12	+	2	CCCCA
gi|514486632|gb|KE346360.1|	2480137	2480150	AAAACC	13	+	2	AAACCA
gi|514486632|gb|KE346360.1|	2480169	2480182	A	13	+	13	A
gi|514486632|gb|KE346360.1|	2482035	2482060	ATC	25	-	8	TGA
gi|514486632|gb|KE346360.1|	2482319	2482331	AAAAC	12	+	2	AACAA
gi|514486632|gb|KE346360.1|	2482510	2482528	AAT	18	+	6	AAT
gi|514486632|gb|KE346360.1|	2482807	2482820	AAAAG	13	-	2	TTTCT
gi|514486632|gb|KE346360.1|	2484641	2484654	ACGCGG	13	-	2	CCGCGT
gi|514486632|gb|KE346360.1|	2485682	2485694	AGCCTC	12	+	2	CAGCCT
gi|514486632|gb|KE346360.1|	2485983	2485995	AAAACC	12	+	2	AAACCA
gi|514486632|gb|KE346360.1|	2487199	2487214	AC	15	-	7	GT
gi|514486632|gb|KE346360.1|	2487993	2488006	ACC	13	+	4	ACC
gi|514486632|gb|KE346360.1|	2488048	2488062	AAC	14	-	4	TGT
gi|514486632|gb|KE346360.1|	2488573	2488585	AACAG	12	+	2	AGAAC
gi|514486632|gb|KE346360.1|	2489020	2489033	AGCCTG	13	-	2	CAGGCT
gi|514486632|gb|KE346360.1|	2490912	2490925	A	13	+	13	A
gi|514486632|gb|KE346360.1|	2491412	2491425	AACAAG	13	+	2	ACAAGA
gi|514486632|gb|KE346360.1|	2491643	2491657	ACTGCT	14	-	2	AGCAGT
gi|514486632|gb|KE346360.1|	2491652	2491667	ACT	15	-	5	AGT
gi|514486632|gb|KE346360.1|	2491707	2491720	ACCAGC	13	-	2	GCTGGT
gi|514486632|gb|KE346360.1|	2492435	2492462	A	27	+	27	A
gi|514486632|gb|KE346360.1|	2492468	2492481	A	13	+	13	A
gi|514486632|gb|KE346360.1|	2492895	2492907	AG	12	+	6	GA
gi|514486632|gb|KE346360.1|	2493641	2493655	ACG	14	-	4	CGT
gi|514486632|gb|KE346360.1|	2493664	2493677	ATCCGC	13	-	2	GATGCG
gi|514486632|gb|KE346360.1|	2493813	2493827	AAGGGC	14	-	2	GCCCTT
gi|514486632|gb|KE346360.1|	2495199	2495211	AAGGTC	12	-	2	CCTTGA
gi|514486632|gb|KE346360.1|	2495830	2495842	ACG	12	-	4	TCG
gi|514486632|gb|KE346360.1|	2495895	2495908	ACTCTG	13	-	2	CAGAGT
gi|514486632|gb|KE346360.1|	2495918	2495932	ACTGCC	14	+	2	CACTGC
gi|514486632|gb|KE346360.1|	2496030	2496043	AGGCC	13	-	2	GCCTG
gi|514486632|gb|KE346360.1|	2496165	2496177	AGC	12	+	4	AGC
gi|514486632|gb|KE346360.1|	2496178	2496195	AGCGGC	17	+	2	GCGGCA
gi|514486632|gb|KE346360.1|	2496309	2496324	ACG	15	-	5	TCG
gi|514486632|gb|KE346360.1|	2496689	2496701	AGCTGC	12	+	2	TGCAGC
gi|514486632|gb|KE346360.1|	2499285	2499298	ACCG	13	-	3	GGTC
gi|514486632|gb|KE346360.1|	2499952	2499966	ATCATG	14	+	2	ATGATC
gi|514486632|gb|KE346360.1|	2499976	2499989	ATC	13	-	4	ATG
gi|514486632|gb|KE346360.1|	2502175	2502188	AACTTG	13	+	2	AACTTG
gi|514486632|gb|KE346360.1|	2502770	2502784	ACGGCG	14	-	2	GTCGCC
gi|514486632|gb|KE346360.1|	2502790	2502821	AGC	31	+	10	AGC
gi|514486632|gb|KE346360.1|	2503054	2503068	AAGCGG	14	+	2	AGCGGA
gi|514486632|gb|KE346360.1|	2503136	2503148	AGC	12	-	4	TGC
gi|514486632|gb|KE346360.1|	2503150	2503164	AGC	14	-	4	CTG
gi|514486632|gb|KE346360.1|	2503322	2503335	AGCATC	13	-	2	TGATGC
gi|514486632|gb|KE346360.1|	2503339	2503351	AGC	12	-	4	CTG
gi|514486632|gb|KE346360.1|	2503402	2503425	AGC	23	-	7	GCT
gi|514486632|gb|KE346360.1|	2503430	2503444	AGC	14	-	4	TGC
gi|514486632|gb|KE346360.1|	2503594	2503608	A	14	+	14	A
gi|514486632|gb|KE346360.1|	2503836	2503849	AAAAAG	13	-	2	TTCTTT
gi|514486632|gb|KE346360.1|	2503845	2503863	AAAAAG	18	-	3	TTTTCT
gi|514486632|gb|KE346360.1|	2504026	2504038	AAAAAC	12	+	2	AAAAAC
gi|514486632|gb|KE346360.1|	2504327	2504339	ACC	12	-	4	TGG
gi|514486632|gb|KE346360.1|	2505410	2505422	ACATGG	12	+	2	ACATGG
gi|514486632|gb|KE346360.1|	2505449	2505462	ATCC	13	+	3	ATCC
gi|514486632|gb|KE346360.1|	2505879	2505891	AAAAC	12	-	2	TGTTT
gi|514486632|gb|KE346360.1|	2505945	2505960	A	15	-	15	T
gi|514486632|gb|KE346360.1|	2505961	2505975	A	14	-	14	T
gi|514486632|gb|KE346360.1|	2505976	2505998	A	22	-	22	T
gi|514486632|gb|KE346360.1|	2507408	2507421	AACGC	13	+	2	CAACG
gi|514486632|gb|KE346360.1|	2507980	2507995	AAC	15	-	5	TGT
gi|514486632|gb|KE346360.1|	2507997	2508010	ACC	13	-	4	TGG
gi|514486632|gb|KE346360.1|	2508332	2508355	AC	23	+	11	CA
gi|514486632|gb|KE346360.1|	2508955	2508968	AGC	13	-	4	CTG
gi|514486632|gb|KE346360.1|	2509829	2509849	CCG	20	-	6	GCG
gi|514486632|gb|KE346360.1|	2510325	2510337	AACGAG	12	-	2	TCTCGT
gi|514486632|gb|KE346360.1|	2511590	2511604	ACGCGG	14	+	2	GCGGAC
gi|514486632|gb|KE346360.1|	2512319	2512336	AGG	17	-	5	TCC
gi|514486632|gb|KE346360.1|	2513278	2513290	AGAGCC	12	+	2	GCCAGA
gi|514486632|gb|KE346360.1|	2514603	2514620	A	17	+	17	A
gi|514486632|gb|KE346360.1|	2514937	2514954	A	17	+	17	A
gi|514486632|gb|KE346360.1|	2515219	2515233	AAAATC	14	+	2	CAAAAT
gi|514486632|gb|KE346360.1|	2515292	2515304	A	12	+	12	A
gi|514486632|gb|KE346360.1|	2515361	2515376	AGC	15	-	5	CTG
gi|514486632|gb|KE346360.1|	2517760	2517774	ACC	14	+	4	CCA
gi|514486632|gb|KE346360.1|	2517774	2517792	AGC	18	+	6	GCA
gi|514486632|gb|KE346360.1|	2517837	2517857	AGC	20	+	6	CAG
gi|514486632|gb|KE346360.1|	2518028	2518040	AGG	12	-	4	CTC
gi|514486632|gb|KE346360.1|	2518217	2518230	AG	13	+	6	GA
gi|514486632|gb|KE346360.1|	2518296	2518311	A	15	-	15	T
gi|514486632|gb|KE346360.1|	2518491	2518508	AAAAAG	17	-	2	TTTTTC
gi|514486632|gb|KE346360.1|	2518503	2518519	A	16	-	16	T
gi|514486632|gb|KE346360.1|	2518688	2518704	A	16	-	16	T
gi|514486632|gb|KE346360.1|	2518918	2518930	AACC	12	+	3	AACC
gi|514486632|gb|KE346360.1|	2519955	2519972	AGCCTC	17	-	2	CTGAGG
gi|514486632|gb|KE346360.1|	2520105	2520117	AAAAC	12	-	2	TTGTT
gi|514486632|gb|KE346360.1|	2520116	2520128	AAAAAC	12	-	2	TTTTTG
gi|514486632|gb|KE346360.1|	2520546	2520569	AC	23	+	11	CA
gi|514486632|gb|KE346360.1|	2522493	2522506	AGC	13	-	4	GCT
gi|514486632|gb|KE346360.1|	2522504	2522521	ACC	17	-	5	TGG
gi|514486632|gb|KE346360.1|	2522558	2522570	AGC	12	+	4	CAG
gi|514486632|gb|KE346360.1|	2522668	2522681	AAATG	13	+	2	AATGA
gi|514486632|gb|KE346360.1|	2523369	2523381	AAGATC	12	+	2	TCAAGA
gi|514486632|gb|KE346360.1|	2524783	2524797	AACGAG	14	-	2	TCGTTC
gi|514486632|gb|KE346360.1|	2524849	2524861	ACGCTG	12	+	2	CGCTGA
gi|514486632|gb|KE346360.1|	2526771	2526785	A	14	+	14	A
gi|514486632|gb|KE346360.1|	2527350	2527364	AC	14	-	7	TG
gi|514486632|gb|KE346360.1|	2528070	2528102	AAAC	32	-	8	TTTG
gi|514486632|gb|KE346360.1|	2528139	2528152	AAGAG	13	-	2	TCTCT
gi|514486632|gb|KE346360.1|	2528160	2528172	AGAGC	12	-	2	TCTGC
gi|514486632|gb|KE346360.1|	2529194	2529206	AAAAAC	12	-	2	GTTTTT
gi|514486632|gb|KE346360.1|	2529743	2529755	ACTC	12	-	3	TGAG
gi|514486632|gb|KE346360.1|	2530188	2530201	AGGCCG	13	-	2	GCCTCG
gi|514486632|gb|KE346360.1|	2531174	2531187	AAAAAC	13	+	2	AACAAA
gi|514486632|gb|KE346360.1|	2532076	2532088	AACGAC	12	+	2	ACAACG
gi|514486632|gb|KE346360.1|	2532711	2532724	AACAGC	13	+	2	CAGCAA
gi|514486632|gb|KE346360.1|	2533326	2533339	AATG	13	+	3	GAAT
gi|514486632|gb|KE346360.1|	2533861	2533873	AAAAC	12	+	2	AACAA
gi|514486632|gb|KE346360.1|	2535398	2535411	AGATGC	13	+	2	CAGATG
gi|514486632|gb|KE346360.1|	2535798	2535810	AGCGCG	12	+	2	GAGCGC
gi|514486632|gb|KE346360.1|	2536236	2536257	ACG	21	+	7	CGA
gi|514486632|gb|KE346360.1|	2536252	2536269	ACGAGG	17	+	2	GACGAG
gi|514486632|gb|KE346360.1|	2536553	2536568	AAG	15	+	5	AAG
gi|514486632|gb|KE346360.1|	2536613	2536630	ACTGCT	17	+	2	CTGCTA
gi|514486632|gb|KE346360.1|	2536625	2536645	AGC	20	-	6	CTG
gi|514486632|gb|KE346360.1|	2536719	2536733	A	14	+	14	A
gi|514486632|gb|KE346360.1|	2536770	2536785	A	15	+	15	A
gi|514486632|gb|KE346360.1|	2536788	2536804	A	16	+	16	A
gi|514486632|gb|KE346360.1|	2537140	2537156	AGGGC	16	+	3	GCAGG
gi|514486632|gb|KE346360.1|	2537150	2537162	AGGGGC	12	+	2	GCAGGG
gi|514486632|gb|KE346360.1|	2537379	2537395	AG	16	-	8	TC
gi|514486632|gb|KE346360.1|	2538173	2538185	AAGACC	12	+	2	CAAGAC
gi|514486632|gb|KE346360.1|	2539541	2539554	AG	13	+	6	GA
gi|514486632|gb|KE346360.1|	2539581	2539597	A	16	+	16	A
gi|514486632|gb|KE346360.1|	2539601	2539613	AACCCC	12	+	2	CCAACC
gi|514486632|gb|KE346360.1|	2540126	2540138	AATATC	12	-	2	ATTGAT
gi|514486632|gb|KE346360.1|	2540170	2540182	AAAATC	12	+	2	CAAAAT
gi|514486632|gb|KE346360.1|	2540292	2540310	AGG	18	+	6	AGG
gi|514486632|gb|KE346360.1|	2540465	2540478	ATCC	13	-	3	GGAT
gi|514486632|gb|KE346360.1|	2541161	2541175	AACGAC	14	+	2	ACGACA
gi|514486632|gb|KE346360.1|	2541173	2541191	AACGAC	18	+	3	ACAACG
gi|514486632|gb|KE346360.1|	2542094	2542107	AAC	13	+	4	CAA
gi|514486632|gb|KE346360.1|	2542137	2542149	AAAAC	12	+	2	AACAA
gi|514486632|gb|KE346360.1|	2542731	2542749	ACTC	18	-	4	TGAG
gi|514486632|gb|KE346360.1|	2542937	2542953	ACCGCC	16	+	2	CCGCCA
gi|514486632|gb|KE346360.1|	2543177	2543191	AGGC	14	+	3	AGGC
gi|514486632|gb|KE346360.1|	2543807	2543821	AAGACG	14	+	2	GAAGAC
gi|514486632|gb|KE346360.1|	2544171	2544184	AGATC	13	-	2	GATCT
gi|514486632|gb|KE346360.1|	2544298	2544311	AAGCTC	13	+	2	GCTCAA
gi|514486632|gb|KE346360.1|	2544457	2544478	AGC	21	+	7	CAG
gi|514486632|gb|KE346360.1|	2544476	2544492	AATAGT	16	+	2	AGTAAT
gi|514486632|gb|KE346360.1|	2544487	2544501	ACT	14	-	4	TAG
gi|514486632|gb|KE346360.1|	2544528	2544540	AGCCGC	12	+	2	CAGCCG
gi|514486632|gb|KE346360.1|	2546078	2546090	CCG	12	+	4	GCC
gi|514486632|gb|KE346360.1|	2546140	2546152	ACATGC	12	-	2	GCATGT
gi|514486632|gb|KE346360.1|	2546406	2546418	AAAC	12	+	3	ACAA
gi|514486632|gb|KE346360.1|	2546982	2546994	AAGCCC	12	-	2	GGCTTG
gi|514486632|gb|KE346360.1|	2547547	2547559	AGGCCC	12	+	2	CCCAGG
gi|514486632|gb|KE346360.1|	2548143	2548163	AAT	20	+	6	AAT
gi|514486632|gb|KE346360.1|	2548166	2548179	AAAAAG	13	+	2	AGAAAA
gi|514486632|gb|KE346360.1|	2548237	2548249	AACGG	12	+	2	AACGG
gi|514486632|gb|KE346360.1|	2548390	2548402	AAAGGG	12	+	2	GGGAAA
gi|514486632|gb|KE346360.1|	2548796	2548808	A	12	-	12	T
gi|514486632|gb|KE346360.1|	2548932	2548953	AAACGG	21	+	3	CGGAAA
gi|514486632|gb|KE346360.1|	2549105	2549117	AAACGG	12	+	2	ACGGAA
gi|514486632|gb|KE346360.1|	2549133	2549148	AAAAC	15	+	3	AAAAC
gi|514486632|gb|KE346360.1|	2549869	2549889	ACGAGG	20	-	3	CCTCGT
gi|514486632|gb|KE346360.1|	2550081	2550093	AAAGTC	12	-	2	TTTGAC
gi|514486632|gb|KE346360.1|	2550089	2550101	ACGATG	12	+	2	TGACGA
gi|514486632|gb|KE346360.1|	2550460	2550473	AAC	13	+	4	CAA
gi|514486632|gb|KE346360.1|	2550800	2550812	ACCCTC	12	+	2	CTCACC
gi|514486632|gb|KE346360.1|	2551058	2551071	AAAAC	13	-	2	TTTTG
gi|514486632|gb|KE346360.1|	2551065	2551079	AAAC	14	-	3	TTGT
gi|514486632|gb|KE346360.1|	2551073	2551086	AAAAAC	13	-	2	TTGTTT
gi|514486632|gb|KE346360.1|	2551436	2551454	AGC	18	+	6	AGC
gi|514486632|gb|KE346360.1|	2551883	2551897	ACGATG	14	-	2	TCATCG
gi|514486632|gb|KE346360.1|	2552283	2552295	AACCAC	12	+	2	ACCACA
gi|514486632|gb|KE346360.1|	2552652	2552671	AGC	19	-	6	CTG
gi|514486632|gb|KE346360.1|	2553176	2553192	ATC	16	-	5	GAT
gi|514486632|gb|KE346360.1|	2553702	2553714	AGCTCC	12	-	2	GCTGGA
gi|514486632|gb|KE346360.1|	2554324	2554336	ACCGCC	12	-	2	GGTGGC
gi|514486632|gb|KE346360.1|	2554807	2554821	A	14	+	14	A
gi|514486632|gb|KE346360.1|	2555632	2555644	AAAAAG	12	+	2	GAAAAA
gi|514486632|gb|KE346360.1|	2556328	2556341	AGCCGC	13	+	2	CCGCAG
gi|514486632|gb|KE346360.1|	2556354	2556374	ATC	20	-	6	GAT
gi|514486632|gb|KE346360.1|	2556571	2556583	AGC	12	-	4	GCT
gi|514486632|gb|KE346360.1|	2556801	2556815	AAGCGC	14	-	2	CTTGCG
gi|514486632|gb|KE346360.1|	2557425	2557450	ACAG	25	-	6	GTCT
gi|514486632|gb|KE346360.1|	2558117	2558129	ACCCC	12	+	2	CCACC
gi|514486632|gb|KE346360.1|	2558375	2558391	A	16	+	16	A
gi|514486632|gb|KE346360.1|	2558392	2558404	A	12	+	12	A
gi|514486632|gb|KE346360.1|	2558445	2558457	AACAAG	12	-	2	TTGTTC
gi|514486632|gb|KE346360.1|	2558661	2558679	AAAGCC	18	-	3	TTGGCT
gi|514486632|gb|KE346360.1|	2558954	2558966	AATGAG	12	+	2	GAGAAT
gi|514486632|gb|KE346360.1|	2559045	2559058	AGG	13	-	4	CTC
gi|514486632|gb|KE346360.1|	2559311	2559324	ACACTG	13	+	2	ACACTG
gi|514486632|gb|KE346360.1|	2560081	2560105	AGC	24	-	8	GCT
gi|514486632|gb|KE346360.1|	2560191	2560204	AAAGC	13	-	2	TTGCT
gi|514486632|gb|KE346360.1|	2560217	2560229	AAATGC	12	-	2	ATTTGC
gi|514486632|gb|KE346360.1|	2560430	2560442	AAAAAC	12	-	2	TTGTTT
gi|514486632|gb|KE346360.1|	2560619	2560637	A	18	-	18	T
gi|514486632|gb|KE346360.1|	2560861	2560886	AC	25	+	12	CA
gi|514486632|gb|KE346360.1|	2561201	2561213	AGCGCG	12	-	2	GCGCTC
gi|514486632|gb|KE346360.1|	2561477	2561489	ATCGGC	12	+	2	CATCGG
gi|514486632|gb|KE346360.1|	2562931	2562943	A	12	-	12	T
gi|514486632|gb|KE346360.1|	2564141	2564153	AAAAAC	12	-	2	TTGTTT
gi|514486632|gb|KE346360.1|	2564238	2564263	A	25	-	25	T
gi|514486632|gb|KE346360.1|	2564308	2564328	AG	20	-	10	TC
gi|514486632|gb|KE346360.1|	2564560	2564572	AACGGC	12	-	2	CCGTTG
gi|514486632|gb|KE346360.1|	2564576	2564589	AGCG	13	+	3	GAGC
gi|514486632|gb|KE346360.1|	2565559	2565573	ACC	14	+	4	CAC
gi|514486632|gb|KE346360.1|	2565568	2565585	ACCAGC	17	+	2	CACCAG
gi|514486632|gb|KE346360.1|	2565912	2565924	AGCC	12	+	3	GCCA
gi|514486632|gb|KE346360.1|	2566665	2566677	ACCTCG	12	+	2	CTCGAC
gi|514486632|gb|KE346360.1|	2567146	2567158	AAC	12	+	4	CAA
gi|514486632|gb|KE346360.1|	2567696	2567710	AAG	14	+	4	GAA
gi|514486632|gb|KE346360.1|	2567923	2567936	AAATAC	13	+	2	AAATAC
gi|514486632|gb|KE346360.1|	2569238	2569251	AAGGG	13	+	2	AGGGA
gi|514486632|gb|KE346360.1|	2569580	2569595	AAAC	15	+	3	AAAC
gi|514486632|gb|KE346360.1|	2569851	2569863	AATGCC	12	-	2	GCATTG
gi|514486632|gb|KE346360.1|	2570066	2570080	AGAGCC	14	-	2	TGGCTC
gi|514486632|gb|KE346360.1|	2570297	2570337	AGC	40	-	13	CTG
gi|514486632|gb|KE346360.1|	2570413	2570426	AGCTCG	13	+	2	CGAGCT
gi|514486632|gb|KE346360.1|	2570488	2570500	AAGCTC	12	-	2	CTTGAG
gi|514486632|gb|KE346360.1|	2570576	2570591	AGCCAT	15	+	2	CCATAG
gi|514486632|gb|KE346360.1|	2570690	2570703	AGC	13	+	4	GCA
gi|514486632|gb|KE346360.1|	2570698	2570712	AAGCAG	14	+	2	AGCAGA
gi|514486632|gb|KE346360.1|	2570882	2570899	ACC	17	+	5	CCA
gi|514486632|gb|KE346360.1|	2571365	2571379	AGC	14	-	4	TGC
gi|514486632|gb|KE346360.1|	2572303	2572316	AAGGGC	13	-	2	TTGCCC
gi|514486632|gb|KE346360.1|	2573338	2573353	AAG	15	+	5	AGA
gi|514486632|gb|KE346360.1|	2573411	2573425	AACACC	14	-	2	TGGTGT
gi|514486632|gb|KE346360.1|	2573426	2573440	AACAGC	14	-	2	TGCTGT
gi|514486632|gb|KE346360.1|	2573531	2573545	AACAGC	14	-	2	GCTGTT
gi|514486632|gb|KE346360.1|	2574383	2574399	A	16	+	16	A
gi|514486632|gb|KE346360.1|	2574462	2574474	AATG	12	-	3	CATT
gi|514486632|gb|KE346360.1|	2574594	2574628	A	34	-	34	T
gi|514486632|gb|KE346360.1|	2574708	2574725	ACTC	17	-	4	GAGT
gi|514486632|gb|KE346360.1|	2574722	2574736	AC	14	-	7	GT
gi|514486632|gb|KE346360.1|	2574815	2574827	AAAGT	12	+	2	GTAAA
gi|514486632|gb|KE346360.1|	2576381	2576394	ACCCC	13	-	2	GGTGG
gi|514486632|gb|KE346360.1|	2576910	2576926	AAAAC	16	-	3	TTGTT
gi|514486632|gb|KE346360.1|	2578131	2578172	AC	41	+	20	CA
gi|514486632|gb|KE346360.1|	2578171	2578187	AG	16	-	8	CT
gi|514486632|gb|KE346360.1|	2578654	2578667	A	13	-	13	T
gi|514486632|gb|KE346360.1|	2578665	2578688	AAC	23	-	7	TTG
gi|514486632|gb|KE346360.1|	2579269	2579288	A	19	-	19	T
gi|514486632|gb|KE346360.1|	2579516	2579542	A	26	+	26	A
gi|514486632|gb|KE346360.1|	2579741	2579757	ACAGTC	16	-	2	GTGACT
gi|514486632|gb|KE346360.1|	2579860	2579880	AAGGGG	20	+	3	GGGAAG
gi|514486632|gb|KE346360.1|	2580617	2580629	AAAATC	12	-	2	ATTTTG
gi|514486632|gb|KE346360.1|	2580906	2580919	AAAAC	13	+	2	AAACA
gi|514486632|gb|KE346360.1|	2580927	2580942	AAAAAC	15	+	2	AACAAA
gi|514486632|gb|KE346360.1|	2581029	2581042	ACAGAG	13	+	2	AGACAG
gi|514486632|gb|KE346360.1|	2581060	2581072	AGCC	12	+	3	CAGC
gi|514486632|gb|KE346360.1|	2581853	2581865	AAACAC	12	+	2	ACAAAC
gi|514486632|gb|KE346360.1|	2582164	2582181	AGAGCG	17	+	2	GAGAGC
gi|514486632|gb|KE346360.1|	2582828	2582846	ACGCAG	18	+	3	GCAGAC
gi|514486632|gb|KE346360.1|	2582876	2582896	AGC	20	+	6	GCA
gi|514486632|gb|KE346360.1|	2582959	2582974	AGC	15	+	5	AGC
gi|514486632|gb|KE346360.1|	2583159	2583174	ACC	15	-	5	GTG
gi|514486632|gb|KE346360.1|	2583175	2583187	ACC	12	-	4	TGG
gi|514486632|gb|KE346360.1|	2583202	2583222	AGG	20	+	6	AGG
gi|514486632|gb|KE346360.1|	2583500	2583513	AGCATC	13	-	2	GATGCT
gi|514486632|gb|KE346360.1|	2584540	2584611	AC	71	-	35	GT
gi|514486632|gb|KE346360.1|	2584612	2584624	AC	12	-	6	GT
gi|514486632|gb|KE346360.1|	2585159	2585171	ATCCCG	12	+	2	ATCCCG
gi|514486632|gb|KE346360.1|	2585878	2585890	ACCC	12	+	3	ACCC
gi|514486632|gb|KE346360.1|	2586021	2586034	AAACAG	13	-	2	TGTTTC
gi|514486632|gb|KE346360.1|	2586300	2586313	ACTGAG	13	-	2	CAGTCT
gi|514486632|gb|KE346360.1|	2586379	2586391	AAGGAG	12	-	2	TCTCCT
gi|514486632|gb|KE346360.1|	2586502	2586515	ATCGCC	13	+	2	CATCGC
gi|514486632|gb|KE346360.1|	2586526	2586551	A	25	+	25	A
gi|514486632|gb|KE346360.1|	2586771	2586788	A	17	-	17	T
gi|514486632|gb|KE346360.1|	2586965	2586978	AATACG	13	-	2	TTCGTA
gi|514486632|gb|KE346360.1|	2586981	2586994	AAAAAT	13	-	2	TATTTT
gi|514486632|gb|KE346360.1|	2587009	2587021	AGAGC	12	-	2	CTCTG
gi|514486632|gb|KE346360.1|	2587548	2587563	AAAC	15	+	3	AAAC
gi|514486632|gb|KE346360.1|	2589643	2589655	ACAGGG	12	-	2	GTCCCT
gi|514486632|gb|KE346360.1|	2589855	2589867	AATGGC	12	+	2	CAATGG
gi|514486632|gb|KE346360.1|	2590028	2590052	A	24	-	24	T
gi|514486632|gb|KE346360.1|	2590764	2590776	AGCATC	12	+	2	CAGCAT
gi|514486632|gb|KE346360.1|	2593045	2593059	AGC	14	-	4	TGC
gi|514486632|gb|KE346360.1|	2593718	2593737	AAAAC	19	-	3	TTTTG
gi|514486632|gb|KE346360.1|	2594128	2594140	AGAGCC	12	-	2	TGGCTC
gi|514486632|gb|KE346360.1|	2594163	2594175	AAGTCC	12	+	2	AGTCCA
gi|514486632|gb|KE346360.1|	2594856	2594868	AGAGC	12	+	2	AGAGC
gi|514486632|gb|KE346360.1|	2595177	2595192	AAAAAT	15	-	2	TTTATT
gi|514486632|gb|KE346360.1|	2595205	2595218	AAAACC	13	-	2	TGGTTT
gi|514486632|gb|KE346360.1|	2595568	2595580	AAG	12	+	4	AAG
gi|514486632|gb|KE346360.1|	2595607	2595628	AGC	21	+	7	CAG
gi|514486632|gb|KE346360.1|	2595701	2595714	ACGGGG	13	-	2	CCGTCC
gi|514486632|gb|KE346360.1|	2595709	2595734	ACAGGG	25	-	4	GTCCCT
gi|514486632|gb|KE346360.1|	2596068	2596080	AAGTGC	12	+	2	CAAGTG
gi|514486632|gb|KE346360.1|	2596088	2596117	AC	29	-	14	GT
gi|514486632|gb|KE346360.1|	2596157	2596173	AAAGAC	16	-	2	TGTCTT
gi|514486632|gb|KE346360.1|	2596436	2596449	AAGCAC	13	-	2	TGTGCT
gi|514486632|gb|KE346360.1|	2596447	2596474	A	27	-	27	T
gi|514486632|gb|KE346360.1|	2596559	2596571	ACTCCC	12	+	2	CACTCC
gi|514486632|gb|KE346360.1|	2596665	2596677	A	12	-	12	T
gi|514486632|gb|KE346360.1|	2597296	2597313	ACTCGG	17	+	2	TCGGAC
gi|514486632|gb|KE346360.1|	2597341	2597353	AAGCAG	12	+	2	GAAGCA
gi|514486632|gb|KE346360.1|	2597910	2597924	AAAAAC	14	-	2	TTTTTG
gi|514486632|gb|KE346360.1|	2598500	2598512	A	12	-	12	T
gi|514486632|gb|KE346360.1|	2598574	2598586	AACGTC	12	-	2	GTTGAC
gi|514486632|gb|KE346360.1|	2598970	2598982	AGCGC	12	+	2	GCAGC
gi|514486632|gb|KE346360.1|	2599849	2599862	AG	13	+	6	AG
gi|514486632|gb|KE346360.1|	2599871	2599886	AG	15	-	7	CT
gi|514486632|gb|KE346360.1|	2600432	2600446	AAGCGC	14	+	2	AGCGCA
gi|514486632|gb|KE346360.1|	2600937	2600949	ACTCGC	12	-	2	GCGAGT
gi|514486632|gb|KE346360.1|	2602215	2602238	AG	23	+	11	AG
gi|514486632|gb|KE346360.1|	2602357	2602370	AACAGC	13	+	2	AACAGC
gi|514486632|gb|KE346360.1|	2602595	2602608	AAGTCG	13	-	2	CGACTT
gi|514486632|gb|KE346360.1|	2602712	2602724	AAAATC	12	+	2	AAATCA
gi|514486632|gb|KE346360.1|	2602774	2602786	AGC	12	+	4	AGC
gi|514486632|gb|KE346360.1|	2602847	2602859	ATGGCC	12	+	2	CCATGG
gi|514486632|gb|KE346360.1|	2603022	2603034	ATC	12	+	4	TCA
gi|514486632|gb|KE346360.1|	2604756	2604770	ACG	14	+	4	GAC
gi|514486632|gb|KE346360.1|	2604828	2604840	CCG	12	+	4	CCG
gi|514486632|gb|KE346360.1|	2606406	2606418	ACGAGG	12	-	2	TCGTCC
gi|514486632|gb|KE346360.1|	2607180	2607192	ACAG	12	+	3	ACAG
gi|514486632|gb|KE346360.1|	2607539	2607552	AAAAG	13	+	2	AAAAG
gi|514486632|gb|KE346360.1|	2607578	2607590	AAGAC	12	+	2	ACAAG
gi|514486632|gb|KE346360.1|	2608622	2608634	CCG	12	-	4	GGC
gi|514486632|gb|KE346360.1|	2608719	2608736	AGG	17	+	5	GAG
gi|514486632|gb|KE346360.1|	2608737	2608751	AGG	14	+	4	GAG
gi|514486632|gb|KE346360.1|	2608895	2608913	ACG	18	-	6	CGT
gi|514486632|gb|KE346360.1|	2609451	2609468	AGC	17	+	5	GCA
gi|514486632|gb|KE346360.1|	2609722	2609735	AGC	13	+	4	CAG
gi|514486632|gb|KE346360.1|	2610407	2610419	ACGCCC	12	+	2	CACGCC
gi|514486632|gb|KE346360.1|	2611608	2611621	A	13	+	13	A
gi|514486632|gb|KE346360.1|	2612824	2612849	ATC	25	+	8	ATC
gi|514486632|gb|KE346360.1|	2612865	2612878	ATC	13	+	4	CAT
gi|514486632|gb|KE346360.1|	2613000	2613016	AAAGC	16	-	3	GCTTT
gi|514486632|gb|KE346360.1|	2613110	2613129	A	19	-	19	T
gi|514486632|gb|KE346360.1|	2613220	2613232	AATGAG	12	-	2	CTCATT
gi|514486632|gb|KE346360.1|	2613300	2613312	AG	12	-	6	CT
gi|514486632|gb|KE346360.1|	2613433	2613447	AGC	14	-	4	TGC
gi|514486632|gb|KE346360.1|	2613768	2613784	ACTC	16	+	4	TCAC
gi|514486632|gb|KE346360.1|	2614123	2614137	ACGAGC	14	-	2	CGTGCT
gi|514486632|gb|KE346360.1|	2614180	2614197	AGC	17	+	5	CAG
gi|514486632|gb|KE346360.1|	2615026	2615038	ACACAG	12	-	2	CTGTGT
gi|514486632|gb|KE346360.1|	2615084	2615098	AAC	14	-	4	GTT
gi|514486632|gb|KE346360.1|	2615105	2615117	AAAAAG	12	-	2	TTTTTC
gi|514486632|gb|KE346360.1|	2615948	2615960	AAGAGC	12	+	2	CAAGAG
gi|514486632|gb|KE346360.1|	2617147	2617160	AGCC	13	-	3	GGCT
gi|514486632|gb|KE346360.1|	2617250	2617262	AACCC	12	-	2	GGGTT
gi|514486632|gb|KE346360.1|	2617766	2617787	ACC	21	+	7	CAC
gi|514486632|gb|KE346360.1|	2617991	2618003	AGGCGG	12	+	2	GAGGCG
gi|514486632|gb|KE346360.1|	2619000	2619022	AGG	22	-	7	CCT
gi|514486632|gb|KE346360.1|	2619203	2619218	ATGC	15	+	3	TGCA
gi|514486632|gb|KE346360.1|	2619861	2619882	AG	21	-	10	CT
gi|514486632|gb|KE346360.1|	2620016	2620035	A	19	-	19	T
gi|514486632|gb|KE346360.1|	2620263	2620275	AAAAAG	12	-	2	TTTTTC
gi|514486632|gb|KE346360.1|	2620461	2620481	A	20	+	20	A
gi|514486632|gb|KE346360.1|	2620516	2620533	AGC	17	+	5	AGC
gi|514486632|gb|KE346360.1|	2620731	2620751	AG	20	-	10	CT
gi|514486632|gb|KE346360.1|	2620922	2620939	AC	17	+	8	CA
gi|514486632|gb|KE346360.1|	2621564	2621576	AGCCG	12	-	2	GCTCG
gi|514486632|gb|KE346360.1|	2621889	2621901	ACAGCG	12	-	2	CGCTGT
gi|514486632|gb|KE346360.1|	2622649	2622661	AGCTCG	12	+	2	CGAGCT
gi|514486632|gb|KE346360.1|	2623947	2623959	A	12	+	12	A
gi|514486632|gb|KE346360.1|	2625242	2625258	AACG	16	-	4	TTCG
gi|514486632|gb|KE346360.1|	2625482	2625494	A	12	-	12	T
gi|514486632|gb|KE346360.1|	2625514	2625526	AAAC	12	-	3	GTTT
gi|514486632|gb|KE346360.1|	2626548	2626561	A	13	-	13	T
gi|514486632|gb|KE346360.1|	2626778	2626791	AAACAC	13	+	2	ACACAA
gi|514486632|gb|KE346360.1|	2626925	2626937	A	12	+	12	A
gi|514486632|gb|KE346360.1|	2626984	2627000	AGGATG	16	-	2	CATCCT
gi|514486632|gb|KE346360.1|	2627011	2627032	ACAGAG	21	+	3	AGAGAC
gi|514486632|gb|KE346360.1|	2628119	2628131	A	12	-	12	T
gi|514486632|gb|KE346360.1|	2628189	2628201	AATCGC	12	+	2	ATCGCA
gi|514486632|gb|KE346360.1|	2628257	2628273	AGC	16	+	5	CAG
gi|514486632|gb|KE346360.1|	2628281	2628295	AGC	14	+	4	AGC
gi|514486632|gb|KE346360.1|	2628536	2628548	AGAGCG	12	-	2	TCGCTC
gi|514486632|gb|KE346360.1|	2629148	2629165	AGCCGC	17	+	2	GCCGCA
gi|514486632|gb|KE346360.1|	2630310	2630325	AAAAT	15	-	3	ATTTT
gi|514486632|gb|KE346360.1|	2630333	2630348	AACAGC	15	-	2	TTGCTG
gi|514486632|gb|KE346360.1|	2630343	2630371	AAC	28	-	9	TGT
gi|514486632|gb|KE346360.1|	2630370	2630383	AAC	13	-	4	TTG
gi|514486632|gb|KE346360.1|	2630870	2630883	AAGCAC	13	+	2	AAGCAC
gi|514486632|gb|KE346360.1|	2630903	2630915	AAAAC	12	+	2	AACAA
gi|514486632|gb|KE346360.1|	2631513	2631530	AC	17	-	8	TG
gi|514486632|gb|KE346360.1|	2631688	2631701	AATG	13	+	3	ATGA
gi|514486632|gb|KE346360.1|	2632092	2632106	ACAGCC	14	+	2	GCCACA
gi|514486632|gb|KE346360.1|	2632298	2632310	AGGATG	12	-	2	ATCCTC
gi|514486632|gb|KE346360.1|	2632335	2632349	ACTGGC	14	-	2	GTGCCA
gi|514486632|gb|KE346360.1|	2632519	2632531	AATGGC	12	-	2	CATTGC
gi|514486632|gb|KE346360.1|	2632608	2632623	AGCGGC	15	+	2	GCAGCG
gi|514486632|gb|KE346360.1|	2632800	2632817	ATCCCC	17	+	2	ATCCCC
gi|514486632|gb|KE346360.1|	2633003	2633015	ACGGCC	12	+	2	GCCACG
gi|514486632|gb|KE346360.1|	2633155	2633167	AAGAAT	12	+	2	TAAGAA
gi|514486632|gb|KE346360.1|	2633642	2633659	ACT	17	+	5	ACT
gi|514486632|gb|KE346360.1|	2633654	2633667	ACGACT	13	+	2	ACTACG
gi|514486632|gb|KE346360.1|	2633980	2634000	ACG	20	-	6	GTC
gi|514486632|gb|KE346360.1|	2634832	2634855	AC	23	+	11	AC
gi|514486632|gb|KE346360.1|	2634855	2634889	AC	34	+	17	AC
gi|514486632|gb|KE346360.1|	2634899	2634911	ACGC	12	+	3	ACGC
gi|514486632|gb|KE346360.1|	2635784	2635797	AACGGC	13	+	2	CAACGG
gi|514486632|gb|KE346360.1|	2635877	2635889	AATGG	12	+	2	GAATG
gi|514486632|gb|KE346360.1|	2636094	2636106	ACG	12	+	4	CGA
gi|514486632|gb|KE346360.1|	2636161	2636177	AGC	16	+	5	GCA
gi|514486632|gb|KE346360.1|	2636193	2636206	AGC	13	-	4	GCT
gi|514486632|gb|KE346360.1|	2636450	2636464	A	14	+	14	A
gi|514486632|gb|KE346360.1|	2636548	2636561	A	13	+	13	A
gi|514486632|gb|KE346360.1|	2637719	2637733	AC	14	-	7	TG
gi|514486632|gb|KE346360.1|	2639115	2639128	AAACG	13	+	2	CGAAA
gi|514486632|gb|KE346360.1|	2639195	2639218	A	23	-	23	T
gi|514486632|gb|KE346360.1|	2639701	2639715	AAC	14	-	4	TGT
gi|514486632|gb|KE346360.1|	2639969	2639982	AAAAGC	13	-	2	TTTTGC
gi|514486632|gb|KE346360.1|	2640039	2640051	AAGTGG	12	-	2	TCCACT
gi|514486632|gb|KE346360.1|	2640371	2640383	AAAGT	12	-	2	CTTTA
gi|514486632|gb|KE346360.1|	2640710	2640723	AAAC	13	+	3	AAAC
gi|514486632|gb|KE346360.1|	2640720	2640743	AC	23	+	11	AC
gi|514486632|gb|KE346360.1|	2641042	2641055	AACGAC	13	+	2	ACGACA
gi|514486632|gb|KE346360.1|	2641127	2641146	AGC	19	-	6	TGC
gi|514486632|gb|KE346360.1|	2641156	2641173	ACTCG	17	+	3	CTCGA
gi|514486632|gb|KE346360.1|	2641220	2641232	ACCCTC	12	-	2	TGAGGG
gi|514486632|gb|KE346360.1|	2642525	2642537	AAAGGC	12	-	2	CTTTGC
gi|514486632|gb|KE346360.1|	2643658	2643672	AAC	14	+	4	ACA
gi|514486632|gb|KE346360.1|	2643851	2643863	AAAAAG	12	-	2	CTTTTT
gi|514486632|gb|KE346360.1|	2644197	2644209	ACACG	12	+	2	GACAC
gi|514486632|gb|KE346360.1|	2644219	2644231	AAAAAC	12	-	2	TTTTTG
gi|514486632|gb|KE346360.1|	2644326	2644340	ATC	14	+	4	CAT
gi|514486632|gb|KE346360.1|	2644338	2644355	AAC	17	+	5	CAA
gi|514486632|gb|KE346360.1|	2644350	2644373	AACATC	23	+	3	CAACAT
gi|514486632|gb|KE346360.1|	2644643	2644657	AGC	14	+	4	CAG
gi|514486632|gb|KE346360.1|	2644667	2644679	AGC	12	+	4	CAG
gi|514486632|gb|KE346360.1|	2645486	2645498	AAGTC	12	-	2	GACTT
gi|514486632|gb|KE346360.1|	2646363	2646375	AAAAAC	12	+	2	CAAAAA
gi|514486632|gb|KE346360.1|	2646468	2646481	AAAAAC	13	+	2	CAAAAA
gi|514486632|gb|KE346360.1|	2646789	2646805	AAAC	16	+	4	AAAC
gi|514486632|gb|KE346360.1|	2647046	2647058	A	12	-	12	T
gi|514486632|gb|KE346360.1|	2649157	2649170	AGGGC	13	-	2	TGCCC
gi|514486632|gb|KE346360.1|	2649414	2649426	AAACAC	12	+	2	CAAACA
gi|514486632|gb|KE346360.1|	2649421	2649433	AAAAAC	12	+	2	AAACAA
gi|514486632|gb|KE346360.1|	2649865	2649881	AACGAC	16	+	2	ACGACA
gi|514486632|gb|KE346360.1|	2649881	2649894	AGC	13	-	4	TGC
gi|514486632|gb|KE346360.1|	2650052	2650067	AAGGAG	15	+	2	GGAGAA
gi|514486632|gb|KE346360.1|	2650129	2650141	AAGCAC	12	-	2	TTGTGC
gi|514486632|gb|KE346360.1|	2651045	2651057	AAAGG	12	-	2	TCCTT
gi|514486632|gb|KE346360.1|	2651787	2651811	A	24	+	24	A
gi|514486632|gb|KE346360.1|	2651838	2651862	AACTG	24	-	4	CAGTT
gi|514486632|gb|KE346360.1|	2652260	2652276	ACGCAG	16	+	2	GCAGAC
gi|514486632|gb|KE346360.1|	2652271	2652283	AGCCGC	12	+	2	CGCAGC
gi|514486632|gb|KE346360.1|	2652344	2652357	CCG	13	+	4	GCC
gi|514486632|gb|KE346360.1|	2653305	2653318	A	13	-	13	T
gi|514486632|gb|KE346360.1|	2653313	2653325	AAAAAC	12	-	2	TTTTTG
gi|514486632|gb|KE346360.1|	2654192	2654205	AAAC	13	-	3	TTGT
gi|514486632|gb|KE346360.1|	2654215	2654228	AATAC	13	-	2	TTGTA
gi|514486632|gb|KE346360.1|	2654368	2654380	AGC	12	+	4	GCA
gi|514486632|gb|KE346360.1|	2655572	2655603	A	31	-	31	T
gi|514486632|gb|KE346360.1|	2655760	2655781	A	21	-	21	T
gi|514486632|gb|KE346360.1|	2655949	2655961	AAAAAC	12	+	2	AAAAAC
gi|514486632|gb|KE346360.1|	2656180	2656195	AAAC	15	+	3	CAAA
gi|514486632|gb|KE346360.1|	2656196	2656222	A	26	-	26	T
gi|514486632|gb|KE346360.1|	2656579	2656598	A	19	-	19	T
gi|514486632|gb|KE346360.1|	2656636	2656657	A	21	-	21	T
gi|514486632|gb|KE346360.1|	2656858	2656872	A	14	-	14	T
gi|514486632|gb|KE346360.1|	2656902	2656914	A	12	-	12	T
gi|514486632|gb|KE346360.1|	2656933	2656950	A	17	-	17	T
gi|514486632|gb|KE346360.1|	2656956	2656968	AAAGG	12	-	2	CCTTT
gi|514486632|gb|KE346360.1|	2657110	2657124	A	14	-	14	T
gi|514486632|gb|KE346360.1|	2657191	2657212	A	21	-	21	T
gi|514486632|gb|KE346360.1|	2657528	2657541	AAAACC	13	-	2	TTGGTT
gi|514486632|gb|KE346360.1|	2657538	2657550	AAAACC	12	-	2	TTTGGT
gi|514486632|gb|KE346360.1|	2657574	2657588	A	14	-	14	T
gi|514486632|gb|KE346360.1|	2657761	2657788	A	27	-	27	T
gi|514486632|gb|KE346360.1|	2657791	2657816	A	25	-	25	T
gi|514486632|gb|KE346360.1|	2659454	2659470	AAGAGG	16	-	2	CCTCTT
gi|514486632|gb|KE346360.1|	2659606	2659618	AACAGG	12	-	2	TCCTGT
gi|514486632|gb|KE346360.1|	2660549	2660561	ACGGCG	12	-	2	TCGCCG
gi|514486632|gb|KE346360.1|	2660807	2660825	A	18	+	18	A
gi|514486632|gb|KE346360.1|	2661352	2661364	ATGCCC	12	+	2	CATGCC
gi|514486632|gb|KE346360.1|	2661544	2661571	AAAAC	27	+	5	AAACA
gi|514486632|gb|KE346360.1|	2661572	2661584	A	12	+	12	A
gi|514486632|gb|KE346360.1|	2662076	2662088	A	12	+	12	A
gi|514486632|gb|KE346360.1|	2662414	2662426	ACGGC	12	+	2	ACGGC
gi|514486632|gb|KE346360.1|	2662534	2662551	AC	17	-	8	TG
gi|514486632|gb|KE346360.1|	2662546	2662560	ACACAG	14	-	2	TGTGTC
gi|514486632|gb|KE346360.1|	2662597	2662620	A	23	+	23	A
gi|514486632|gb|KE346360.1|	2662634	2662660	A	26	+	26	A
gi|514486632|gb|KE346360.1|	2662771	2662784	AAACG	13	+	2	ACGAA
gi|514486632|gb|KE346360.1|	2662789	2662802	ACTG	13	-	3	CAGT
gi|514486632|gb|KE346360.1|	2663124	2663156	AGC	32	-	10	CTG
gi|514486632|gb|KE346360.1|	2664030	2664042	AGAGG	12	-	2	TCTCC
gi|514486632|gb|KE346360.1|	2664371	2664383	AAGACT	12	+	2	GACTAA
gi|514486632|gb|KE346360.1|	2664728	2664741	AACTG	13	+	2	TGAAC
gi|514486632|gb|KE346360.1|	2665055	2665068	A	13	+	13	A
gi|514486632|gb|KE346360.1|	2665661	2665675	AGC	14	+	4	GCA
gi|514486632|gb|KE346360.1|	2665880	2665899	ACG	19	+	6	GAC
gi|514486632|gb|KE346360.1|	2665924	2665942	AC	18	+	9	CA
gi|514486632|gb|KE346360.1|	2666015	2666028	AATCCT	13	-	2	TAGGAT
gi|514486632|gb|KE346360.1|	2666848	2666860	AGATCC	12	-	2	TCTGGA
gi|514486632|gb|KE346360.1|	2667405	2667422	A	17	-	17	T
gi|514486632|gb|KE346360.1|	2667876	2667888	AAAAAC	12	-	2	TTTTTG
gi|514486632|gb|KE346360.1|	2668566	2668578	ACGGGC	12	+	2	ACGGGC
gi|514486632|gb|KE346360.1|	2668602	2668619	ACG	17	+	5	CGA
gi|514486632|gb|KE346360.1|	2668620	2668634	ATC	14	-	4	TGA
gi|514486632|gb|KE346360.1|	2668667	2668679	CCG	12	-	4	GGC
gi|514486632|gb|KE346360.1|	2669049	2669061	AAAAGG	12	+	2	AAAAGG
gi|514486632|gb|KE346360.1|	2670804	2670816	AAC	12	+	4	CAA
gi|514486632|gb|KE346360.1|	2671339	2671351	AAGAGG	12	-	2	CTCTTC
gi|514486632|gb|KE346360.1|	2672052	2672065	AGC	13	+	4	AGC
gi|514486632|gb|KE346360.1|	2674104	2674117	A	13	+	13	A
gi|514486632|gb|KE346360.1|	2674118	2674130	A	12	+	12	A
gi|514486632|gb|KE346360.1|	2674131	2674147	A	16	+	16	A
gi|514486632|gb|KE346360.1|	2674185	2674207	A	22	-	22	T
gi|514486632|gb|KE346360.1|	2674563	2674575	A	12	+	12	A
gi|514486632|gb|KE346360.1|	2674734	2674748	AGGG	14	+	3	GGAG
gi|514486632|gb|KE346360.1|	2674924	2674936	AAAAAG	12	+	2	GAAAAA
gi|514486632|gb|KE346360.1|	2675151	2675181	A	30	+	30	A
gi|514486632|gb|KE346360.1|	2675377	2675400	A	23	+	23	A
gi|514486632|gb|KE346360.1|	2675851	2675876	AC	25	+	12	AC
gi|514486632|gb|KE346360.1|	2676892	2676905	AAAC	13	+	3	AACA
gi|514486632|gb|KE346360.1|	2678374	2678387	AAAAG	13	+	2	AAGAA
gi|514486632|gb|KE346360.1|	2679279	2679310	AAC	31	+	10	AAC
gi|514486632|gb|KE346360.1|	2679684	2679700	AAGGGG	16	+	2	GGGAAG
gi|514486632|gb|KE346360.1|	2679870	2679886	AAG	16	+	5	GAA
gi|514486632|gb|KE346360.1|	2680142	2680155	A	13	-	13	T
gi|514486632|gb|KE346360.1|	2680882	2680895	ACAG	13	+	3	AGAC
gi|514486632|gb|KE346360.1|	2681749	2681761	AAC	12	+	4	CAA
gi|514486632|gb|KE346360.1|	2681760	2681777	AAAAAC	17	+	2	AAAAAC
gi|514486632|gb|KE346360.1|	2681794	2681809	AAC	15	+	5	CAA
gi|514486632|gb|KE346360.1|	2682023	2682036	AAAAGG	13	+	2	AAGGAA
gi|514486632|gb|KE346360.1|	2682042	2682054	AAGGAC	12	+	2	ACAAGG
gi|514486632|gb|KE346360.1|	2682385	2682410	A	25	+	25	A
gi|514486632|gb|KE346360.1|	2684909	2684921	AC	12	-	6	TG
gi|514486632|gb|KE346360.1|	2685183	2685203	AAC	20	+	6	CAA
gi|514486632|gb|KE346360.1|	2685486	2685498	AGGC	12	+	3	GCAG
gi|514486632|gb|KE346360.1|	2685814	2685828	AC	14	-	7	TG
gi|514486632|gb|KE346360.1|	2686244	2686256	AACGC	12	+	2	CGCAA
gi|514486632|gb|KE346360.1|	2686609	2686623	AAGCTG	14	-	2	TCAGCT
gi|514486632|gb|KE346360.1|	2687098	2687110	AAACTG	12	-	2	TTTCAG
gi|514486632|gb|KE346360.1|	2687133	2687145	AGGCG	12	-	2	CCTCG
gi|514486632|gb|KE346360.1|	2687480	2687494	CCG	14	+	4	CCG
gi|514486632|gb|KE346360.1|	2687737	2687766	ACGAGG	29	+	4	GACGAG
gi|514486632|gb|KE346360.1|	2687848	2687877	ACG	29	+	9	GAC
gi|514486632|gb|KE346360.1|	2687875	2687897	ATC	22	-	7	GAT
gi|514486632|gb|KE346360.1|	2687913	2687934	ACG	21	+	7	CGA
gi|514486632|gb|KE346360.1|	2688142	2688154	AAATCC	12	+	2	TCCAAA
gi|514486632|gb|KE346360.1|	2688502	2688515	ACTCG	13	+	2	TCGAC
gi|514486632|gb|KE346360.1|	2689123	2689136	CCGGCG	13	+	2	GCGCCG
gi|514486632|gb|KE346360.1|	2689511	2689524	ACCATC	13	-	2	TGGTGA
gi|514486632|gb|KE346360.1|	2689743	2689755	ACCCAG	12	-	2	GGTCTG
gi|514486632|gb|KE346360.1|	2689842	2689855	AGG	13	+	4	GAG
gi|514486632|gb|KE346360.1|	2691143	2691157	AGC	14	-	4	CTG
gi|514486632|gb|KE346360.1|	2691299	2691312	A	13	-	13	T
gi|514486632|gb|KE346360.1|	2692009	2692030	A	21	+	21	A
gi|514486632|gb|KE346360.1|	2692403	2692416	A	13	-	13	T
gi|514486632|gb|KE346360.1|	2692513	2692525	AGCTGC	12	+	2	CTGCAG
gi|514486632|gb|KE346360.1|	2692643	2692661	A	18	+	18	A
gi|514486632|gb|KE346360.1|	2692662	2692677	A	15	+	15	A
gi|514486632|gb|KE346360.1|	2692899	2692915	A	16	+	16	A
gi|514486632|gb|KE346360.1|	2692957	2692970	A	13	-	13	T
gi|514486632|gb|KE346360.1|	2693039	2693051	ACAGCG	12	-	2	TCGCTG
gi|514486632|gb|KE346360.1|	2693196	2693210	AGGCCG	14	+	2	GGCCGA
gi|514486632|gb|KE346360.1|	2693206	2693218	AGGG	12	+	3	GAGG
gi|514486632|gb|KE346360.1|	2694343	2694355	AACGC	12	-	2	CGTTG
gi|514486632|gb|KE346360.1|	2695385	2695401	AAAC	16	+	4	CAAA
gi|514486632|gb|KE346360.1|	2695765	2695778	A	13	+	13	A
gi|514486632|gb|KE346360.1|	2695995	2696018	AG	23	+	11	GA
gi|514486632|gb|KE346360.1|	2696156	2696179	A	23	+	23	A
gi|514486632|gb|KE346360.1|	2696295	2696315	A	20	-	20	T
gi|514486632|gb|KE346360.1|	2696537	2696549	A	12	-	12	T
gi|514486632|gb|KE346360.1|	2696550	2696570	A	20	-	20	T
gi|514486632|gb|KE346360.1|	2696948	2696962	AGAGC	14	-	2	GCTCT
gi|514486632|gb|KE346360.1|	2698306	2698318	AGG	12	+	4	GAG
gi|514486632|gb|KE346360.1|	2698974	2698986	AAAGAC	12	-	2	TCTTTG
gi|514486632|gb|KE346360.1|	2699232	2699244	AGAGGG	12	+	2	AGGGAG
gi|514486632|gb|KE346360.1|	2701412	2701424	AGGGGG	12	-	2	CCTCCC
gi|514486632|gb|KE346360.1|	2701959	2701983	AAAC	24	+	6	CAAA
gi|514486632|gb|KE346360.1|	2703085	2703097	AGC	12	-	4	GCT
gi|514486632|gb|KE346360.1|	2703105	2703127	AGC	22	-	7	TGC
gi|514486632|gb|KE346360.1|	2703973	2703986	AACGC	13	+	2	CGCAA
gi|514486632|gb|KE346360.1|	2706583	2706596	AAAACC	13	+	2	AAAACC
gi|514486632|gb|KE346360.1|	2706772	2706785	ACACC	13	+	2	CACCA
gi|514486632|gb|KE346360.1|	2707152	2707164	AATG	12	-	3	CATT
gi|514486632|gb|KE346360.1|	2707319	2707331	A	12	-	12	T
gi|514486632|gb|KE346360.1|	2707916	2707928	AAGAGG	12	-	2	TCTTCC
gi|514486632|gb|KE346360.1|	2707955	2707969	AAAGAC	14	-	2	TCTTTG
gi|514486632|gb|KE346360.1|	2708073	2708085	AACTAC	12	+	2	CAACTA
gi|514486632|gb|KE346360.1|	2708200	2708213	AGC	13	+	4	GCA
gi|514486632|gb|KE346360.1|	2708362	2708377	AAC	15	-	5	TTG
gi|514486632|gb|KE346360.1|	2708405	2708417	ACACTC	12	-	2	TGTGAG
gi|514486632|gb|KE346360.1|	2708807	2708823	AAAC	16	+	4	CAAA
gi|514486632|gb|KE346360.1|	2708863	2708875	AGC	12	+	4	GCA
gi|514486632|gb|KE346360.1|	2709044	2709065	A	21	-	21	T
gi|514486632|gb|KE346360.1|	2709121	2709146	ACG	25	-	8	TCG
gi|514486632|gb|KE346360.1|	2709209	2709227	ACGC	18	+	4	CGCA
gi|514486632|gb|KE346360.1|	2709233	2709252	A	19	-	19	T
gi|514486632|gb|KE346360.1|	2709462	2709474	AAAAAG	12	-	2	TTTTTC
gi|514486632|gb|KE346360.1|	2709654	2709670	A	16	-	16	T
gi|514486632|gb|KE346360.1|	2709666	2709678	AAAATG	12	-	2	TTTTCA
gi|514486632|gb|KE346360.1|	2709689	2709701	AAAAAG	12	-	2	CTTTTT
gi|514486632|gb|KE346360.1|	2711019	2711033	ACGATG	14	-	2	TCGTCA
gi|514486632|gb|KE346360.1|	2711039	2711061	ATC	22	+	7	ATC
gi|514486632|gb|KE346360.1|	2711062	2711076	ATC	14	+	4	CAT
gi|514486632|gb|KE346360.1|	2711077	2711091	ATC	14	+	4	CAT
gi|514486632|gb|KE346360.1|	2711134	2711153	ACGAGG	19	-	3	CGTCCT
gi|514486632|gb|KE346360.1|	2711380	2711392	ACCC	12	-	3	GTGG
gi|514486632|gb|KE346360.1|	2711497	2711509	AAAAGC	12	+	2	AGCAAA
gi|514486632|gb|KE346360.1|	2711575	2711589	ACACTC	14	-	2	GTGTGA
gi|514486632|gb|KE346360.1|	2711643	2711655	ATC	12	-	4	TGA
gi|514486632|gb|KE346360.1|	2712139	2712151	ACCACG	12	-	2	TCGTGG
gi|514486632|gb|KE346360.1|	2712443	2712459	AAG	16	-	5	CTT
gi|514486632|gb|KE346360.1|	2712634	2712658	A	24	-	24	T
gi|514486632|gb|KE346360.1|	2712669	2712681	AAACGC	12	-	2	GCGTTT
gi|514486632|gb|KE346360.1|	2712830	2712846	A	16	+	16	A
gi|514486632|gb|KE346360.1|	2712897	2712913	AAACCC	16	+	2	CCAAAC
gi|514486632|gb|KE346360.1|	2712939	2712954	A	15	+	15	A
gi|514486632|gb|KE346360.1|	2713288	2713300	AAG	12	-	4	TTC
gi|514486632|gb|KE346360.1|	2713786	2713800	ACACC	14	+	2	CACAC
gi|514486632|gb|KE346360.1|	2713858	2713876	AC	18	+	9	CA
gi|514486632|gb|KE346360.1|	2714211	2714226	ACG	15	-	5	TCG
gi|514486632|gb|KE346360.1|	2714613	2714627	AAGACG	14	-	2	TCGTCT
gi|514486632|gb|KE346360.1|	2714653	2714672	AGC	19	-	6	TGC
gi|514486632|gb|KE346360.1|	2715136	2715148	ACG	12	+	4	CGA
gi|514486632|gb|KE346360.1|	2715395	2715418	AGC	23	-	7	GCT
gi|514486632|gb|KE346360.1|	2715509	2715522	AGC	13	+	4	GCA
gi|514486632|gb|KE346360.1|	2715533	2715550	AGCCGC	17	+	2	GCAGCC
gi|514486632|gb|KE346360.1|	2715822	2715838	CCGGCG	16	+	2	CGCCGG
gi|514486632|gb|KE346360.1|	2715879	2715904	CCG	25	-	8	GCG
gi|514486632|gb|KE346360.1|	2716100	2716112	AGC	12	-	4	TGC
gi|514486632|gb|KE346360.1|	2716277	2716289	ACCACG	12	-	2	GTCGTG
gi|514486632|gb|KE346360.1|	2716336	2716348	CCG	12	+	4	CGC
gi|514486632|gb|KE346360.1|	2717405	2717417	AGGGGG	12	+	2	GAGGGG
gi|514486632|gb|KE346360.1|	2718530	2718542	AGGGGG	12	+	2	GAGGGG
gi|514486632|gb|KE346360.1|	2719059	2719071	AAGCCC	12	+	2	GCCCAA
gi|514486632|gb|KE346360.1|	2719700	2719712	AAGAG	12	-	2	CTCTT
gi|514486632|gb|KE346360.1|	2719806	2719822	AGGGGG	16	-	2	CCCCCT
gi|514486632|gb|KE346360.1|	2720052	2720064	ACGCG	12	+	2	GACGC
gi|514486632|gb|KE346360.1|	2721173	2721193	ACCGCC	20	-	3	GGCGGT
gi|514486632|gb|KE346360.1|	2721599	2721618	AG	19	-	9	CT
gi|514486632|gb|KE346360.1|	2721689	2721701	AAGAGG	12	-	2	TCTTCC
gi|514486632|gb|KE346360.1|	2721914	2721928	AGC	14	-	4	GCT
gi|514486632|gb|KE346360.1|	2721967	2721992	AGC	25	-	8	TGC
gi|514486632|gb|KE346360.1|	2722436	2722448	ATGCCC	12	-	2	ATGGGC
gi|514486632|gb|KE346360.1|	2722510	2722522	ACG	12	+	4	CGA
gi|514486632|gb|KE346360.1|	2722517	2722530	ACGATG	13	+	2	GACGAT
gi|514486632|gb|KE346360.1|	2723629	2723641	ACCCCC	12	+	2	CACCCC
gi|514486632|gb|KE346360.1|	2724731	2724748	AACCTC	17	-	2	GGTTGA
gi|514486632|gb|KE346360.1|	2724899	2724914	AGGG	15	+	3	GAGG
gi|514486632|gb|KE346360.1|	2724911	2724925	AG	14	+	7	GA
gi|514486632|gb|KE346360.1|	2724926	2724940	AATGGG	14	-	2	CCCATT
gi|514486632|gb|KE346360.1|	2724980	2724997	ACC	17	+	5	CCA
gi|514486632|gb|KE346360.1|	2725014	2725030	ACTGCG	16	-	2	AGTCGC
gi|514486632|gb|KE346360.1|	2725168	2725194	A	26	+	26	A
gi|514486632|gb|KE346360.1|	2725592	2725610	AGCTC	18	-	3	GCTGA
gi|514486632|gb|KE346360.1|	2725683	2725695	A	12	+	12	A
gi|514486632|gb|KE346360.1|	2725983	2725995	AGGGGG	12	+	2	AGGGGG
gi|514486632|gb|KE346360.1|	2726426	2726438	ACTC	12	+	3	CTCA
gi|514486632|gb|KE346360.1|	2727532	2727556	ACC	24	+	8	ACC
gi|514486632|gb|KE346360.1|	2727613	2727625	AAAAC	12	+	2	AACAA
gi|514486632|gb|KE346360.1|	2727619	2727631	AAAAAC	12	+	2	ACAAAA
gi|514486632|gb|KE346360.1|	2727636	2727651	A	15	+	15	A
gi|514486632|gb|KE346360.1|	2728864	2728879	A	15	+	15	A
gi|514486632|gb|KE346360.1|	2729542	2729570	A	28	+	28	A
gi|514486632|gb|KE346360.1|	2729891	2729912	AAAC	21	+	5	AAAC
gi|514486632|gb|KE346360.1|	2729913	2729928	AAAC	15	+	3	ACAA
gi|514486632|gb|KE346360.1|	2730003	2730015	AACAC	12	+	2	AACAC
gi|514486632|gb|KE346360.1|	2730205	2730219	A	14	+	14	A
gi|514486632|gb|KE346360.1|	2730767	2730779	AAGAC	12	-	2	TTGTC
gi|514486632|gb|KE346360.1|	2732257	2732269	AGC	12	-	4	TGC
gi|514486632|gb|KE346360.1|	2732320	2732344	AAC	24	-	8	TGT
gi|514486632|gb|KE346360.1|	2732339	2732353	AACCAC	14	-	2	GTTGTG
gi|514486632|gb|KE346360.1|	2732368	2732391	AGC	23	-	7	TGC
gi|514486632|gb|KE346360.1|	2733144	2733172	A	28	+	28	A
gi|514486632|gb|KE346360.1|	2733220	2733232	A	12	+	12	A
gi|514486632|gb|KE346360.1|	2733628	2733649	A	21	+	21	A
gi|514486632|gb|KE346360.1|	2733725	2733737	AAGCCC	12	+	2	AGCCCA
gi|514486632|gb|KE346360.1|	2733836	2733848	A	12	-	12	T
gi|514486632|gb|KE346360.1|	2733844	2733858	AAAAG	14	-	2	TTTTC
gi|514486632|gb|KE346360.1|	2733854	2733869	A	15	-	15	T
gi|514486632|gb|KE346360.1|	2733895	2733917	A	22	-	22	T
gi|514486632|gb|KE346360.1|	2734111	2734128	A	17	+	17	A
gi|514486632|gb|KE346360.1|	2734468	2734480	AAGAGC	12	+	2	AGCAAG
gi|514486632|gb|KE346360.1|	2734509	2734542	A	33	+	33	A
gi|514486632|gb|KE346360.1|	2734615	2734628	AAGGG	13	+	2	GGGAA
gi|514486632|gb|KE346360.1|	2735015	2735028	A	13	+	13	A
gi|514486632|gb|KE346360.1|	2735816	2735838	A	22	+	22	A
gi|514486632|gb|KE346360.1|	2736039	2736055	A	16	-	16	T
gi|514486632|gb|KE346360.1|	2736288	2736311	A	23	+	23	A
gi|514486632|gb|KE346360.1|	2736577	2736590	A	13	-	13	T
gi|514486632|gb|KE346360.1|	2736594	2736615	A	21	-	21	T
gi|514486632|gb|KE346360.1|	2736617	2736630	A	13	-	13	T
gi|514486632|gb|KE346360.1|	2736632	2736648	A	16	-	16	T
gi|514486632|gb|KE346360.1|	2736763	2736775	AGAGG	12	+	2	AGAGG
gi|514486632|gb|KE346360.1|	2736799	2736814	AAAGTC	15	+	2	AAGTCA
gi|514486632|gb|KE346360.1|	2736907	2736920	AAAAC	13	+	2	AACAA
gi|514486632|gb|KE346360.1|	2738044	2738056	ATGCGC	12	+	2	GCATGC
gi|514486632|gb|KE346360.1|	2738517	2738529	AAAAAC	12	+	2	CAAAAA
gi|514486632|gb|KE346360.1|	2740855	2740868	AGCGC	13	+	2	GCAGC
gi|514486632|gb|KE346360.1|	2741140	2741154	CCCCG	14	+	2	CCCCG
gi|514486632|gb|KE346360.1|	2741820	2741832	AAATG	12	+	2	TGAAA
gi|514486632|gb|KE346360.1|	2742340	2742354	ACCGCG	14	+	2	GCGACC
gi|514486632|gb|KE346360.1|	2742901	2742913	AGAGGC	12	+	2	AGAGGC
gi|514486632|gb|KE346360.1|	2743554	2743611	A	57	-	57	T
gi|514486632|gb|KE346360.1|	2744196	2744225	A	29	+	29	A
gi|514486632|gb|KE346360.1|	2745156	2745168	AAGGCC	12	+	2	GCCAAG
gi|514486632|gb|KE346360.1|	2745470	2745482	AAAG	12	+	3	AAGA
gi|514486632|gb|KE346360.1|	2745622	2745636	ACTCGC	14	+	2	CTCGCA
gi|514486632|gb|KE346360.1|	2745988	2746013	ACC	25	+	8	CAC
gi|514486632|gb|KE346360.1|	2747175	2747188	AACAGC	13	+	2	ACAGCA
gi|514486632|gb|KE346360.1|	2747557	2747569	ACAGCC	12	-	2	TGTGGC
gi|514486632|gb|KE346360.1|	2747612	2747641	A	29	-	29	T
gi|514486632|gb|KE346360.1|	2747636	2747648	AAAAAC	12	-	2	TTTTTG
gi|514486632|gb|KE346360.1|	2747862	2747881	AAAC	19	+	4	CAAA
gi|514486632|gb|KE346360.1|	2748155	2748178	AGC	23	-	7	TGC
gi|514486632|gb|KE346360.1|	2748176	2748190	AAC	14	-	4	TGT
gi|514486632|gb|KE346360.1|	2748549	2748566	A	17	-	17	T
gi|514486632|gb|KE346360.1|	2748899	2748926	AGC	27	-	9	GCT
gi|514486632|gb|KE346360.1|	2748948	2748963	AGC	15	-	5	CTG
gi|514486632|gb|KE346360.1|	2749849	2749861	AAATTC	12	+	2	CAAATT
gi|514486632|gb|KE346360.1|	2750094	2750106	ATCGC	12	+	2	CGCAT
gi|514486632|gb|KE346360.1|	2751631	2751643	AAAAAG	12	+	2	AAGAAA
gi|514486632|gb|KE346360.1|	2752112	2752124	AAAAAC	12	-	2	TTTGTT
gi|514486632|gb|KE346360.1|	2752119	2752133	AAC	14	-	4	TTG
gi|514486632|gb|KE346360.1|	2752134	2752146	AAC	12	-	4	TTG
gi|514486632|gb|KE346360.1|	2752790	2752803	AAACAC	13	-	2	TTTGTG
gi|514486632|gb|KE346360.1|	2752798	2752853	AC	55	-	27	TG
gi|514486632|gb|KE346360.1|	2753195	2753215	AAG	20	-	6	TTC
gi|514486632|gb|KE346360.1|	2753507	2753526	AAAAAC	19	-	3	GTTTTT
gi|514486632|gb|KE346360.1|	2753809	2753821	CCCGCG	12	-	2	CGCGGG
gi|514486632|gb|KE346360.1|	2754981	2754993	AC	12	-	6	TG
gi|514486632|gb|KE346360.1|	2754990	2755002	ACCCC	12	-	2	GTGGG
gi|514486632|gb|KE346360.1|	2755030	2755042	AAAAC	12	+	2	CAAAA
gi|514486632|gb|KE346360.1|	2755392	2755411	A	19	-	19	T
gi|514486632|gb|KE346360.1|	2755785	2755805	A	20	-	20	T
gi|514486632|gb|KE346360.1|	2755995	2756007	A	12	-	12	T
gi|514486632|gb|KE346360.1|	2756023	2756038	AAG	15	-	5	CTT
gi|514486632|gb|KE346360.1|	2756051	2756069	AG	18	-	9	TC
gi|514486632|gb|KE346360.1|	2756518	2756532	AAC	14	+	4	CAA
gi|514486632|gb|KE346360.1|	2756533	2756546	AAC	13	+	4	CAA
gi|514486632|gb|KE346360.1|	2756634	2756647	AAAAC	13	+	2	CAAAA
gi|514486632|gb|KE346360.1|	2757131	2757148	A	17	+	17	A
gi|514486632|gb|KE346360.1|	2758001	2758019	AGC	18	-	6	TGC
gi|514486632|gb|KE346360.1|	2758123	2758139	ACTCGG	16	-	2	AGTCCG
gi|514486632|gb|KE346360.1|	2758201	2758215	AAT	14	+	4	AAT
gi|514486632|gb|KE346360.1|	2758240	2758256	AC	16	-	8	TG
gi|514486632|gb|KE346360.1|	2758270	2758282	AATTC	12	+	2	ATTCA
gi|514486632|gb|KE346360.1|	2759041	2759080	AG	39	+	19	AG
gi|514486632|gb|KE346360.1|	2759081	2759111	AG	30	+	15	AG
gi|514486632|gb|KE346360.1|	2759110	2759129	AC	19	-	9	GT
gi|514486632|gb|KE346360.1|	2760305	2760331	AGC	26	+	8	GCA
gi|514486632|gb|KE346360.1|	2760396	2760409	ACG	13	+	4	ACG
gi|514486632|gb|KE346360.1|	2760487	2760499	ACCCCC	12	-	2	GGGGTG
gi|514486632|gb|KE346360.1|	2760532	2760544	AGGCGG	12	+	2	GGCGGA
gi|514486632|gb|KE346360.1|	2761658	2761671	AAAAAC	13	-	2	TTTGTT
gi|514486632|gb|KE346360.1|	2761676	2761688	AAACG	12	-	2	TTTCG
gi|514486632|gb|KE346360.1|	2761701	2761715	A	14	-	14	T
gi|514486632|gb|KE346360.1|	2761761	2761789	A	28	-	28	T
gi|514486632|gb|KE346360.1|	2761813	2761827	AAG	14	+	4	AGA
gi|514486632|gb|KE346360.1|	2761954	2761977	A	23	+	23	A
gi|514486632|gb|KE346360.1|	2762237	2762249	AATTCC	12	-	2	TGGAAT
gi|514486632|gb|KE346360.1|	2762458	2762471	AAGGGG	13	-	2	CCCTTC
gi|514486632|gb|KE346360.1|	2762595	2762609	AAC	14	+	4	AAC
gi|514486632|gb|KE346360.1|	2762607	2762622	A	15	+	15	A
gi|514486632|gb|KE346360.1|	2762701	2762716	AAGGGG	15	+	2	GGGGAA
gi|514486632|gb|KE346360.1|	2763127	2763143	AAAACT	16	+	2	AAAACT
gi|514486632|gb|KE346360.1|	2763354	2763366	A	12	+	12	A
gi|514486632|gb|KE346360.1|	2764548	2764572	AC	24	-	12	TG
gi|514486632|gb|KE346360.1|	2764905	2764917	AATCAC	12	+	2	AATCAC
gi|514486632|gb|KE346360.1|	2766130	2766145	ACTG	15	-	3	CAGT
gi|514486632|gb|KE346360.1|	2766158	2766170	AAACAG	12	+	2	AAACAG
gi|514486632|gb|KE346360.1|	2766234	2766259	AC	25	-	12	GT
gi|514486632|gb|KE346360.1|	2766434	2766448	AAG	14	-	4	TTC
gi|514486632|gb|KE346360.1|	2766470	2766523	A	53	-	53	T
gi|514486632|gb|KE346360.1|	2766521	2766533	AACC	12	-	3	TTGG
gi|514486632|gb|KE346360.1|	2766821	2766842	CCG	21	-	7	CGG
gi|514486632|gb|KE346360.1|	2766846	2766858	AGC	12	+	4	AGC
gi|514486632|gb|KE346360.1|	2767254	2767274	ACG	20	-	6	TCG
gi|514486632|gb|KE346360.1|	2768138	2768150	A	12	-	12	T
gi|514486632|gb|KE346360.1|	2768958	2768973	AAAAC	15	-	3	GTTTT
gi|514486632|gb|KE346360.1|	2768972	2768987	AAC	15	-	5	TTG
gi|514486632|gb|KE346360.1|	2769006	2769018	ACC	12	-	4	TGG
gi|514486632|gb|KE346360.1|	2771561	2771584	AAC	23	-	7	GTT
gi|514486632|gb|KE346360.1|	2771582	2771599	ACC	17	-	5	GTG
gi|514486632|gb|KE346360.1|	2771798	2771810	ATGCC	12	+	2	ATGCC
gi|514486632|gb|KE346360.1|	2771976	2771991	CCG	15	-	5	CGG
gi|514486632|gb|KE346360.1|	2772253	2772265	AGCGGC	12	+	2	GCAGCG
gi|514486632|gb|KE346360.1|	2772436	2772449	AAAGCC	13	-	2	GGCTTT
gi|514486632|gb|KE346360.1|	2772554	2772567	AAAAC	13	-	2	TGTTT
gi|514486632|gb|KE346360.1|	2772608	2772635	A	27	+	27	A
gi|514486632|gb|KE346360.1|	2772992	2773017	A	25	+	25	A
gi|514486632|gb|KE346360.1|	2773041	2773053	A	12	+	12	A
gi|514486632|gb|KE346360.1|	2773199	2773212	A	13	-	13	T
gi|514486632|gb|KE346360.1|	2773238	2773251	AAAGC	13	-	2	TTTGC
gi|514486632|gb|KE346360.1|	2773310	2773324	AATCAC	14	+	2	AATCAC
gi|514486632|gb|KE346360.1|	2773388	2773402	A	14	-	14	T
gi|514486632|gb|KE346360.1|	2774010	2774022	A	12	+	12	A
gi|514486632|gb|KE346360.1|	2774079	2774094	A	15	+	15	A
gi|514486632|gb|KE346360.1|	2775778	2775844	ACG	66	+	22	CGA
gi|514486632|gb|KE346360.1|	2777088	2777100	AATGTC	12	-	2	TTGACA
gi|514486632|gb|KE346360.1|	2778415	2778430	ACCGCC	15	+	2	CACCGC
gi|514486632|gb|KE346360.1|	2778625	2778638	ACGCC	13	-	2	GCGTG
gi|514486632|gb|KE346360.1|	2779296	2779310	AAAAC	14	-	2	TTTTG
gi|514486632|gb|KE346360.1|	2779679	2779693	AACTCG	14	+	2	CTCGAA
gi|514486632|gb|KE346360.1|	2780360	2780372	AGCGC	12	+	2	GCAGC
gi|514486632|gb|KE346360.1|	2780502	2780519	AGCC	17	-	4	GCTG
gi|514486632|gb|KE346360.1|	2780658	2780671	AAAAC	13	+	2	CAAAA
gi|514486632|gb|KE346360.1|	2780933	2780945	AGAGCG	12	-	2	GCTCTC
gi|514486632|gb|KE346360.1|	2781317	2781330	ATCC	13	+	3	TCCA
gi|514486632|gb|KE346360.1|	2781331	2781346	ATCC	15	+	3	CATC
gi|514486632|gb|KE346360.1|	2781495	2781508	A	13	-	13	T
gi|514486632|gb|KE346360.1|	2781571	2781584	AGGG	13	-	3	CCTC
gi|514486632|gb|KE346360.1|	2781710	2781731	A	21	-	21	T
gi|514486632|gb|KE346360.1|	2782047	2782059	A	12	-	12	T
gi|514486632|gb|KE346360.1|	2782065	2782079	A	14	-	14	T
gi|514486632|gb|KE346360.1|	2782094	2782106	A	12	-	12	T
gi|514486632|gb|KE346360.1|	2782108	2782120	A	12	-	12	T
gi|514486632|gb|KE346360.1|	2782320	2782357	A	37	-	37	T
gi|514486632|gb|KE346360.1|	2782724	2782740	ACTC	16	+	4	CTCA
gi|514486632|gb|KE346360.1|	2782770	2782794	A	24	-	24	T
gi|514486632|gb|KE346360.1|	2782924	2782942	AGC	18	-	6	CTG
gi|514486632|gb|KE346360.1|	2782983	2783088	AG	105	-	52	TC
gi|514486632|gb|KE346360.1|	2783299	2783311	ACGTCG	12	+	2	ACGTCG
gi|514486632|gb|KE346360.1|	2784981	2785000	AAG	19	-	6	CTT
gi|514486632|gb|KE346360.1|	2785815	2785827	AGC	12	+	4	AGC
gi|514486632|gb|KE346360.1|	2785844	2785857	AACAGC	13	+	2	CAGCAA
gi|514486632|gb|KE346360.1|	2786173	2786190	AG	17	-	8	CT
gi|514486632|gb|KE346360.1|	2786455	2786474	A	19	-	19	T
gi|514486632|gb|KE346360.1|	2786469	2786500	AAAAAC	31	-	5	TTTTTG
gi|514486632|gb|KE346360.1|	2787706	2787719	AAAAAC	13	-	2	TTTGTT
gi|514486632|gb|KE346360.1|	2787730	2787743	AAAACC	13	-	2	TTTTGG
gi|514486632|gb|KE346360.1|	2787780	2787806	AC	26	+	13	CA
gi|514486632|gb|KE346360.1|	2788902	2788914	AAAAAC	12	+	2	AAACAA
gi|514486632|gb|KE346360.1|	2789229	2789241	AAAAC	12	-	2	TTGTT
gi|514486632|gb|KE346360.1|	2789407	2789435	AAAAAC	28	-	4	TTTTTG
gi|514486632|gb|KE346360.1|	2792232	2792245	AAAGTC	13	-	2	ACTTTG
gi|514486632|gb|KE346360.1|	2793284	2793296	ACGGGG	12	+	2	GGACGG
gi|514486632|gb|KE346360.1|	2794579	2794593	AACCCG	14	-	2	GGTTCG
gi|514486632|gb|KE346360.1|	2794687	2794701	AATGAC	14	-	2	TCATTG
gi|514486632|gb|KE346360.1|	2796026	2796039	AAAAAT	13	-	2	TATTTT
gi|514486632|gb|KE346360.1|	2796049	2796063	AAAAAT	14	-	2	TTATTT
gi|514486632|gb|KE346360.1|	2796111	2796134	AAAAAT	23	-	3	TTTTTA
gi|514486632|gb|KE346360.1|	2797081	2797093	AAGCG	12	+	2	AGCGA
gi|514486632|gb|KE346360.1|	2797275	2797291	AAAAT	16	+	3	AAAAT
gi|514486632|gb|KE346360.1|	2800106	2800121	AAAT	15	-	3	TTTA
gi|514486632|gb|KE346360.1|	2800115	2800127	AAAAAT	12	-	2	TTATTT
gi|514486632|gb|KE346360.1|	2800268	2800280	ATCGCC	12	-	2	GCGATG
gi|514486632|gb|KE346360.1|	2800292	2800305	AACGAG	13	+	2	AACGAG
gi|514486632|gb|KE346360.1|	2800529	2800541	AACGGC	12	-	2	TTGCCG
gi|514486632|gb|KE346360.1|	2803552	2803587	ACG	35	+	11	GAC
gi|514486632|gb|KE346360.1|	2803894	2803906	AGCAGG	12	+	2	GAGCAG
gi|514486632|gb|KE346360.1|	2804099	2804112	AGCCCG	13	+	2	CCCGAG
gi|514486632|gb|KE346360.1|	2804762	2804774	ACACGC	12	-	2	GTGTGC
gi|514486632|gb|KE346360.1|	2806434	2806451	AAAAAT	17	+	2	AAAAAT
gi|514486632|gb|KE346360.1|	2806475	2806493	AAAAT	18	+	3	AAAAT
gi|514486632|gb|KE346360.1|	2806552	2806564	AAAAAG	12	+	2	GAAAAA
gi|514486632|gb|KE346360.1|	2808213	2808226	AAATAC	13	-	2	TGTATT
gi|514486632|gb|KE346360.1|	2809753	2809766	AATGCC	13	-	2	CATTGG
gi|514486632|gb|KE346360.1|	2810578	2810591	ACGGGC	13	+	2	GGGCAC
gi|514486632|gb|KE346360.1|	2813219	2813238	ACG	19	-	6	TCG
gi|514486632|gb|KE346360.1|	2813440	2813457	AACGGC	17	-	2	GTTGCC
gi|514486632|gb|KE346360.1|	2813468	2813483	AACGGC	15	-	2	CCGTTG
gi|514486632|gb|KE346360.1|	2814559	2814575	AAATG	16	+	3	AAATG
gi|514486632|gb|KE346360.1|	2815089	2815101	AAATCC	12	-	2	TTGGAT
gi|514486632|gb|KE346360.1|	2816345	2816365	A	20	+	20	A
gi|514486632|gb|KE346360.1|	2816693	2816709	A	16	+	16	A
gi|514486632|gb|KE346360.1|	2818238	2818259	A	21	-	21	T
gi|514486632|gb|KE346360.1|	2818618	2818633	AAAACC	15	+	2	CCAAAA
gi|514486632|gb|KE346360.1|	2818629	2818652	ACC	23	+	7	ACC
gi|514486632|gb|KE346360.1|	2818991	2819003	AAAGCG	12	+	2	CGAAAG
gi|514486632|gb|KE346360.1|	2819057	2819070	A	13	+	13	A
gi|514486632|gb|KE346360.1|	2819080	2819097	A	17	+	17	A
gi|514486632|gb|KE346360.1|	2819374	2819386	ACAGTC	12	+	2	CACAGT
gi|514486632|gb|KE346360.1|	2820276	2820288	ATCC	12	+	3	CCAT
gi|514486632|gb|KE346360.1|	2820657	2820676	AAAAAC	19	+	3	AAAAAC
gi|514486632|gb|KE346360.1|	2820705	2820718	AAAAC	13	+	2	AAACA
gi|514486632|gb|KE346360.1|	2820811	2820827	A	16	-	16	T
gi|514486632|gb|KE346360.1|	2820859	2820871	AAAGGG	12	+	2	GAAAGG
gi|514486632|gb|KE346360.1|	2822000	2822054	A	54	+	54	A
gi|514486632|gb|KE346360.1|	2822321	2822335	AAAAG	14	-	2	TTTTC
gi|514486632|gb|KE346360.1|	2822673	2822695	AAC	22	+	7	AAC
gi|514486632|gb|KE346360.1|	2823457	2823475	A	18	-	18	T
gi|514486632|gb|KE346360.1|	2823512	2823529	AAAAAT	17	-	2	TTTTTA
gi|514486632|gb|KE346360.1|	2823581	2823600	AAC	19	-	6	TTG
gi|514486632|gb|KE346360.1|	2823833	2823849	A	16	-	16	T
gi|514486632|gb|KE346360.1|	2824144	2824157	AGC	13	+	4	AGC
gi|514486632|gb|KE346360.1|	2824384	2824402	AGC	18	+	6	CAG
gi|514486632|gb|KE346360.1|	2824411	2824425	AGC	14	+	4	CAG
gi|514486632|gb|KE346360.1|	2824429	2824443	AGC	14	+	4	CAG
gi|514486632|gb|KE346360.1|	2826371	2826388	AGC	17	+	5	AGC
gi|514486632|gb|KE346360.1|	2827522	2827535	AACATG	13	-	2	TCATGT
gi|514486632|gb|KE346360.1|	2827722	2827734	AACTAC	12	+	2	TACAAC
gi|514486632|gb|KE346360.1|	2828076	2828114	AATC	38	+	9	CAAT
gi|514486632|gb|KE346360.1|	2828616	2828628	ACCCTC	12	+	2	CTCACC
gi|514486632|gb|KE346360.1|	2828878	2828890	A	12	-	12	T
gi|514486632|gb|KE346360.1|	2828941	2828954	A	13	-	13	T
gi|514486632|gb|KE346360.1|	2829002	2829023	A	21	+	21	A
gi|514486632|gb|KE346360.1|	2829256	2829269	AGCGGC	13	-	2	CCGCTG
gi|514486632|gb|KE346360.1|	2829637	2829649	AAAAAC	12	+	2	AACAAA
gi|514486632|gb|KE346360.1|	2829849	2829869	A	20	-	20	T
gi|514486632|gb|KE346360.1|	2830022	2830035	A	13	-	13	T
gi|514486632|gb|KE346360.1|	2830125	2830137	ACCGCC	12	+	2	GCCACC
gi|514486632|gb|KE346360.1|	2830308	2830329	ACC	21	-	7	GGT
gi|514486632|gb|KE346360.1|	2830398	2830411	A	13	-	13	T
gi|514486632|gb|KE346360.1|	2830429	2830446	AGC	17	-	5	TGC
gi|514486632|gb|KE346360.1|	2830444	2830457	AAC	13	-	4	TGT
gi|514486632|gb|KE346360.1|	2830467	2830481	ACTC	14	+	3	TCAC
gi|514486632|gb|KE346360.1|	2830926	2830938	ACACGT	12	+	2	TACACG
gi|514486632|gb|KE346360.1|	2831047	2831059	ATCGCC	12	+	2	TCGCCA
gi|514486632|gb|KE346360.1|	2831447	2831460	AAGCTC	13	+	2	CAAGCT
gi|514486632|gb|KE346360.1|	2834169	2834183	AGC	14	-	4	GCT
gi|514486632|gb|KE346360.1|	2834187	2834201	AGGCGG	14	-	2	CCGCCT
gi|514486632|gb|KE346360.1|	2834427	2834439	CCG	12	+	4	GCC
gi|514486632|gb|KE346360.1|	2835635	2835650	ACCGCC	15	+	2	CCGCCA
gi|514486632|gb|KE346360.1|	2835771	2835784	AGC	13	-	4	CTG
gi|514486632|gb|KE346360.1|	2836283	2836295	AAGGAC	12	+	2	GACAAG
gi|514486632|gb|KE346360.1|	2836291	2836304	AAGCTC	13	+	2	CAAGCT
gi|514486632|gb|KE346360.1|	2836736	2836751	AGAGGC	15	-	2	TCTGCC
gi|514486632|gb|KE346360.1|	2837063	2837075	ACGTCC	12	-	2	TGGACG
gi|514486632|gb|KE346360.1|	2837947	2837959	AAGG	12	-	3	TCCT
gi|514486632|gb|KE346360.1|	2838223	2838235	A	12	-	12	T
gi|514486632|gb|KE346360.1|	2838241	2838276	AAC	35	-	11	TTG
gi|514486632|gb|KE346360.1|	2838508	2838532	A	24	-	24	T
gi|514486632|gb|KE346360.1|	2838696	2838711	AAC	15	-	5	GTT
gi|514486632|gb|KE346360.1|	2838712	2838725	AACCAC	13	-	2	TGGTTG
gi|514486632|gb|KE346360.1|	2838927	2838941	ACGG	14	-	3	GTCC
gi|514486632|gb|KE346360.1|	2839706	2839726	A	20	-	20	T
gi|514486632|gb|KE346360.1|	2839740	2839761	AAGG	21	-	5	CCTT
gi|514486632|gb|KE346360.1|	2839946	2839959	AACAG	13	-	2	TTCTG
gi|514486632|gb|KE346360.1|	2841280	2841293	AGGCGG	13	+	2	GGAGGC
gi|514486632|gb|KE346360.1|	2841348	2841360	AAAAAC	12	-	2	TGTTTT
gi|514486632|gb|KE346360.1|	2841599	2841614	AATGTC	15	+	2	TCAATG
gi|514486632|gb|KE346360.1|	2841807	2841821	AAGG	14	-	3	TTCC
gi|514486632|gb|KE346360.1|	2841819	2841840	A	21	-	21	T
gi|514486632|gb|KE346360.1|	2841925	2841955	ATC	30	+	10	TCA
gi|514486632|gb|KE346360.1|	2842257	2842284	A	27	+	27	A
gi|514486632|gb|KE346360.1|	2842461	2842473	AAACGC	12	+	2	AACGCA
gi|514486632|gb|KE346360.1|	2842499	2842512	AAT	13	+	4	AAT
gi|514486632|gb|KE346360.1|	2842589	2842611	AAACCC	22	-	3	GGGTTT
gi|514486632|gb|KE346360.1|	2842612	2842628	AACCCT	16	-	2	GGGTTA
gi|514486632|gb|KE346360.1|	2842761	2842778	AC	17	-	8	GT
gi|514486632|gb|KE346360.1|	2842779	2842792	ACACTC	13	-	2	GTGAGT
gi|514486632|gb|KE346360.1|	2842874	2842887	AAAGTC	13	+	2	AAAGTC
gi|514486632|gb|KE346360.1|	2842949	2842961	ACGAG	12	-	2	TCTCG
gi|514486632|gb|KE346360.1|	2843521	2843533	ACG	12	+	4	CGA
gi|514486632|gb|KE346360.1|	2844476	2844489	AGAGCC	13	-	2	GGCTCT
gi|514486632|gb|KE346360.1|	2845526	2845544	AG	18	-	9	CT
gi|514486632|gb|KE346360.1|	2848813	2848840	AGC	27	+	9	AGC
gi|514486632|gb|KE346360.1|	2848887	2848900	AAGTGC	13	+	2	CAAGTG
gi|514486632|gb|KE346360.1|	2848979	2848992	AATCCT	13	+	2	AATCCT
gi|514486632|gb|KE346360.1|	2850439	2850452	AAAGAG	13	+	2	AGAGAA
gi|514486632|gb|KE346360.1|	2851414	2851432	AG	18	+	9	GA
gi|514486632|gb|KE346360.1|	2851833	2851845	ACTCG	12	+	2	ACTCG
gi|514486632|gb|KE346360.1|	2853229	2853246	AACAGC	17	-	2	CTGTTG
gi|514486632|gb|KE346360.1|	2853257	2853269	ATCCGC	12	-	2	GATGCG
gi|514486632|gb|KE346360.1|	2853376	2853388	CCGCG	12	-	2	CGCGG
gi|514486632|gb|KE346360.1|	2853541	2853553	ACC	12	-	4	GGT
gi|514486632|gb|KE346360.1|	2853614	2853626	AGC	12	-	4	CTG
gi|514486632|gb|KE346360.1|	2853638	2853658	ACT	20	+	6	CTA
gi|514486632|gb|KE346360.1|	2853653	2853667	ACTGCT	14	+	2	CTACTG
gi|514486632|gb|KE346360.1|	2853760	2853773	AAAACG	13	-	2	TTTCGT
gi|514486632|gb|KE346360.1|	2853881	2853899	AAAT	18	+	4	AAAT
gi|514486632|gb|KE346360.1|	2853906	2853920	AAAAG	14	+	2	AAAAG
gi|514486632|gb|KE346360.1|	2854234	2854246	AGGGG	12	-	2	TCCCC
gi|514486632|gb|KE346360.1|	2854247	2854262	AGC	15	+	5	AGC
gi|514486632|gb|KE346360.1|	2854600	2854615	AAGGGG	15	+	2	GGGGAA
gi|514486632|gb|KE346360.1|	2854729	2854742	AAGCAG	13	-	2	TTCTGC
gi|514486632|gb|KE346360.1|	2855119	2855131	AGGGGG	12	+	2	GAGGGG
gi|514486632|gb|KE346360.1|	2856230	2856242	AGGGGG	12	+	2	GAGGGG
gi|514486632|gb|KE346360.1|	2857217	2857230	AAAAC	13	-	2	GTTTT
gi|514486632|gb|KE346360.1|	2857710	2857723	AAC	13	+	4	CAA
gi|514486632|gb|KE346360.1|	2858018	2858042	ACG	24	+	8	CGA
gi|514486632|gb|KE346360.1|	2858916	2858928	ACGCTG	12	+	2	TGACGC
gi|514486632|gb|KE346360.1|	2860442	2860454	AGCGCC	12	+	2	GCGCCA
gi|514486632|gb|KE346360.1|	2860727	2860739	AGC	12	-	4	TGC
gi|514486632|gb|KE346360.1|	2860780	2860799	AAAC	19	-	4	TTGT
gi|514486632|gb|KE346360.1|	2861408	2861428	AG	20	-	10	CT
gi|514486632|gb|KE346360.1|	2862218	2862237	AC	19	+	9	CA
gi|514486632|gb|KE346360.1|	2862236	2862293	AG	57	-	28	CT
gi|514486632|gb|KE346360.1|	2862789	2862806	AAAT	17	-	4	TATT
gi|514486632|gb|KE346360.1|	2862800	2862820	AAAAAT	20	-	3	TTATTT
gi|514486632|gb|KE346360.1|	2862847	2862870	A	23	-	23	T
gi|514486632|gb|KE346360.1|	2863050	2863063	A	13	+	13	A
gi|514486632|gb|KE346360.1|	2863064	2863076	A	12	+	12	A
gi|514486632|gb|KE346360.1|	2863093	2863105	AAAGTC	12	+	2	AGTCAA
gi|514486632|gb|KE346360.1|	2863270	2863285	ACCG	15	-	3	CGGT
gi|514486632|gb|KE346360.1|	2863446	2863463	AAAAAT	17	-	2	TTTTTA
gi|514486632|gb|KE346360.1|	2863491	2863505	AAAAAT	14	-	2	TTTATT
gi|514486632|gb|KE346360.1|	2863702	2863731	A	29	+	29	A
gi|514486632|gb|KE346360.1|	2863970	2863984	A	14	+	14	A
gi|514486632|gb|KE346360.1|	2863997	2864015	A	18	+	18	A
gi|514486632|gb|KE346360.1|	2864167	2864180	ACACCC	13	-	2	GGTGTG
gi|514486632|gb|KE346360.1|	2864194	2864209	A	15	+	15	A
gi|514486632|gb|KE346360.1|	2864205	2864227	AAAATC	22	+	3	AAAATC
gi|514486632|gb|KE346360.1|	2864448	2864465	AACGTG	17	+	2	GTGAAC
gi|514486632|gb|KE346360.1|	2864501	2864518	AACGTG	17	+	2	GTGAAC
gi|514486632|gb|KE346360.1|	2864525	2864561	AC	36	-	18	GT
gi|514486632|gb|KE346360.1|	2864910	2864927	AACAG	17	-	3	TGTTC
gi|514486632|gb|KE346360.1|	2864946	2864959	A	13	-	13	T
gi|514486632|gb|KE346360.1|	2865485	2865498	AAGATC	13	+	2	ATCAAG
gi|514486632|gb|KE346360.1|	2866258	2866278	AAAC	20	-	5	TTTG
gi|514486632|gb|KE346360.1|	2866279	2866294	AAAC	15	-	3	TTGT
gi|514486632|gb|KE346360.1|	2866627	2866641	AAAAG	14	-	2	TTTTC
gi|514486632|gb|KE346360.1|	2866637	2866653	A	16	-	16	T
gi|514486632|gb|KE346360.1|	2867200	2867213	ATC	13	-	4	ATG
gi|514486632|gb|KE346360.1|	2868742	2868754	ACTGCG	12	+	2	CTGCGA
gi|514486632|gb|KE346360.1|	2868804	2868826	AGC	22	+	7	GCA
gi|514486632|gb|KE346360.1|	2870364	2870393	AGC	29	-	9	TGC
gi|514486632|gb|KE346360.1|	2870846	2870870	AGC	24	+	8	AGC
gi|514486632|gb|KE346360.1|	2871341	2871355	ACG	14	+	4	CGA
gi|514486632|gb|KE346360.1|	2871491	2871503	AGGATG	12	-	2	CTCATC
gi|514486632|gb|KE346360.1|	2871507	2871521	AGG	14	-	4	TCC
gi|514486632|gb|KE346360.1|	2871641	2871654	AGC	13	-	4	GCT
gi|514486632|gb|KE346360.1|	2871792	2871805	AGAGGC	13	+	2	GAGGCA
gi|514486632|gb|KE346360.1|	2872132	2872153	AACAGC	21	-	3	TGTTGC
gi|514486632|gb|KE346360.1|	2872447	2872459	AAACTC	12	-	2	AGTTTG
gi|514486632|gb|KE346360.1|	2872810	2872834	A	24	-	24	T
gi|514486632|gb|KE346360.1|	2874695	2874716	A	21	+	21	A
gi|514486632|gb|KE346360.1|	2874826	2874839	AACAAG	13	+	2	ACAAGA
gi|514486632|gb|KE346360.1|	2875024	2875036	AAGGCC	12	-	2	CTTGGC
gi|514486632|gb|KE346360.1|	2875130	2875146	A	16	+	16	A
gi|514486632|gb|KE346360.1|	2875228	2875251	AC	23	-	11	GT
gi|514486632|gb|KE346360.1|	2875437	2875449	AAGTC	12	+	2	CAAGT
gi|514486632|gb|KE346360.1|	2875716	2875728	ATCGC	12	-	2	TGCGA
gi|514486632|gb|KE346360.1|	2875812	2875846	A	34	-	34	T
gi|514486632|gb|KE346360.1|	2876216	2876232	A	16	+	16	A
gi|514486632|gb|KE346360.1|	2876892	2876921	A	29	-	29	T
gi|514486632|gb|KE346360.1|	2877088	2877102	AGCGGC	14	+	2	GCAGCG
gi|514486632|gb|KE346360.1|	2877159	2877171	ACGCCG	12	+	2	ACGCCG
gi|514486632|gb|KE346360.1|	2877495	2877514	AGC	19	+	6	AGC
gi|514486632|gb|KE346360.1|	2877764	2877782	ACC	18	+	6	CAC
gi|514486632|gb|KE346360.1|	2878548	2878561	AACAGC	13	+	2	CAACAG
gi|514486632|gb|KE346360.1|	2878650	2878664	AGC	14	+	4	CAG
gi|514486632|gb|KE346360.1|	2878683	2878697	AACAGC	14	+	2	CAGCAA
gi|514486632|gb|KE346360.1|	2878709	2878723	AAC	14	+	4	ACA
gi|514486632|gb|KE346360.1|	2878795	2878807	AATGGC	12	+	2	CAATGG
gi|514486632|gb|KE346360.1|	2879061	2879073	AAAAAC	12	-	2	TTTGTT
gi|514486632|gb|KE346360.1|	2879193	2879205	AGGG	12	-	3	CCCT
gi|514486632|gb|KE346360.1|	2879809	2879822	ACGG	13	+	3	ACGG
gi|514486632|gb|KE346360.1|	2879835	2879847	ACGGG	12	-	2	TCCCG
gi|514486632|gb|KE346360.1|	2879983	2880017	A	34	-	34	T
gi|514486632|gb|KE346360.1|	2880834	2880847	A	13	-	13	T
gi|514486632|gb|KE346360.1|	2881365	2881384	AAACAC	19	-	3	GTGTTT
gi|514486632|gb|KE346360.1|	2881380	2881396	AAAACC	16	-	2	TTTGGT
gi|514486632|gb|KE346360.1|	2881597	2881617	AC	20	+	10	CA
gi|514486632|gb|KE346360.1|	2881913	2881925	AAGCC	12	+	2	GCCAA
gi|514486632|gb|KE346360.1|	2882006	2882020	ATC	14	+	4	TCA
gi|514486632|gb|KE346360.1|	2882018	2882032	ACG	14	-	4	TCG
gi|514486632|gb|KE346360.1|	2882310	2882327	ATC	17	-	5	ATG
gi|514486632|gb|KE346360.1|	2882793	2882806	AAAC	13	-	3	TGTT
gi|514486632|gb|KE346360.1|	2883036	2883050	AATGAG	14	-	2	TCTCAT
gi|514486632|gb|KE346360.1|	2883067	2883087	AAAATC	20	-	3	TGATTT
gi|514486632|gb|KE346360.1|	2883291	2883306	AAC	15	+	5	CAA
gi|514486632|gb|KE346360.1|	2883865	2883878	AAC	13	+	4	ACA
gi|514486632|gb|KE346360.1|	2883929	2883942	ACCC	13	+	3	CACC
gi|514486632|gb|KE346360.1|	2884470	2884482	AACTCG	12	-	2	TTCGAG
gi|514486632|gb|KE346360.1|	2885650	2885664	AATGCG	14	+	2	GAATGC
gi|514486632|gb|KE346360.1|	2885793	2885807	ACCTCG	14	-	2	GTCGAG
gi|514486632|gb|KE346360.1|	2886742	2886754	AAAAAC	12	+	2	CAAAAA
gi|514486632|gb|KE346360.1|	2887554	2887567	A	13	+	13	A
gi|514486632|gb|KE346360.1|	2887579	2887600	A	21	+	21	A
gi|514486632|gb|KE346360.1|	2888680	2888698	A	18	+	18	A
gi|514486632|gb|KE346360.1|	2888699	2888713	A	14	+	14	A
gi|514486632|gb|KE346360.1|	2889254	2889269	AG	15	+	7	AG
gi|514486632|gb|KE346360.1|	2889341	2889358	A	17	+	17	A
gi|514486632|gb|KE346360.1|	2889354	2889366	AAAAGT	12	+	2	AAAAGT
gi|514486632|gb|KE346360.1|	2889375	2889389	AAATGG	14	+	2	AATGGA
gi|514486632|gb|KE346360.1|	2890917	2890931	AGC	14	-	4	TGC
gi|514486632|gb|KE346360.1|	2890949	2890962	AGCGGC	13	+	2	GGCAGC
gi|514486632|gb|KE346360.1|	2892613	2892631	AG	18	-	9	TC
gi|514486632|gb|KE346360.1|	2892640	2892717	AG	77	-	38	CT
gi|514486632|gb|KE346360.1|	2892871	2892883	AAGC	12	-	3	TGCT
gi|514486632|gb|KE346360.1|	2893019	2893038	A	19	+	19	A
gi|514486632|gb|KE346360.1|	2893430	2893442	AC	12	-	6	TG
gi|514486632|gb|KE346360.1|	2894028	2894042	AC	14	+	7	CA
gi|514486632|gb|KE346360.1|	2894074	2894086	AGGGGG	12	+	2	GGGGGA
gi|514486632|gb|KE346360.1|	2894094	2894137	AG	43	+	21	GA
gi|514486632|gb|KE346360.1|	2895380	2895394	AAAATC	14	+	2	AATCAA
gi|514486632|gb|KE346360.1|	2896130	2896150	AGC	20	-	6	TGC
gi|514486632|gb|KE346360.1|	2896787	2896799	ACCAGC	12	-	2	TGGTGC
gi|514486632|gb|KE346360.1|	2896916	2896928	ACAGGT	12	+	2	AGGTAC
gi|514486632|gb|KE346360.1|	2898510	2898524	ACGGCG	14	-	2	CGTCGC
gi|514486632|gb|KE346360.1|	2898730	2898753	AAC	23	-	7	GTT
gi|514486632|gb|KE346360.1|	2898751	2898769	ACG	18	-	6	GTC
gi|514486632|gb|KE346360.1|	2899456	2899470	AAGCAG	14	+	2	AGCAGA
gi|514486632|gb|KE346360.1|	2900574	2900588	AAAG	14	+	3	GAAA
gi|514486632|gb|KE346360.1|	2901514	2901529	AGCGGC	15	-	2	GCTGCC
gi|514486632|gb|KE346360.1|	2901915	2901927	ACGGCG	12	-	2	TCGCCG
gi|514486632|gb|KE346360.1|	2902127	2902153	AAC	26	-	8	TGT
gi|514486632|gb|KE346360.1|	2902285	2902297	AGC	12	-	4	GCT
gi|514486632|gb|KE346360.1|	2903271	2903284	ACTGG	13	+	2	TGGAC
gi|514486632|gb|KE346360.1|	2903552	2903572	A	20	+	20	A
gi|514486632|gb|KE346360.1|	2903613	2903625	AAGGGG	12	+	2	AGGGGA
gi|514486632|gb|KE346360.1|	2904030	2904045	AAC	15	+	5	ACA
gi|514486632|gb|KE346360.1|	2904501	2904513	AAAAAT	12	+	2	TAAAAA
gi|514486632|gb|KE346360.1|	2904519	2904551	A	32	-	32	T
gi|514486632|gb|KE346360.1|	2904772	2904784	ACCAGC	12	-	2	TGCTGG
gi|514486632|gb|KE346360.1|	2905105	2905139	A	34	-	34	T
gi|514486632|gb|KE346360.1|	2905312	2905326	AAT	14	+	4	AAT
gi|514486632|gb|KE346360.1|	2905707	2905728	A	21	+	21	A
gi|514486632|gb|KE346360.1|	2905787	2905799	ACAGCG	12	-	2	CTGTCG
gi|514486632|gb|KE346360.1|	2905851	2905864	ACC	13	+	4	CAC
gi|514486632|gb|KE346360.1|	2905889	2905904	ACG	15	-	5	TCG
gi|514486632|gb|KE346360.1|	2907743	2907755	A	12	+	12	A
gi|514486632|gb|KE346360.1|	2907769	2907781	A	12	+	12	A
gi|514486632|gb|KE346360.1|	2909262	2909274	AGCCGC	12	+	2	GCAGCC
gi|514486632|gb|KE346360.1|	2909351	2909368	A	17	+	17	A
gi|514486632|gb|KE346360.1|	2909548	2909560	A	12	-	12	T
gi|514486632|gb|KE346360.1|	2909567	2909580	A	13	-	13	T
gi|514486632|gb|KE346360.1|	2909738	2909759	A	21	+	21	A
gi|514486632|gb|KE346360.1|	2909820	2909839	A	19	+	19	A
gi|514486632|gb|KE346360.1|	2910032	2910056	A	24	-	24	T
gi|514486632|gb|KE346360.1|	2910090	2910113	AAAAAG	23	-	3	TTTTTC
gi|514486632|gb|KE346360.1|	2910255	2910278	A	23	+	23	A
gi|514486632|gb|KE346360.1|	2910337	2910350	ACT	13	-	4	AGT
gi|514486632|gb|KE346360.1|	2910460	2910478	A	18	+	18	A
gi|514486632|gb|KE346360.1|	2910783	2910795	AAAAAG	12	-	2	TCTTTT
gi|514486632|gb|KE346360.1|	2910846	2910858	AACACC	12	+	2	CCAACA
gi|514486632|gb|KE346360.1|	2911657	2911669	ACCAG	12	+	2	CCAGA
gi|514486632|gb|KE346360.1|	2911771	2911783	ACAGCG	12	+	2	ACAGCG
gi|514486632|gb|KE346360.1|	2912194	2912209	AGC	15	+	5	AGC
gi|514486632|gb|KE346360.1|	2912216	2912228	AGCGGC	12	+	2	GCAGCG
gi|514486632|gb|KE346360.1|	2913084	2913096	ACGAGC	12	-	2	GTGCTC
gi|514486632|gb|KE346360.1|	2915049	2915061	ACACG	12	+	2	GACAC
gi|514486632|gb|KE346360.1|	2915116	2915194	AAC	78	+	26	AAC
gi|514486632|gb|KE346360.1|	2917275	2917287	AGGG	12	-	3	CCTC
gi|514486632|gb|KE346360.1|	2917345	2917363	AAAATC	18	+	3	CAAAAT
gi|514486632|gb|KE346360.1|	2917430	2917445	A	15	+	15	A
gi|514486632|gb|KE346360.1|	2918639	2918651	AGC	12	-	4	CTG
gi|514486632|gb|KE346360.1|	2918823	2918835	AGAGGC	12	+	2	AGAGGC
gi|514486632|gb|KE346360.1|	2919323	2919351	AGG	28	-	9	CCT
gi|514486632|gb|KE346360.1|	2920080	2920092	ACG	12	+	4	ACG
gi|514486632|gb|KE346360.1|	2920186	2920202	AAAG	16	+	4	GAAA
gi|514486632|gb|KE346360.1|	2920210	2920224	A	14	-	14	T
gi|514486632|gb|KE346360.1|	2920380	2920399	A	19	+	19	A
gi|514486632|gb|KE346360.1|	2920426	2920443	A	17	-	17	T
gi|514486632|gb|KE346360.1|	2920852	2920868	AGCGGC	16	-	2	CCGCTG
gi|514486632|gb|KE346360.1|	2921022	2921034	A	12	-	12	T
gi|514486632|gb|KE346360.1|	2921224	2921236	AGAGG	12	-	2	TCCTC
gi|514486632|gb|KE346360.1|	2921813	2921825	AACCGC	12	-	2	GTTGCG
gi|514486632|gb|KE346360.1|	2923078	2923090	ACCACG	12	+	2	CACGAC
gi|514486632|gb|KE346360.1|	2923313	2923327	AACGAC	14	-	2	GTTGTC
gi|514486632|gb|KE346360.1|	2923322	2923357	ACG	35	-	11	GTC
gi|514486632|gb|KE346360.1|	2923398	2923412	ACC	14	-	4	GTG
gi|514486632|gb|KE346360.1|	2923720	2923734	AGAGGG	14	-	2	CCCTCT
gi|514486632|gb|KE346360.1|	2923747	2923760	AGAGGG	13	-	2	TCTCCC
gi|514486632|gb|KE346360.1|	2923848	2923862	AAGCAT	14	-	2	TTATGC
gi|514486632|gb|KE346360.1|	2923858	2923880	AAAGCC	22	-	3	GCTTTG
gi|514486632|gb|KE346360.1|	2924030	2924043	ATC	13	+	4	CAT
gi|514486632|gb|KE346360.1|	2924192	2924209	AGCCTC	17	+	2	CTCAGC
gi|514486632|gb|KE346360.1|	2924272	2924292	CCG	20	+	6	CCG
gi|514486632|gb|KE346360.1|	2924306	2924321	AGC	15	+	5	GCA
gi|514486632|gb|KE346360.1|	2924316	2924332	ACCAGC	16	+	2	CAGCAC
gi|514486632|gb|KE346360.1|	2925669	2925681	ACCGCC	12	+	2	CCGCCA
gi|514486632|gb|KE346360.1|	2925874	2925886	ACACG	12	-	2	GTGTC
gi|514486632|gb|KE346360.1|	2926272	2926286	ACACGG	14	+	2	CACGGA
gi|514486632|gb|KE346360.1|	2926351	2926366	A	15	-	15	T
gi|514486632|gb|KE346360.1|	2927075	2927088	AAGCGC	13	+	2	AAGCGC
gi|514486632|gb|KE346360.1|	2927095	2927110	ACGCTC	15	+	2	CACGCT
gi|514486632|gb|KE346360.1|	2927199	2927213	ACGCAG	14	+	2	GCAGAC
gi|514486632|gb|KE346360.1|	2927776	2927788	A	12	+	12	A
gi|514486632|gb|KE346360.1|	2929803	2929825	A	22	+	22	A
gi|514486632|gb|KE346360.1|	2929988	2930003	AAGCGC	15	-	2	TGCGCT
gi|514486632|gb|KE346360.1|	2931349	2931361	ACCGTG	12	-	2	TCACGG
gi|514486632|gb|KE346360.1|	2931609	2931621	AATCAG	12	+	2	AATCAG
gi|514486632|gb|KE346360.1|	2932423	2932436	AGGCGG	13	-	2	CCTCCG
gi|514486632|gb|KE346360.1|	2932701	2932714	ACC	13	-	4	GGT
gi|514486632|gb|KE346360.1|	2932895	2932907	AAAAG	12	+	2	AAGAA
gi|514486632|gb|KE346360.1|	2933107	2933120	ATC	13	+	4	ATC
gi|514486632|gb|KE346360.1|	2933129	2933146	AAGAGG	17	-	2	TCTTCC
gi|514486632|gb|KE346360.1|	2933339	2933351	AAGGGG	12	-	2	TCCCCT
gi|514486632|gb|KE346360.1|	2933671	2933700	A	29	+	29	A
gi|514486632|gb|KE346360.1|	2933978	2933993	AAAAAC	15	-	2	TTTTTG
gi|514486632|gb|KE346360.1|	2934430	2934445	A	15	+	15	A
gi|514486632|gb|KE346360.1|	2934503	2934515	AAAAC	12	-	2	GTTTT
gi|514486632|gb|KE346360.1|	2934644	2934665	A	21	-	21	T
gi|514486632|gb|KE346360.1|	2934919	2934932	AAAAG	13	-	2	TTTCT
gi|514486632|gb|KE346360.1|	2934936	2934949	A	13	-	13	T
gi|514486632|gb|KE346360.1|	2935018	2935032	AATG	14	-	3	TTCA
gi|514486632|gb|KE346360.1|	2935123	2935135	AAAAAC	12	+	2	AAAACA
gi|514486632|gb|KE346360.1|	2935206	2935220	AAGCTC	14	+	2	AGCTCA
gi|514486632|gb|KE346360.1|	2935492	2935504	AATGG	12	-	2	TTCCA
gi|514486632|gb|KE346360.1|	2935600	2935629	AAG	29	-	9	CTT
gi|514486632|gb|KE346360.1|	2935627	2935643	AGC	16	-	5	CTG
gi|514486632|gb|KE346360.1|	2935698	2935716	ATGCCC	18	-	3	GGCATG
gi|514486632|gb|KE346360.1|	2935730	2935742	ACC	12	-	4	TGG
gi|514486632|gb|KE346360.1|	2935962	2935974	AGGCC	12	+	2	GGCCA
gi|514486632|gb|KE346360.1|	2936209	2936228	AGC	19	+	6	AGC
gi|514486632|gb|KE346360.1|	2936226	2936240	AAC	14	+	4	CAA
gi|514486632|gb|KE346360.1|	2936400	2936415	AGC	15	-	5	TGC
gi|514486632|gb|KE346360.1|	2937954	2937967	ACGCCG	13	+	2	CGCCGA
gi|514486632|gb|KE346360.1|	2939038	2939052	AAAGTC	14	+	2	TCAAAG
gi|514486632|gb|KE346360.1|	2940310	2940324	CCG	14	-	4	CGG
gi|514486632|gb|KE346360.1|	2940321	2940333	ACTGCG	12	+	2	GCGACT
gi|514486632|gb|KE346360.1|	2940585	2940612	AGC	27	-	9	GCT
gi|514486632|gb|KE346360.1|	2940733	2940747	AGCATC	14	+	2	CATCAG
gi|514486632|gb|KE346360.1|	2941616	2941628	AAAAAC	12	-	2	TTTTTG
gi|514486632|gb|KE346360.1|	2941997	2942011	ACG	14	-	4	CGT
gi|514486632|gb|KE346360.1|	2942730	2942745	AATGAC	15	-	2	ATTGTC
gi|514486632|gb|KE346360.1|	2942760	2942772	AAAAC	12	-	2	TTTGT
gi|514486632|gb|KE346360.1|	2942805	2942819	AAAAG	14	-	2	TTTTC
gi|514486632|gb|KE346360.1|	2942813	2942826	AAAAAG	13	-	2	TCTTTT
gi|514486632|gb|KE346360.1|	2942870	2942882	A	12	-	12	T
gi|514486632|gb|KE346360.1|	2943090	2943142	A	52	+	52	A
gi|514486632|gb|KE346360.1|	2944218	2944230	ACCGCG	12	+	2	GCGACC
gi|514486632|gb|KE346360.1|	2945053	2945066	AAAACC	13	+	2	AACCAA
gi|514486632|gb|KE346360.1|	2946645	2946658	A	13	+	13	A
gi|514486632|gb|KE346360.1|	2947452	2947464	A	12	+	12	A
gi|514486632|gb|KE346360.1|	2948218	2948233	AAAAC	15	+	3	CAAAA
gi|514486632|gb|KE346360.1|	2948229	2948243	A	14	+	14	A
gi|514486632|gb|KE346360.1|	2948669	2948685	AAAGCC	16	+	2	CAAAGC
gi|514486632|gb|KE346360.1|	2948786	2948798	ACTGCG	12	-	2	CAGTCG
gi|514486632|gb|KE346360.1|	2948942	2948957	AGC	15	-	5	TGC
gi|514486632|gb|KE346360.1|	2949644	2949687	A	43	-	43	T
gi|514486632|gb|KE346360.1|	2949794	2949806	ACGAT	12	+	2	GATAC
gi|514486632|gb|KE346360.1|	2949953	2949965	AACTTG	12	+	2	GAACTT
gi|514486632|gb|KE346360.1|	2951504	2951521	AAATG	17	-	3	ATTTC
gi|514486632|gb|KE346360.1|	2951721	2951735	AG	14	+	7	AG
gi|514486632|gb|KE346360.1|	2951844	2951867	A	23	-	23	T
gi|514486632|gb|KE346360.1|	2951961	2951974	AAACAC	13	-	2	TTTGTG
gi|514486632|gb|KE346360.1|	2952017	2952030	AAACCC	13	+	2	CCAAAC
gi|514486632|gb|KE346360.1|	2952113	2952126	AAAAC	13	+	2	AAAAC
gi|514486632|gb|KE346360.1|	2952123	2952136	AAAAC	13	+	2	AAACA
gi|514486632|gb|KE346360.1|	2952908	2952920	AGGGCG	12	+	2	GGCGAG
gi|514486632|gb|KE346360.1|	2954041	2954053	CCCGCG	12	+	2	CGCGCC
gi|514486632|gb|KE346360.1|	2954869	2954882	AGAGG	13	-	2	CTCTC
gi|514486632|gb|KE346360.1|	2955134	2955154	CCG	20	-	6	GGC
gi|514486632|gb|KE346360.1|	2955703	2955716	AGC	13	+	4	CAG
gi|514486632|gb|KE346360.1|	2955733	2955750	AACACC	17	+	2	CAACAC
gi|514486632|gb|KE346360.1|	2956127	2956139	AGAGG	12	-	2	CTCCT
gi|514486632|gb|KE346360.1|	2956172	2956187	AC	15	-	7	TG
gi|514486632|gb|KE346360.1|	2956329	2956341	AGCGGC	12	+	2	GCAGCG
gi|514486632|gb|KE346360.1|	2956401	2956413	AACAGC	12	+	2	GCAACA
gi|514486632|gb|KE346360.1|	2956660	2956672	C	12	-	12	G
gi|514486632|gb|KE346360.1|	2956797	2956816	AATC	19	+	4	AATC
gi|514486632|gb|KE346360.1|	2956875	2956893	AG	18	+	9	GA
gi|514486632|gb|KE346360.1|	2956929	2956946	AGCC	17	+	4	CCAG
gi|514486632|gb|KE346360.1|	2957464	2957483	A	19	-	19	T
gi|514486632|gb|KE346360.1|	2957514	2957531	AAAGC	17	-	3	CTTTG
gi|514486632|gb|KE346360.1|	2958046	2958059	AC	13	-	6	GT
gi|514486632|gb|KE346360.1|	2958056	2958075	ACTC	19	-	4	GTGA
gi|514486632|gb|KE346360.1|	2958072	2958087	AC	15	-	7	GT
gi|514486632|gb|KE346360.1|	2958361	2958374	AAAAGC	13	-	2	TTTTGC
gi|514486632|gb|KE346360.1|	2958666	2958683	AAAAC	17	-	3	TTTGT
gi|514486632|gb|KE346360.1|	2958695	2958709	AAACCG	14	-	2	TTCGGT
gi|514486632|gb|KE346360.1|	2959775	2959791	A	16	+	16	A
gi|514486632|gb|KE346360.1|	2959901	2959914	AAAAAG	13	-	2	TTTCTT
gi|514486632|gb|KE346360.1|	2959941	2959965	A	24	-	24	T
gi|514486632|gb|KE346360.1|	2960530	2960557	A	27	-	27	T
gi|514486632|gb|KE346360.1|	2961097	2961109	ACTGGG	12	+	2	CTGGGA
gi|514486632|gb|KE346360.1|	2961196	2961208	AGGCGG	12	-	2	CGCCTC
gi|514486632|gb|KE346360.1|	2962969	2962981	AGG	12	-	4	CCT
gi|514486632|gb|KE346360.1|	2963587	2963599	ACAGCC	12	+	2	CAGCCA
gi|514486632|gb|KE346360.1|	2964049	2964063	ACGATG	14	+	2	ACGATG
gi|514486632|gb|KE346360.1|	2964134	2964146	AAAAC	12	-	2	TTTTG
gi|514486632|gb|KE346360.1|	2964193	2964207	AAAAAG	14	-	2	TTCTTT
gi|514486632|gb|KE346360.1|	2964618	2964630	A	12	+	12	A
gi|514486632|gb|KE346360.1|	2964632	2964646	A	14	+	14	A
gi|514486632|gb|KE346360.1|	2965621	2965633	ACGGGG	12	+	2	GGGACG
gi|514486632|gb|KE346360.1|	2965728	2965740	ACCAGC	12	-	2	GGTGCT
gi|514486632|gb|KE346360.1|	2965791	2965803	AACCAC	12	-	2	TGTGGT
gi|514486632|gb|KE346360.1|	2966126	2966140	ACCCC	14	-	2	GGGGT
gi|514486632|gb|KE346360.1|	2966576	2966591	ACT	15	+	5	ACT
gi|514486632|gb|KE346360.1|	2966872	2966887	A	15	+	15	A
gi|514486632|gb|KE346360.1|	2966923	2966948	A	25	+	25	A
gi|514486632|gb|KE346360.1|	2968224	2968248	AAAC	24	+	6	AAAC
gi|514486632|gb|KE346360.1|	2969265	2969278	AGG	13	+	4	GGA
gi|514486632|gb|KE346360.1|	2969899	2969912	AACACC	13	-	2	TGGTGT
gi|514486632|gb|KE346360.1|	2970101	2970114	AAGACC	13	-	2	TCTTGG
gi|514486632|gb|KE346360.1|	2970860	2970874	ACATGC	14	-	2	TGTGCA
gi|514486632|gb|KE346360.1|	2971299	2971329	ACG	30	+	10	ACG
gi|514486632|gb|KE346360.1|	2971331	2971357	AAGATC	26	+	4	GATCAA
gi|514486632|gb|KE346360.1|	2971361	2971387	AAGATC	26	+	4	GATCAA
gi|514486632|gb|KE346360.1|	2971442	2971468	ACG	26	+	8	GAC
gi|514486632|gb|KE346360.1|	2971664	2971676	ACG	12	+	4	GAC
gi|514486632|gb|KE346360.1|	2971677	2971696	ACGATG	19	+	3	ATGACG
gi|514486632|gb|KE346360.1|	2971703	2971722	ACGATG	19	+	3	GATGAC
gi|514486632|gb|KE346360.1|	2972361	2972373	ACGGGC	12	+	2	ACGGGC
gi|514486632|gb|KE346360.1|	2973454	2973466	AACCC	12	+	2	AACCC
gi|514486632|gb|KE346360.1|	2973553	2973567	AAACC	14	-	2	TTTGG
gi|514486632|gb|KE346360.1|	2973948	2973960	ACCAGC	12	-	2	TGCTGG
gi|514486632|gb|KE346360.1|	2974575	2974594	AAG	19	+	6	AAG
gi|514486632|gb|KE346360.1|	2974947	2974959	AACGC	12	+	2	ACGCA
gi|514486632|gb|KE346360.1|	2975112	2975126	A	14	+	14	A
gi|514486632|gb|KE346360.1|	2975329	2975347	A	18	+	18	A
gi|514486632|gb|KE346360.1|	2975367	2975391	A	24	+	24	A
gi|514486632|gb|KE346360.1|	2975398	2975427	A	29	+	29	A
gi|514486632|gb|KE346360.1|	2975435	2975463	ACG	28	+	9	GAC
gi|514486632|gb|KE346360.1|	2975600	2975617	A	17	-	17	T
gi|514486632|gb|KE346360.1|	2975739	2975752	A	13	+	13	A
gi|514486632|gb|KE346360.1|	2975748	2975762	AAAAG	14	+	2	AAAAG
gi|514486632|gb|KE346360.1|	2975972	2975986	AAAG	14	-	3	TTTC
gi|514486632|gb|KE346360.1|	2979135	2979148	AACAGC	13	+	2	AGCAAC
gi|514486632|gb|KE346360.1|	2979160	2979173	AACAGC	13	+	2	AGCAAC
gi|514486632|gb|KE346360.1|	2979836	2979848	AGGGCG	12	-	2	CCTCGC
gi|514486632|gb|KE346360.1|	2980382	2980396	ACTG	14	-	3	AGTC
gi|514486632|gb|KE346360.1|	2980472	2980489	ACC	17	+	5	CCA
gi|514486632|gb|KE346360.1|	2980750	2980765	AAAAAT	15	+	2	AAAATA
gi|514486632|gb|KE346360.1|	2980769	2980787	A	18	+	18	A
gi|514486632|gb|KE346360.1|	2981356	2981368	ACTGG	12	+	2	TGGAC
gi|514486632|gb|KE346360.1|	2981404	2981416	AATGTC	12	+	2	TGTCAA
gi|514486632|gb|KE346360.1|	2981937	2981951	AAAAAG	14	+	2	AAGAAA
gi|514486632|gb|KE346360.1|	2982137	2982149	AGCAGG	12	-	2	CTGCTC
gi|514486632|gb|KE346360.1|	2982491	2982503	AAAAAC	12	+	2	ACAAAA
gi|514486632|gb|KE346360.1|	2984389	2984524	AC	135	-	67	TG
gi|514486632|gb|KE346360.1|	2984525	2984578	AC	53	-	26	TG
gi|514486632|gb|KE346360.1|	2985044	2985066	AG	22	+	11	AG
gi|514486632|gb|KE346360.1|	2985083	2985096	AAAAC	13	+	2	AAACA
gi|514486632|gb|KE346360.1|	2985449	2985461	AAGAGC	12	+	2	GAGCAA
gi|514486632|gb|KE346360.1|	2985812	2985827	AAAC	15	+	3	AAAC
gi|514486632|gb|KE346360.1|	2985966	2985978	AGAGC	12	+	2	AGCAG
gi|514486632|gb|KE346360.1|	2985981	2985996	ACTC	15	-	3	GAGT
gi|514486632|gb|KE346360.1|	2985990	2986002	ACTCTC	12	-	2	AGTGAG
gi|514486632|gb|KE346360.1|	2986087	2986104	AGAGGG	17	+	2	GAGAGG
gi|514486632|gb|KE346360.1|	2986101	2986126	AGAGGG	25	+	4	GAGAGG
gi|514486632|gb|KE346360.1|	2986299	2986318	AAAAT	19	+	3	AAAAT
gi|514486632|gb|KE346360.1|	2986322	2986335	AAT	13	+	4	AAT
gi|514486632|gb|KE346360.1|	2986348	2986361	AATGTC	13	-	2	ACATTG
gi|514486632|gb|KE346360.1|	2986557	2986575	ACTC	18	+	4	TCAC
gi|514486632|gb|KE346360.1|	2987021	2987035	AATGC	14	-	2	ATTGC
gi|514486632|gb|KE346360.1|	2987054	2987087	A	33	-	33	T
gi|514486632|gb|KE346360.1|	2987698	2987711	AAACGG	13	-	2	GTTTCC
gi|514486632|gb|KE346360.1|	2987758	2987770	AAAAAC	12	-	2	TTTTTG
gi|514486632|gb|KE346360.1|	2988798	2988812	AGC	14	-	4	GCT
gi|514486632|gb|KE346360.1|	2988872	2988884	AAAAGC	12	+	2	AGCAAA
gi|514486632|gb|KE346360.1|	2989331	2989345	ACGCTG	14	+	2	TGACGC
gi|514486632|gb|KE346360.1|	2989379	2989391	AAGCGG	12	+	2	AGCGGA
gi|514486632|gb|KE346360.1|	2989615	2989627	AAC	12	+	4	CAA
gi|514486632|gb|KE346360.1|	2989622	2989641	AAAC	19	+	4	AACA
gi|514486632|gb|KE346360.1|	2989642	2989805	AAAC	163	+	40	AACA
gi|514486632|gb|KE346360.1|	2989806	2989820	A	14	+	14	A
gi|514486632|gb|KE346360.1|	2990622	2990639	ACC	17	+	5	ACC
gi|514486632|gb|KE346360.1|	2990644	2990658	AATGTC	14	-	2	GACATT
gi|514486632|gb|KE346360.1|	2991024	2991040	AATG	16	+	4	GAAT
gi|514486632|gb|KE346360.1|	2991369	2991387	AG	18	-	9	CT
gi|514486632|gb|KE346360.1|	2991506	2991521	A	15	-	15	T
gi|514486632|gb|KE346360.1|	2991533	2991545	A	12	-	12	T
gi|514486632|gb|KE346360.1|	2992013	2992028	AAAC	15	+	3	AAAC
gi|514486632|gb|KE346360.1|	2992751	2992763	ACG	12	+	4	CGA
gi|514486632|gb|KE346360.1|	2993540	2993553	AGGGGG	13	-	2	TCCCCC
gi|514486632|gb|KE346360.1|	2994532	2994545	AGGGG	13	+	2	GGGGA
gi|514486632|gb|KE346360.1|	2994700	2994712	AGCCGC	12	+	2	CCGCAG
gi|514486632|gb|KE346360.1|	2994710	2994724	ACGACT	14	-	2	AGTCGT
gi|514486632|gb|KE346360.1|	2994809	2994830	ACGATC	21	-	3	GATCGT
gi|514486632|gb|KE346360.1|	2994848	2994860	ACCGCG	12	+	2	GACCGC
gi|514486632|gb|KE346360.1|	2994865	2994877	ACCGTG	12	+	2	TGACCG
gi|514486632|gb|KE346360.1|	2994917	2994929	ACCGTG	12	+	2	GACCGT
gi|514486632|gb|KE346360.1|	2994947	2994964	ACCGCG	17	+	2	GACCGC
gi|514486632|gb|KE346360.1|	2995032	2995046	AAACG	14	-	2	GTTTC
gi|514486632|gb|KE346360.1|	2995998	2996012	AAG	14	+	4	GAA
gi|514486632|gb|KE346360.1|	2996684	2996697	AACTC	13	-	2	TTGAG
gi|514486632|gb|KE346360.1|	2996926	2996945	AGCC	19	+	4	CAGC
gi|514486632|gb|KE346360.1|	2997044	2997057	AAGCGG	13	-	2	TCCGCT
gi|514486632|gb|KE346360.1|	2997321	2997333	A	12	+	12	A
gi|514486632|gb|KE346360.1|	2997930	2997945	ATCCCC	15	+	2	CCCATC
gi|514486632|gb|KE346360.1|	2998155	2998178	AATGC	23	-	4	GCATT
gi|514486632|gb|KE346360.1|	2998243	2998257	A	14	-	14	T
gi|514486632|gb|KE346360.1|	2998258	2998276	A	18	-	18	T
gi|514486632|gb|KE346360.1|	2998396	2998411	ACG	15	+	5	CGA
gi|514486632|gb|KE346360.1|	2998409	2998479	AG	70	+	35	GA
gi|514486632|gb|KE346360.1|	2998524	2998556	A	32	-	32	T
gi|514486632|gb|KE346360.1|	2998552	2998585	AAAACC	33	-	5	TTTTGG
gi|514486632|gb|KE346360.1|	2999377	2999389	AAAGGG	12	-	2	TTTCCC
gi|514486632|gb|KE346360.1|	3000295	3000308	AAACAC	13	-	2	TGTGTT
gi|514486632|gb|KE346360.1|	3000492	3000507	AC	15	+	7	AC
gi|514486632|gb|KE346360.1|	3000506	3000518	A	12	+	12	A
gi|514486632|gb|KE346360.1|	3000714	3000726	AAAGAG	12	+	2	AAGAGA
gi|514486632|gb|KE346360.1|	3000827	3000841	AG	14	+	7	AG
gi|514486632|gb|KE346360.1|	3001433	3001456	AGC	23	-	7	TGC
gi|514486632|gb|KE346360.1|	3001454	3001468	AAC	14	-	4	TGT
gi|514486632|gb|KE346360.1|	3001493	3001507	AACAGC	14	-	2	TGTTGC
gi|514486632|gb|KE346360.1|	3001502	3001531	AGC	29	-	9	TGC
gi|514486632|gb|KE346360.1|	3001598	3001613	AAGCTG	15	+	2	AGCTGA
gi|514486632|gb|KE346360.1|	3001713	3001733	AGC	20	-	6	GCT
gi|514486632|gb|KE346360.1|	3002360	3002374	AAAAAG	14	+	2	AAAAGA
gi|514486632|gb|KE346360.1|	3002382	3002399	A	17	+	17	A
gi|514486632|gb|KE346360.1|	3002686	3002698	AATCAG	12	+	2	AATCAG
gi|514486632|gb|KE346360.1|	3003321	3003338	AACACC	17	-	2	TGTTGG
gi|514486632|gb|KE346360.1|	3003333	3003350	AAC	17	-	5	TGT
gi|514486632|gb|KE346360.1|	3003366	3003380	AACAGC	14	-	2	TGCTGT
gi|514486632|gb|KE346360.1|	3003675	3003692	AAC	17	-	5	TGT
gi|514486632|gb|KE346360.1|	3003690	3003707	AGC	17	-	5	TGC
gi|514486632|gb|KE346360.1|	3003843	3003870	AGC	27	-	9	TGC
gi|514486632|gb|KE346360.1|	3003996	3004013	AACAGC	17	-	2	TGCTGT
gi|514486632|gb|KE346360.1|	3004041	3004061	AGC	20	-	6	TGC
gi|514486632|gb|KE346360.1|	3004071	3004085	AACAGC	14	-	2	TGTTGC
gi|514486632|gb|KE346360.1|	3004167	3004187	AGCTCC	20	+	3	CCAGCT
gi|514486632|gb|KE346360.1|	3004251	3004263	A	12	+	12	A
gi|514486632|gb|KE346360.1|	3004270	3004284	AAT	14	+	4	AAT
gi|514486632|gb|KE346360.1|	3004288	3004301	A	13	+	13	A
gi|514486632|gb|KE346360.1|	3004369	3004386	AGGC	17	-	4	CTGC
gi|514486632|gb|KE346360.1|	3004499	3004511	ACGG	12	+	3	GGAC
gi|514486632|gb|KE346360.1|	3004561	3004582	A	21	+	21	A
gi|514486632|gb|KE346360.1|	3004751	3004770	A	19	+	19	A
gi|514486632|gb|KE346360.1|	3004766	3004782	AAAAGG	16	+	2	AAAAGG
gi|514486632|gb|KE346360.1|	3004778	3004793	A	15	+	15	A
gi|514486632|gb|KE346360.1|	3004789	3004805	AAAAGG	16	+	2	AAAAGG
gi|514486632|gb|KE346360.1|	3004854	3004870	A	16	+	16	A
gi|514486632|gb|KE346360.1|	3005042	3005055	ACCC	13	-	3	GGGT
gi|514486632|gb|KE346360.1|	3006393	3006416	AC	23	-	11	GT
gi|514486632|gb|KE346360.1|	3006653	3006666	AGATCC	13	+	2	CAGATC
gi|514486632|gb|KE346360.1|	3008801	3008814	ACTCTG	13	-	2	TCAGAG
gi|514486632|gb|KE346360.1|	3008930	3008944	AGC	14	-	4	GCT
gi|514486632|gb|KE346360.1|	3009184	3009198	ACGAGG	14	-	2	TCGTCC
gi|514486632|gb|KE346360.1|	3010112	3010126	AACAGC	14	-	2	TGTTGC
gi|514486632|gb|KE346360.1|	3010587	3010599	AAGACG	12	-	2	TTCGTC
gi|514486632|gb|KE346360.1|	3010605	3010619	ACG	14	-	4	GTC
gi|514486632|gb|KE346360.1|	3010716	3010744	AAC	28	-	9	GTT
gi|514486632|gb|KE346360.1|	3011261	3011273	C	12	+	12	C
gi|514486632|gb|KE346360.1|	3011911	3011923	ACGAGG	12	+	2	GACGAG
gi|514486632|gb|KE346360.1|	3012501	3012513	AGAGGG	12	+	2	GGAGAG
gi|514486632|gb|KE346360.1|	3012515	3012527	AGAGCG	12	+	2	CGAGAG
gi|514486632|gb|KE346360.1|	3012522	3012536	AG	14	+	7	GA
gi|514486632|gb|KE346360.1|	3013273	3013287	A	14	+	14	A
gi|514486632|gb|KE346360.1|	3014079	3014109	AAAAC	30	+	6	AACAA
gi|514486632|gb|KE346360.1|	3014506	3014519	AAATCG	13	+	2	ATCGAA
gi|514486632|gb|KE346360.1|	3015201	3015223	ATC	22	-	7	GAT
gi|514486632|gb|KE346360.1|	3015811	3015827	A	16	+	16	A
gi|514486632|gb|KE346360.1|	3015897	3015909	AC	12	+	6	CA
gi|514486632|gb|KE346360.1|	3016048	3016061	AAAAAC	13	-	2	GTTTTT
gi|514486632|gb|KE346360.1|	3017049	3017062	AACGCC	13	-	2	TTGGCG
gi|514486632|gb|KE346360.1|	3017508	3017520	AAACAC	12	-	2	TGTGTT
gi|514486632|gb|KE346360.1|	3017897	3017913	A	16	-	16	T
gi|514486632|gb|KE346360.1|	3017916	3017933	AAAAAG	17	-	2	TTTTTC
gi|514486632|gb|KE346360.1|	3018102	3018118	A	16	-	16	T
gi|514486632|gb|KE346360.1|	3018378	3018392	AAACAC	14	-	2	GTGTTT
gi|514486632|gb|KE346360.1|	3018466	3018479	A	13	+	13	A
gi|514486632|gb|KE346360.1|	3018524	3018536	A	12	-	12	T
gi|514486632|gb|KE346360.1|	3018576	3018588	AAAAAG	12	-	2	TTTTTC
gi|514486632|gb|KE346360.1|	3018698	3018718	A	20	-	20	T
gi|514486632|gb|KE346360.1|	3019242	3019254	AAGAGG	12	-	2	CTCTTC
gi|514486632|gb|KE346360.1|	3019262	3019274	AAAG	12	-	3	TCTT
gi|514486632|gb|KE346360.1|	3019391	3019406	A	15	+	15	A
gi|514486632|gb|KE346360.1|	3019601	3019616	A	15	-	15	T
gi|514486632|gb|KE346360.1|	3020021	3020033	AAAAAT	12	+	2	AAAAAT
gi|514486632|gb|KE346360.1|	3020496	3020510	AC	14	+	7	AC
gi|514486632|gb|KE346360.1|	3022651	3022665	AACGCC	14	+	2	CAACGC
gi|514486632|gb|KE346360.1|	3023688	3023702	AGC	14	+	4	AGC
gi|514486632|gb|KE346360.1|	3023703	3023719	AGC	16	+	5	AGC
gi|514486632|gb|KE346360.1|	3025156	3025170	AAGTCC	14	-	2	TGGACT
gi|514486632|gb|KE346360.1|	3025188	3025210	AC	22	-	11	TG
gi|514486632|gb|KE346360.1|	3025752	3025765	AGCTCG	13	+	2	GCTCGA
gi|514486632|gb|KE346360.1|	3026281	3026293	AGGCCC	12	+	2	CAGGCC
gi|514486632|gb|KE346360.1|	3026818	3026830	AGCAGG	12	+	2	GAGCAG
gi|514486632|gb|KE346360.1|	3026846	3026862	AAGAGC	16	+	2	AGCAAG
gi|514486632|gb|KE346360.1|	3026978	3026991	AGC	13	+	4	AGC
gi|514486632|gb|KE346360.1|	3027377	3027389	AGC	12	+	4	AGC
gi|514486632|gb|KE346360.1|	3027412	3027425	ACGATG	13	-	2	CATCGT
gi|514486632|gb|KE346360.1|	3027912	3027924	AGC	12	+	4	GCA
gi|514486632|gb|KE346360.1|	3028044	3028057	AGCGC	13	+	2	AGCGC
gi|514486632|gb|KE346360.1|	3030525	3030546	A	21	+	21	A
gi|514486632|gb|KE346360.1|	3030589	3030601	ATCG	12	+	3	CGAT
gi|514486632|gb|KE346360.1|	3030797	3030811	AACAGC	14	-	2	TGCTGT
gi|514486632|gb|KE346360.1|	3030844	3030856	AAGGAC	12	-	2	CCTTGT
gi|514486632|gb|KE346360.1|	3030931	3030943	ACACGC	12	+	2	ACGCAC
gi|514486632|gb|KE346360.1|	3031043	3031063	AGC	20	+	6	GCA
gi|514486632|gb|KE346360.1|	3031606	3031619	ATC	13	+	4	CAT
gi|514486632|gb|KE346360.1|	3032915	3032932	AAAAAC	17	-	2	TTTTTG
gi|514486632|gb|KE346360.1|	3033273	3033286	AAAAGC	13	-	2	TTTGCT
gi|514486632|gb|KE346360.1|	3033582	3033603	AG	21	-	10	TC
gi|514486632|gb|KE346360.1|	3034522	3034534	AGATGC	12	-	2	TCTGCA
gi|514486632|gb|KE346360.1|	3035687	3035701	AATGGC	14	+	2	TGGCAA
gi|514486632|gb|KE346360.1|	3037949	3037970	A	21	+	21	A
gi|514486632|gb|KE346360.1|	3038298	3038310	ACCCGC	12	-	2	GGTGCG
gi|514486632|gb|KE346360.1|	3039797	3039810	AAGGCC	13	-	2	CCTTGG
gi|514486632|gb|KE346360.1|	3039970	3039984	AGAGGC	14	+	2	GAGGCA
gi|514486632|gb|KE346360.1|	3040044	3040057	ACTCTG	13	-	2	CAGAGT
gi|514486632|gb|KE346360.1|	3040058	3040075	ACTCTG	17	-	2	GAGTCA
gi|514486632|gb|KE346360.1|	3040070	3040085	ACTCAG	15	-	2	GAGTCT
gi|514486632|gb|KE346360.1|	3040081	3040095	AGCATG	14	+	2	TGAGCA
gi|514486632|gb|KE346360.1|	3040686	3040698	AAAGTG	12	+	2	GTGAAA
gi|514486632|gb|KE346360.1|	3040918	3040932	AAC	14	-	4	TGT
gi|514486632|gb|KE346360.1|	3040930	3040948	AGC	18	-	6	TGC
gi|514486632|gb|KE346360.1|	3041775	3041787	ACCCTG	12	-	2	GTCAGG
gi|514486632|gb|KE346360.1|	3042525	3042541	AGC	16	-	5	GCT
gi|514486632|gb|KE346360.1|	3043117	3043129	AGC	12	+	4	CAG
gi|514486632|gb|KE346360.1|	3043208	3043229	ATCGGC	21	-	3	ATGCCG
gi|514486632|gb|KE346360.1|	3043276	3043290	ACG	14	+	4	GAC
gi|514486632|gb|KE346360.1|	3043323	3043337	ACGAGC	14	-	2	GCTCGT
gi|514486632|gb|KE346360.1|	3043385	3043398	ATC	13	+	4	ATC
gi|514486632|gb|KE346360.1|	3044098	3044111	ACGCGG	13	+	2	GCGGAC
gi|514486632|gb|KE346360.1|	3044181	3044199	AGC	18	-	6	TGC
gi|514486632|gb|KE346360.1|	3045110	3045125	AATTCC	15	+	2	CCAATT
gi|514486632|gb|KE346360.1|	3046019	3046031	ACACG	12	+	2	CACGA
gi|514486632|gb|KE346360.1|	3046867	3046880	A	13	-	13	T
gi|514486632|gb|KE346360.1|	3047102	3047114	AAGACC	12	+	2	CCAAGA
gi|514486632|gb|KE346360.1|	3047257	3047269	ACAGAG	12	-	2	TCTCTG
gi|514486632|gb|KE346360.1|	3048027	3048049	ATC	22	-	7	GAT
gi|514486632|gb|KE346360.1|	3048219	3048231	AGCGGC	12	-	2	CTGCCG
gi|514486632|gb|KE346360.1|	3048255	3048270	AGCGGC	15	-	2	GCTGCC
gi|514486632|gb|KE346360.1|	3049473	3049486	A	13	-	13	T
gi|514486632|gb|KE346360.1|	3049487	3049500	A	13	-	13	T
gi|514486632|gb|KE346360.1|	3049512	3049524	A	12	-	12	T
gi|514486632|gb|KE346360.1|	3049525	3049538	A	13	-	13	T
gi|514486632|gb|KE346360.1|	3049988	3050002	ATCCC	14	+	2	CCATC
gi|514486632|gb|KE346360.1|	3050324	3050336	ACCCCC	12	-	2	GGGGTG
gi|514486632|gb|KE346360.1|	3051950	3051962	ATCGGC	12	-	2	CGATGC
gi|514486632|gb|KE346360.1|	3053388	3053402	A	14	+	14	A
gi|514486632|gb|KE346360.1|	3054467	3054486	AG	19	+	9	GA
gi|514486632|gb|KE346360.1|	3054489	3054506	AGAGGG	17	+	2	GAGAGG
gi|514486632|gb|KE346360.1|	3054508	3054520	AACTTC	12	-	2	AGTTGA
gi|514486632|gb|KE346360.1|	3054586	3054603	AAC	17	-	5	TGT
gi|514486632|gb|KE346360.1|	3054637	3054651	AAAACC	14	-	2	TTTGGT
gi|514486632|gb|KE346360.1|	3054988	3055001	A	13	+	13	A
gi|514486632|gb|KE346360.1|	3055009	3055022	AAAAG	13	+	2	AAAGA
gi|514486632|gb|KE346360.1|	3055138	3055155	ACACTC	17	-	2	TGAGTG
gi|514486632|gb|KE346360.1|	3055234	3055248	ACC	14	+	4	ACC
gi|514486632|gb|KE346360.1|	3055261	3055284	ATC	23	+	7	TCA
gi|514486632|gb|KE346360.1|	3055294	3055312	ACCAGC	18	-	3	GCTGGT
gi|514486632|gb|KE346360.1|	3055519	3055533	AGC	14	+	4	CAG
gi|514486632|gb|KE346360.1|	3055672	3055685	AGC	13	+	4	CAG
gi|514486632|gb|KE346360.1|	3056388	3056400	ACGAGG	12	-	2	TCCTCG
gi|514486632|gb|KE346360.1|	3056504	3056519	AGAGGC	15	-	2	TGCCTC
gi|514486632|gb|KE346360.1|	3056599	3056612	ACTG	13	+	3	TGAC
gi|514486632|gb|KE346360.1|	3056753	3056765	AAATGT	12	-	2	TACATT
gi|514486632|gb|KE346360.1|	3057045	3057057	ACACCG	12	+	2	CCGACA
gi|514486632|gb|KE346360.1|	3057254	3057273	AAAC	19	+	4	ACAA
gi|514486632|gb|KE346360.1|	3057563	3057579	AATGC	16	+	3	GCAAT
gi|514486632|gb|KE346360.1|	3057667	3057679	AAAGCC	12	-	2	GCTTTG
gi|514486632|gb|KE346360.1|	3057688	3057733	AGC	45	-	15	GCT
gi|514486632|gb|KE346360.1|	3057922	3057936	AACAAT	14	+	2	AACAAT
gi|514486632|gb|KE346360.1|	3059207	3059230	AG	23	+	11	GA
gi|514486632|gb|KE346360.1|	3062350	3062362	AAAAC	12	+	2	AAAAC
gi|514486632|gb|KE346360.1|	3063029	3063041	AAACAC	12	+	2	ACACAA
gi|514486632|gb|KE346360.1|	3063240	3063252	C	12	+	12	C
gi|514486632|gb|KE346360.1|	3063904	3063916	ATC	12	+	4	CAT
gi|514486632|gb|KE346360.1|	3064391	3064412	A	21	-	21	T
gi|514486632|gb|KE346360.1|	3064596	3064611	A	15	+	15	A
gi|514486632|gb|KE346360.1|	3064820	3064832	A	12	+	12	A
gi|514486632|gb|KE346360.1|	3065012	3065032	A	20	-	20	T
gi|514486632|gb|KE346360.1|	3065095	3065111	AC	16	+	8	AC
gi|514486632|gb|KE346360.1|	3065408	3065438	A	30	+	30	A
gi|514486632|gb|KE346360.1|	3065807	3065819	AGGGGG	12	-	2	CCCCCT
gi|514486632|gb|KE346360.1|	3067008	3067020	AGCGCG	12	-	2	GCGCTC
gi|514486632|gb|KE346360.1|	3067902	3067916	AAAAC	14	-	2	TTTTG
gi|514486632|gb|KE346360.1|	3069935	3069964	A	29	-	29	T
gi|514486632|gb|KE346360.1|	3070316	3070338	A	22	+	22	A
gi|514486632|gb|KE346360.1|	3070377	3070390	A	13	+	13	A
gi|514486632|gb|KE346360.1|	3070607	3070619	AGATGC	12	-	2	TCTGCA
gi|514486632|gb|KE346360.1|	3070765	3070780	AAATAT	15	-	2	TTTATA
gi|514486632|gb|KE346360.1|	3070782	3070800	AAT	18	-	6	ATT
gi|514486632|gb|KE346360.1|	3071255	3071267	AAGGAC	12	+	2	CAAGGA
gi|514486632|gb|KE346360.1|	3071703	3071716	ACCGTC	13	+	2	GTCACC
gi|514486632|gb|KE346360.1|	3072896	3072911	ACG	15	-	5	TCG
gi|514486632|gb|KE346360.1|	3073007	3073030	ATC	23	+	7	TCA
gi|514486632|gb|KE346360.1|	3073105	3073119	AGC	14	-	4	CTG
gi|514486632|gb|KE346360.1|	3073631	3073649	AGC	18	-	6	CTG
gi|514486632|gb|KE346360.1|	3074352	3074378	ATC	26	+	8	CAT
gi|514486632|gb|KE346360.1|	3075808	3075820	AG	12	+	6	AG
gi|514486632|gb|KE346360.1|	3076167	3076195	AC	28	+	14	CA
gi|514486632|gb|KE346360.1|	3076194	3076208	A	14	+	14	A
gi|514486632|gb|KE346360.1|	3076585	3076597	ACACTG	12	-	2	CAGTGT
gi|514486632|gb|KE346360.1|	3077316	3077330	AC	14	+	7	CA
gi|514486632|gb|KE346360.1|	3078625	3078637	AAAAC	12	+	2	AAAAC
gi|514486632|gb|KE346360.1|	3078646	3078666	ACC	20	+	6	CAC
gi|514486632|gb|KE346360.1|	3078664	3078679	AAC	15	+	5	CAA
gi|514486632|gb|KE346360.1|	3078687	3078701	AATCAC	14	-	2	TTGTGA
gi|514486632|gb|KE346360.1|	3079157	3079169	AACGCG	12	-	2	GTTCGC
gi|514486632|gb|KE346360.1|	3079700	3079715	ACAGCG	15	-	2	GTCGCT
gi|514486632|gb|KE346360.1|	3079985	3079997	ACGAGG	12	+	2	CGAGGA
gi|514486632|gb|KE346360.1|	3080770	3080784	ATGCCC	14	+	2	TGCCCA
gi|514486632|gb|KE346360.1|	3081430	3081442	ACATCG	12	-	2	TGTCGA
gi|514486632|gb|KE346360.1|	3082483	3082495	ACC	12	+	4	ACC
gi|514486632|gb|KE346360.1|	3083919	3083934	A	15	-	15	T
gi|514486632|gb|KE346360.1|	3084234	3084247	ACTG	13	+	3	CTGA
gi|514486632|gb|KE346360.1|	3085131	3085143	AAGCAC	12	-	2	TTGTGC
gi|514486632|gb|KE346360.1|	3085140	3085152	AATGC	12	-	2	TGCAT
gi|514486632|gb|KE346360.1|	3086155	3086184	A	29	-	29	T
gi|514486632|gb|KE346360.1|	3086303	3086317	AACCAC	14	-	2	GTTGTG
gi|514486632|gb|KE346360.1|	3086822	3086834	AAAAAG	12	+	2	GAAAAA
gi|514486632|gb|KE346360.1|	3086837	3086850	A	13	+	13	A
gi|514486632|gb|KE346360.1|	3086854	3086869	A	15	+	15	A
gi|514486632|gb|KE346360.1|	3087510	3087523	AAGTCC	13	+	2	GTCCAA
gi|514486632|gb|KE346360.1|	3087562	3087574	AAGGCC	12	+	2	GCCAAG
gi|514486632|gb|KE346360.1|	3087686	3087699	ACTGCC	13	+	2	CTGCCA
gi|514486632|gb|KE346360.1|	3088627	3088639	AAGGCC	12	+	2	GCCAAG
gi|514486632|gb|KE346360.1|	3089236	3089248	AAGGGC	12	+	2	GGCAAG
gi|514486632|gb|KE346360.1|	3089369	3089382	ACCAGC	13	+	2	AGCACC
gi|514486632|gb|KE346360.1|	3089462	3089475	ACCGAG	13	+	2	AGACCG
gi|514486632|gb|KE346360.1|	3089717	3089730	AGC	13	-	4	CTG
gi|514486632|gb|KE346360.1|	3089748	3089787	AGC	39	-	13	CTG
gi|514486632|gb|KE346360.1|	3090093	3090105	AACGCC	12	+	2	ACGCCA
gi|514486632|gb|KE346360.1|	3090550	3090564	ACCATC	14	+	2	CACCAT
gi|514486632|gb|KE346360.1|	3090853	3090865	ACGAGG	12	+	2	CGAGGA
gi|514486632|gb|KE346360.1|	3090960	3090972	AGCGGC	12	-	2	CTGCCG
gi|514486632|gb|KE346360.1|	3091267	3091280	AAAAGC	13	-	2	TTTGCT
gi|514486632|gb|KE346360.1|	3091286	3091299	AACAC	13	-	2	GTTGT
gi|514486632|gb|KE346360.1|	3091499	3091511	AAAAAC	12	-	2	TTTTGT
gi|514486632|gb|KE346360.1|	3092628	3092641	AATCTG	13	-	2	ATTCAG
gi|514486632|gb|KE346360.1|	3092958	3092970	AAAAAC	12	+	2	CAAAAA
gi|514486632|gb|KE346360.1|	3092965	3092984	A	19	+	19	A
gi|514486632|gb|KE346360.1|	3093159	3093171	AAAGAC	12	+	2	AGACAA
gi|514486632|gb|KE346360.1|	3093403	3093423	A	20	+	20	A
gi|514486632|gb|KE346360.1|	3093593	3093605	AGG	12	+	4	GGA
gi|514486632|gb|KE346360.1|	3093624	3093636	A	12	+	12	A
gi|514486632|gb|KE346360.1|	3093817	3093832	AAAG	15	+	3	AAAG
gi|514486632|gb|KE346360.1|	3093829	3093843	A	14	+	14	A
gi|514486632|gb|KE346360.1|	3094079	3094091	ACGGAG	12	+	2	GACGGA
gi|514486632|gb|KE346360.1|	3094094	3094106	AAATCC	12	-	2	ATTTGG
gi|514486632|gb|KE346360.1|	3094541	3094563	CCG	22	+	7	CGC
gi|514486632|gb|KE346360.1|	3094572	3094587	AGC	15	-	5	CTG
gi|514486632|gb|KE346360.1|	3095263	3095275	ACATGG	12	-	2	CATGTC
gi|514486632|gb|KE346360.1|	3095303	3095322	ACG	19	+	6	GAC
gi|514486632|gb|KE346360.1|	3095474	3095487	ACAGGT	13	+	2	ACAGGT
gi|514486632|gb|KE346360.1|	3095892	3095904	AAC	12	-	4	GTT
gi|514486632|gb|KE346360.1|	3096333	3096360	AATGAG	27	-	4	TCATTC
gi|514486632|gb|KE346360.1|	3098607	3098619	ACACTG	12	+	2	GACACT
gi|514486632|gb|KE346360.1|	3098977	3098991	ACCTCC	14	+	2	CCACCT
gi|514486632|gb|KE346360.1|	3099013	3099027	ACCGCC	14	+	2	CCACCG
gi|514486632|gb|KE346360.1|	3099049	3099063	ACCGCC	14	+	2	CCGCCA
gi|514486632|gb|KE346360.1|	3099224	3099236	ACATGG	12	+	2	TGGACA
gi|514486632|gb|KE346360.1|	3100514	3100527	AAGCGC	13	+	2	GCAAGC
gi|514486632|gb|KE346360.1|	3101530	3101542	AAAT	12	+	3	TAAA
gi|514486632|gb|KE346360.1|	3102706	3102727	AAC	21	+	7	CAA
gi|514486632|gb|KE346360.1|	3104088	3104100	ACCATG	12	-	2	CATGGT
gi|514486632|gb|KE346360.1|	3104526	3104540	AATGGC	14	+	2	AATGGC
gi|514486632|gb|KE346360.1|	3104789	3104807	AGC	18	+	6	CAG
gi|514486632|gb|KE346360.1|	3105111	3105123	AAAATC	12	+	2	TCAAAA
gi|514486632|gb|KE346360.1|	3105498	3105515	ATC	17	-	5	GAT
gi|514486632|gb|KE346360.1|	3105652	3105667	AACAGC	15	+	2	CAGCAA
gi|514486632|gb|KE346360.1|	3107014	3107036	ACAGCG	22	-	3	CTGTCG
gi|514486632|gb|KE346360.1|	3107505	3107526	ACC	21	+	7	ACC
gi|514486632|gb|KE346360.1|	3107654	3107667	ACG	13	+	4	CGA
gi|514486632|gb|KE346360.1|	3107670	3107693	AATGAC	23	+	3	GACAAT
gi|514486632|gb|KE346360.1|	3107688	3107705	AACGAC	17	+	2	GACAAC
gi|514486632|gb|KE346360.1|	3108577	3108602	AGC	25	+	8	CAG
gi|514486632|gb|KE346360.1|	3109145	3109157	AGGCGC	12	+	2	AGGCGC
gi|514486632|gb|KE346360.1|	3109446	3109459	ACC	13	+	4	ACC
gi|514486632|gb|KE346360.1|	3109995	3110007	ACGC	12	+	3	CACG
gi|514486632|gb|KE346360.1|	3110999	3111011	ACC	12	-	4	GTG
gi|514486632|gb|KE346360.1|	3111854	3111866	A	12	-	12	T
gi|514486632|gb|KE346360.1|	3112239	3112251	AAC	12	-	4	TTG
gi|514486632|gb|KE346360.1|	3112386	3112401	A	15	-	15	T
gi|514486632|gb|KE346360.1|	3112402	3112414	AAAGAT	12	-	2	CTTTAT
gi|514486632|gb|KE346360.1|	3112469	3112481	AACGG	12	+	2	CGGAA
gi|514486632|gb|KE346360.1|	3112570	3112583	AGC	13	-	4	GCT
gi|514486632|gb|KE346360.1|	3112880	3112895	A	15	-	15	T
gi|514486632|gb|KE346360.1|	3112911	3112923	ACTG	12	+	3	GACT
gi|514486632|gb|KE346360.1|	3113420	3113432	AAAAAC	12	-	2	TTGTTT
gi|514486632|gb|KE346360.1|	3113532	3113558	A	26	-	26	T
gi|514486632|gb|KE346360.1|	3113830	3113843	AAAAG	13	+	2	AAAAG
gi|514486632|gb|KE346360.1|	3114624	3114636	AAC	12	-	4	GTT
gi|514486632|gb|KE346360.1|	3117570	3117583	AGCTGC	13	+	2	GCAGCT
gi|514486632|gb|KE346360.1|	3117590	3117603	AACAGC	13	-	2	TGCTGT
gi|514486632|gb|KE346360.1|	3118303	3118339	A	36	+	36	A
gi|514486632|gb|KE346360.1|	3118373	3118387	AAAAG	14	+	2	AAAGA
gi|514486632|gb|KE346360.1|	3118485	3118499	AG	14	+	7	GA
gi|514486632|gb|KE346360.1|	3118632	3118645	AGCG	13	+	3	CGAG
gi|514486632|gb|KE346360.1|	3119136	3119150	ACACTC	14	+	2	CTCACA
gi|514486632|gb|KE346360.1|	3119552	3119564	ACCCTG	12	+	2	CTGACC
gi|514486632|gb|KE346360.1|	3119786	3119801	AAAGTG	15	-	2	TTCACT
gi|514486632|gb|KE346360.1|	3120106	3120120	AAC	14	+	4	AAC
gi|514486632|gb|KE346360.1|	3122099	3122114	AGCATC	15	-	2	CTGATG
gi|514486632|gb|KE346360.1|	3123379	3123391	AGATCT	12	+	2	TAGATC
gi|514486632|gb|KE346360.1|	3123678	3123694	AAATAC	16	+	2	AAATAC
gi|514486632|gb|KE346360.1|	3124184	3124196	AAAAAC	12	+	2	AACAAA
gi|514486632|gb|KE346360.1|	3124211	3124223	AAAAC	12	-	2	TGTTT
gi|514486632|gb|KE346360.1|	3127317	3127330	ACGATG	13	-	2	CATCGT
gi|514486632|gb|KE346360.1|	3128148	3128166	A	18	+	18	A
gi|514486632|gb|KE346360.1|	3128180	3128193	AAAAAC	13	+	2	AAACAA
gi|514486632|gb|KE346360.1|	3129394	3129407	ACGGCC	13	+	2	GCCACG
gi|514486632|gb|KE346360.1|	3130260	3130275	AGCATC	15	-	2	CTGATG
gi|514486632|gb|KE346360.1|	3131999	3132014	AAAAAC	15	-	2	TTTGTT
gi|514486632|gb|KE346360.1|	3132049	3132062	A	13	-	13	T
gi|514486632|gb|KE346360.1|	3132416	3132430	AAC	14	+	4	ACA
gi|514486632|gb|KE346360.1|	3132535	3132550	A	15	+	15	A
gi|514486632|gb|KE346360.1|	3133217	3133230	ACCCCC	13	+	2	CCCCCA
gi|514486632|gb|KE346360.1|	3134465	3134477	ACACGG	12	-	2	CCGTGT
gi|514486632|gb|KE346360.1|	3134502	3134517	AGCATC	15	-	2	CTGATG
gi|514486632|gb|KE346360.1|	3135546	3135558	AAAGGG	12	-	2	TTTCCC
gi|514486632|gb|KE346360.1|	3135691	3135703	A	12	-	12	T
gi|514486632|gb|KE346360.1|	3136045	3136063	A	18	+	18	A
gi|514486632|gb|KE346360.1|	3136251	3136275	A	24	+	24	A
gi|514486632|gb|KE346360.1|	3137825	3137837	AAGCTC	12	+	2	CTCAAG
gi|514486632|gb|KE346360.1|	3138325	3138338	AGGCGG	13	+	2	GGAGGC
gi|514486632|gb|KE346360.1|	3138580	3138612	AGC	32	+	10	CAG
gi|514486632|gb|KE346360.1|	3138791	3138803	ACTGCG	12	+	2	CGACTG
gi|514486632|gb|KE346360.1|	3138817	3138829	AGC	12	+	4	AGC
gi|514486632|gb|KE346360.1|	3138941	3138954	ATC	13	-	4	GAT
gi|514486632|gb|KE346360.1|	3139004	3139020	AGCCTC	16	-	2	TGAGGC
gi|514486632|gb|KE346360.1|	3139069	3139084	ACT	15	+	5	ACT
gi|514486632|gb|KE346360.1|	3139116	3139135	AGC	19	-	6	TGC
gi|514486632|gb|KE346360.1|	3139241	3139253	ACGAGG	12	-	2	TCGTCC
gi|514486632|gb|KE346360.1|	3139447	3139460	AACGT	13	+	2	TAACG
gi|514486632|gb|KE346360.1|	3139760	3139773	AC	13	+	6	AC
gi|514486632|gb|KE346360.1|	3139849	3139861	ACAGC	12	+	2	CACAG
gi|514486632|gb|KE346360.1|	3140108	3140124	AGC	16	+	5	CAG
gi|514486632|gb|KE346360.1|	3140196	3140214	AGC	18	+	6	AGC
gi|514486632|gb|KE346360.1|	3140354	3140366	AGGGCC	12	+	2	GGCCAG
gi|514486632|gb|KE346360.1|	3141206	3141220	AGC	14	-	4	TGC
gi|514486632|gb|KE346360.1|	3141306	3141319	A	13	-	13	T
gi|514486632|gb|KE346360.1|	3141409	3141431	ACATCC	22	+	3	ACATCC
gi|514486632|gb|KE346360.1|	3142408	3142420	AAAAAG	12	-	2	CTTTTT
gi|514486632|gb|KE346360.1|	3142490	3142508	AAG	18	-	6	CTT
gi|514486632|gb|KE346360.1|	3143074	3143087	AATAT	13	-	2	TATAT
gi|514486632|gb|KE346360.1|	3143296	3143310	AGGGGG	14	+	2	GGAGGG
gi|514486632|gb|KE346360.1|	3143409	3143421	AAAAAT	12	+	2	AAAAAT
gi|514486632|gb|KE346360.1|	3143427	3143444	AGCCG	17	-	3	GCTCG
gi|514486632|gb|KE346360.1|	3143891	3143903	AAAACG	12	-	2	GTTTTC
gi|514486632|gb|KE346360.1|	3143938	3143950	AAATG	12	-	2	TTTCA
gi|514486632|gb|KE346360.1|	3144091	3144103	ACG	12	-	4	GTC
gi|514486632|gb|KE346360.1|	3145356	3145368	AAATTG	12	+	2	GAAATT
gi|514486632|gb|KE346360.1|	3145714	3145727	AATCGC	13	+	2	GCAATC
gi|514486632|gb|KE346360.1|	3145756	3145769	AATCGC	13	+	2	GCAATC
gi|514486632|gb|KE346360.1|	3146082	3146094	AGCCGG	12	-	2	GCTCCG
gi|514486632|gb|KE346360.1|	3147247	3147259	AAATCG	12	+	2	TCGAAA
gi|514486632|gb|KE346360.1|	3152378	3152395	AGCCG	17	+	3	GCCGA
gi|514486632|gb|KE346360.1|	3152401	3152413	AAAAAT	12	-	2	ATTTTT
gi|514486632|gb|KE346360.1|	3152512	3152526	AGGGGG	14	-	2	CCCCCT
gi|514486632|gb|KE346360.1|	3152735	3152748	AATAT	13	+	2	ATAAT
gi|514486632|gb|KE346360.1|	3152988	3153002	AAG	14	-	4	TTC
gi|514486632|gb|KE346360.1|	3153031	3153052	A	21	-	21	T
gi|514486632|gb|KE346360.1|	3153191	3153203	AGAGGC	12	+	2	GCAGAG
gi|514486632|gb|KE346360.1|	3153298	3153310	AAGG	12	-	3	TCCT
gi|514486632|gb|KE346360.1|	3153315	3153330	AGC	15	-	5	GCT
gi|514486632|gb|KE346360.1|	3153466	3153478	AAAAGC	12	-	2	CTTTTG
gi|514486632|gb|KE346360.1|	3154351	3154363	ACATGG	12	-	2	TGTCCA
gi|514486632|gb|KE346360.1|	3154473	3154487	AGCCGC	14	-	2	GCGGCT
gi|514486632|gb|KE346360.1|	3156319	3156334	ACCGCC	15	-	2	GCGGTG
gi|514486632|gb|KE346360.1|	3156525	3156554	ACG	29	+	9	GAC
gi|514486632|gb|KE346360.1|	3156568	3156580	AAGACG	12	+	2	AAGACG
gi|514486632|gb|KE346360.1|	3157198	3157210	AGGGC	12	+	2	CAGGG
gi|514486632|gb|KE346360.1|	3157423	3157435	AAG	12	-	4	CTT
gi|514486632|gb|KE346360.1|	3157551	3157563	AGATCG	12	-	2	GATCTC
gi|514486632|gb|KE346360.1|	3159342	3159354	ACAGCG	12	-	2	CTGTCG
gi|514486632|gb|KE346360.1|	3160875	3160899	AGC	24	+	8	CAG
gi|514486632|gb|KE346360.1|	3161370	3161382	ATCCCG	12	+	2	ATCCCG
gi|514486632|gb|KE346360.1|	3161812	3161825	AGAGGC	13	-	2	CCTCTG
gi|514486632|gb|KE346360.1|	3161821	3161834	ACTGCG	13	+	2	CTGCGA
gi|514486632|gb|KE346360.1|	3161829	3161841	ACGGCG	12	+	2	GCGACG
gi|514486632|gb|KE346360.1|	3162604	3162617	AGCGGC	13	-	2	CTGCCG
gi|514486632|gb|KE346360.1|	3163194	3163207	ACAGCC	13	-	2	GTGGCT
gi|514486632|gb|KE346360.1|	3163295	3163308	ACCGCC	13	+	2	CACCGC
gi|514486632|gb|KE346360.1|	3163705	3163717	AACAGG	12	-	2	CTGTTC
gi|514486632|gb|KE346360.1|	3163712	3163725	AACAAG	13	-	2	TGTTCT
gi|514486632|gb|KE346360.1|	3164432	3164444	CCCCG	12	-	2	GGGCG
gi|514486632|gb|KE346360.1|	3165150	3165162	ACCCG	12	-	2	GGGTC
gi|514486632|gb|KE346360.1|	3166454	3166470	AGGGGC	16	+	2	GCAGGG
gi|514486632|gb|KE346360.1|	3168160	3168195	ATC	35	-	11	ATG
gi|514486632|gb|KE346360.1|	3168197	3168265	ATC	68	-	22	TGA
gi|514486632|gb|KE346360.1|	3168471	3168493	AAAAAT	22	+	3	AAAAAT
gi|514486632|gb|KE346360.1|	3168525	3168537	ACG	12	-	4	TCG
gi|514486632|gb|KE346360.1|	3168696	3168708	AAAATG	12	+	2	TGAAAA
gi|514486632|gb|KE346360.1|	3169038	3169055	AGAGCG	17	+	2	GAGAGC
gi|514486632|gb|KE346360.1|	3169139	3169159	AG	20	+	10	GA
gi|514486632|gb|KE346360.1|	3169213	3169230	AAAAAG	17	+	2	AAAAAG
gi|514486632|gb|KE346360.1|	3169225	3169238	A	13	+	13	A
gi|514486632|gb|KE346360.1|	3169508	3169526	AGGG	18	-	4	CTCC
gi|514486632|gb|KE346360.1|	3169708	3169727	A	19	+	19	A
gi|514486632|gb|KE346360.1|	3169827	3169840	AGCG	13	+	3	GAGC
gi|514486632|gb|KE346360.1|	3171758	3171792	AAC	34	-	11	GTT
gi|514486632|gb|KE346360.1|	3172564	3172578	CCG	14	-	4	GCG
gi|514486632|gb|KE346360.1|	3173132	3173146	AGC	14	-	4	GCT
gi|514486632|gb|KE346360.1|	3173531	3173544	ATC	13	+	4	ATC
gi|514486632|gb|KE346360.1|	3173827	3173842	ACTC	15	-	3	GTGA
gi|514486632|gb|KE346360.1|	3174065	3174078	AAATCC	13	-	2	TTGGAT
gi|514486632|gb|KE346360.1|	3174112	3174128	AACCCC	16	+	2	CCCCAA
gi|514486632|gb|KE346360.1|	3174215	3174228	ACTC	13	-	3	GTGA
gi|514486632|gb|KE346360.1|	3174222	3174240	ACTCTC	18	-	3	AGTGAG
gi|514486632|gb|KE346360.1|	3174260	3174272	A	12	+	12	A
gi|514486632|gb|KE346360.1|	3174467	3174504	A	37	-	37	T
gi|514486632|gb|KE346360.1|	3174518	3174531	CCCCG	13	+	2	CCGCC
gi|514486632|gb|KE346360.1|	3174707	3174720	AAACC	13	+	2	AAACC
gi|514486632|gb|KE346360.1|	3174724	3174740	A	16	+	16	A
gi|514486632|gb|KE346360.1|	3174892	3174920	A	28	+	28	A
gi|514486632|gb|KE346360.1|	3175223	3175236	AATCCG	13	-	2	CGGATT
gi|514486632|gb|KE346360.1|	3175323	3175337	AAAAC	14	+	2	AAAAC
gi|514486632|gb|KE346360.1|	3175991	3176003	AAAAC	12	+	2	AACAA
gi|514486632|gb|KE346360.1|	3177123	3177137	AGC	14	-	4	TGC
gi|514486632|gb|KE346360.1|	3177532	3177545	AGG	13	-	4	CTC
gi|514486632|gb|KE346360.1|	3177700	3177716	A	16	-	16	T
gi|514486632|gb|KE346360.1|	3177832	3177854	AAC	22	+	7	AAC
gi|514486632|gb|KE346360.1|	3178329	3178346	A	17	-	17	T
gi|514486632|gb|KE346360.1|	3181242	3181256	AAGAG	14	+	2	GAGAA
gi|514486632|gb|KE346360.1|	3182082	3182097	A	15	-	15	T
gi|514486632|gb|KE346360.1|	3185048	3185061	AAAGAG	13	+	2	AGAGAA
gi|514486632|gb|KE346360.1|	3185370	3185382	ACG	12	+	4	GAC
gi|514486632|gb|KE346360.1|	3185560	3185573	ACGCT	13	-	2	GTAGC
gi|514486632|gb|KE346360.1|	3186387	3186399	AAACTC	12	+	2	TCAAAC
gi|514486632|gb|KE346360.1|	3186554	3186570	A	16	+	16	A
gi|514486632|gb|KE346360.1|	3187411	3187423	ACGCG	12	+	2	CGCGA
gi|514486632|gb|KE346360.1|	3188049	3188073	AGC	24	+	8	CAG
gi|514486632|gb|KE346360.1|	3188068	3188080	ACTGCT	12	-	2	AGCAGT
gi|514486632|gb|KE346360.1|	3188336	3188348	ACCTCC	12	+	2	TCCACC
gi|514486632|gb|KE346360.1|	3190260	3190272	AAAG	12	+	3	GAAA
gi|514486632|gb|KE346360.1|	3190340	3190353	AAAACC	13	-	2	GGTTTT
gi|514486632|gb|KE346360.1|	3190396	3190409	AAAAAC	13	+	2	AAAAAC
gi|514486632|gb|KE346360.1|	3190527	3190539	AAATCC	12	+	2	AAATCC
gi|514486632|gb|KE346360.1|	3191787	3191804	AATGCC	17	+	2	CAATGC
gi|514486632|gb|KE346360.1|	3192281	3192294	ATC	13	+	4	CAT
gi|514486632|gb|KE346360.1|	3192542	3192554	AAGACG	12	+	2	AAGACG
gi|514486632|gb|KE346360.1|	3192576	3192588	CCG	12	+	4	CGC
gi|514486632|gb|KE346360.1|	3192970	3192982	AACGAG	12	+	2	CGAGAA
gi|514486632|gb|KE346360.1|	3193129	3193144	AAGGAC	15	+	2	GGACAA
gi|514486632|gb|KE346360.1|	3193873	3193886	ACGGCC	13	-	2	CCGTGG
gi|514486632|gb|KE346360.1|	3194130	3194145	AAC	15	-	5	TGT
gi|514486632|gb|KE346360.1|	3194191	3194204	AGAGC	13	-	2	CTCTG
gi|514486632|gb|KE346360.1|	3194638	3194651	CCG	13	-	4	CGG
gi|514486632|gb|KE346360.1|	3195120	3195132	AATTAC	12	-	2	TTGTAA
gi|514486632|gb|KE346360.1|	3195457	3195472	A	15	+	15	A
gi|514486632|gb|KE346360.1|	3195809	3195834	ACC	25	+	8	CCA
gi|514486632|gb|KE346360.1|	3196140	3196155	AGC	15	+	5	CAG
gi|514486632|gb|KE346360.1|	3196260	3196276	AGC	16	+	5	CAG
gi|514486632|gb|KE346360.1|	3196432	3196447	A	15	+	15	A
gi|514486632|gb|KE346360.1|	3196482	3196507	AATCC	25	-	5	ATTGG
gi|514486632|gb|KE346360.1|	3197054	3197069	AAAGCC	15	+	2	GCCAAA
gi|514486632|gb|KE346360.1|	3197306	3197319	AAACAC	13	-	2	TGTTTG
gi|514486632|gb|KE346360.1|	3198168	3198181	AAAAAC	13	-	2	TGTTTT
gi|514486632|gb|KE346360.1|	3198178	3198192	AAAAC	14	-	2	TTTTG
gi|514486632|gb|KE346360.1|	3198645	3198657	AACAGC	12	+	2	CAGCAA
gi|514486632|gb|KE346360.1|	3198744	3198757	AACATG	13	-	2	TCATGT
gi|514486632|gb|KE346360.1|	3199232	3199244	AAAGCC	12	+	2	AGCCAA
gi|514486632|gb|KE346360.1|	3199400	3199412	ACCGTC	12	+	2	TCACCG
gi|514486632|gb|KE346360.1|	3200296	3200320	AAC	24	-	8	TTG
gi|514486632|gb|KE346360.1|	3201167	3201179	AAAATG	12	+	2	TGAAAA
gi|514486632|gb|KE346360.1|	3201451	3201463	AACAAT	12	+	2	AACAAT
gi|514486632|gb|KE346360.1|	3201913	3201934	AC	21	-	10	GT
gi|514486632|gb|KE346360.1|	3203030	3203066	AC	36	+	18	CA
gi|514486632|gb|KE346360.1|	3203105	3203120	AAAAAC	15	+	2	AAAAAC
gi|514486632|gb|KE346360.1|	3203655	3203667	AAC	12	+	4	CAA
gi|514486632|gb|KE346360.1|	3203854	3203874	AG	20	+	10	GA
gi|514486632|gb|KE346360.1|	3204004	3204016	AAACAC	12	-	2	GTTTGT
gi|514486632|gb|KE346360.1|	3204066	3204079	A	13	+	13	A
gi|514486632|gb|KE346360.1|	3205217	3205229	AAGGCC	12	-	2	GGCCTT
gi|514486632|gb|KE346360.1|	3205919	3205934	AAC	15	-	5	TTG
gi|514486632|gb|KE346360.1|	3206273	3206287	AATAC	14	-	2	TGTAT
gi|514486632|gb|KE346360.1|	3206531	3206585	A	54	+	54	A
gi|514486632|gb|KE346360.1|	3206647	3206659	AACAGC	12	-	2	GTTGCT
gi|514486632|gb|KE346360.1|	3207404	3207416	AAGACG	12	+	2	GACGAA
gi|514486632|gb|KE346360.1|	3208474	3208487	AAGCCC	13	+	2	GCCCAA
gi|514486632|gb|KE346360.1|	3208938	3208951	ACGAGG	13	+	2	AGGACG
gi|514486632|gb|KE346360.1|	3208946	3208959	ACG	13	+	4	GAC
gi|514486632|gb|KE346360.1|	3209768	3209783	AAC	15	-	5	TGT
gi|514486632|gb|KE346360.1|	3209862	3209877	AAACTG	15	-	2	TCAGTT
gi|514486632|gb|KE346360.1|	3210056	3210073	ACGAGG	17	-	2	TCGTCC
gi|514486632|gb|KE346360.1|	3210139	3210151	AGC	12	-	4	TGC
gi|514486632|gb|KE346360.1|	3210511	3210528	ACGCCG	17	+	2	CGCCGA
gi|514486632|gb|KE346360.1|	3211247	3211259	AACCTG	12	-	2	GTTCAG
gi|514486632|gb|KE346360.1|	3211327	3211342	AAAAAC	15	-	2	TTTGTT
gi|514486632|gb|KE346360.1|	3212506	3212526	AGC	20	-	6	CTG
gi|514486632|gb|KE346360.1|	3214803	3214815	AAGTGC	12	+	2	TGCAAG
gi|514486632|gb|KE346360.1|	3215582	3215594	AACGAC	12	+	2	AACGAC
gi|514486632|gb|KE346360.1|	3216210	3216224	AGGGGG	14	+	2	AGGGGG
gi|514486632|gb|KE346360.1|	3216507	3216520	AAACGC	13	+	2	CGCAAA
gi|514486632|gb|KE346360.1|	3216821	3216833	AAC	12	-	4	TTG
gi|514486632|gb|KE346360.1|	3217406	3217420	AGC	14	-	4	TGC
gi|514486632|gb|KE346360.1|	3217630	3217642	AAGCAG	12	-	2	CTGCTT
gi|514486632|gb|KE346360.1|	3217738	3217751	AAC	13	-	4	GTT
gi|514486632|gb|KE346360.1|	3217758	3217784	AGC	26	-	8	TGC
gi|514486632|gb|KE346360.1|	3218132	3218144	A	12	-	12	T
gi|514486632|gb|KE346360.1|	3218486	3218504	AACAGC	18	+	3	CAGCAA
gi|514486632|gb|KE346360.1|	3218546	3218560	AGC	14	+	4	CAG
gi|514486632|gb|KE346360.1|	3219628	3219640	ACATGC	12	-	2	TGTGCA
gi|514486632|gb|KE346360.1|	3219710	3219722	A	12	+	12	A
gi|514486632|gb|KE346360.1|	3219721	3219742	AG	21	+	10	AG
gi|514486632|gb|KE346360.1|	3220374	3220391	AAGAGG	17	+	2	GAAGAG
gi|514486632|gb|KE346360.1|	3220386	3220402	AAG	16	+	5	GAA
gi|514486632|gb|KE346360.1|	3221577	3221589	ACAGGG	12	+	2	GACAGG
gi|514486632|gb|KE346360.1|	3221826	3221838	AAGAGC	12	-	2	TTGCTC
gi|514486632|gb|KE346360.1|	3221895	3221921	ACC	26	-	8	TGG
gi|514486632|gb|KE346360.1|	3222602	3222620	AGG	18	+	6	AGG
gi|514486632|gb|KE346360.1|	3222713	3222725	AGC	12	-	4	TGC
gi|514486632|gb|KE346360.1|	3222731	3222751	AGC	20	-	6	TGC
gi|514486632|gb|KE346360.1|	3222837	3222860	AAG	23	+	7	AGA
gi|514486632|gb|KE346360.1|	3222968	3222980	ACACCC	12	-	2	TGGGTG
gi|514486632|gb|KE346360.1|	3222975	3222989	ACCCGC	14	-	2	GGGTGC
gi|514486632|gb|KE346360.1|	3223108	3223130	ACCAGG	22	-	3	TCCTGG
gi|514486632|gb|KE346360.1|	3223276	3223290	AGC	14	-	4	TGC
gi|514486632|gb|KE346360.1|	3223297	3223311	AGC	14	-	4	TGC
gi|514486632|gb|KE346360.1|	3223306	3223318	AACAGC	12	-	2	TGCTGT
gi|514486632|gb|KE346360.1|	3223336	3223349	AACAGC	13	-	2	TGTTGC
gi|514486632|gb|KE346360.1|	3223510	3223527	ATC	17	-	5	GAT
gi|514486632|gb|KE346360.1|	3223525	3223537	AAG	12	+	4	GAA
gi|514486632|gb|KE346360.1|	3223619	3223631	AATTCG	12	+	2	TCGAAT
gi|514486632|gb|KE346360.1|	3224152	3224189	A	37	+	37	A
gi|514486632|gb|KE346360.1|	3224851	3224863	AAAC	12	-	3	GTTT
gi|514486632|gb|KE346360.1|	3225336	3225348	AGG	12	-	4	CCT
gi|514486632|gb|KE346360.1|	3225382	3225401	AATGGG	19	-	3	CCATTC
gi|514486632|gb|KE346360.1|	3225535	3225562	A	27	+	27	A
gi|514486632|gb|KE346360.1|	3225946	3225963	A	17	-	17	T
gi|514486632|gb|KE346360.1|	3226445	3226458	AG	13	-	6	CT
gi|514486632|gb|KE346360.1|	3226858	3226872	AGC	14	+	4	AGC
gi|514486632|gb|KE346360.1|	3227364	3227376	AAAAAT	12	-	2	ATTTTT
gi|514486632|gb|KE346360.1|	3228124	3228136	AAAAGC	12	+	2	GCAAAA
gi|514486632|gb|KE346360.1|	3228161	3228173	AAAACC	12	-	2	GGTTTT
gi|514486632|gb|KE346360.1|	3228169	3228183	A	14	-	14	T
gi|514486632|gb|KE346360.1|	3228703	3228717	ATC	14	+	4	TCA
gi|514486632|gb|KE346360.1|	3228715	3228727	ACG	12	-	4	TCG
gi|514486632|gb|KE346360.1|	3228762	3228775	ACACCT	13	-	2	GTAGGT
gi|514486632|gb|KE346360.1|	3228900	3228927	AGC	27	-	9	TGC
gi|514486632|gb|KE346360.1|	3229263	3229277	AACCAC	14	-	2	GTTGTG
gi|514486632|gb|KE346360.1|	3229272	3229285	ACC	13	-	4	GTG
gi|514486632|gb|KE346360.1|	3230654	3230667	AATAT	13	-	2	ATTAT
gi|514486632|gb|KE346360.1|	3230749	3230761	A	12	-	12	T
gi|514486632|gb|KE346360.1|	3231467	3231489	AGC	22	-	7	GCT
gi|514486632|gb|KE346360.1|	3231531	3231543	ACC	12	+	4	CAC
gi|514486632|gb|KE346360.1|	3231604	3231616	ACGCAT	12	-	2	ATGCGT
gi|514486632|gb|KE346360.1|	3231846	3231858	ACGAGC	12	+	2	CGAGCA
gi|514486632|gb|KE346360.1|	3232024	3232051	ACGAGG	27	-	4	GTCCTC
gi|514486632|gb|KE346360.1|	3232073	3232087	ATC	14	-	4	GAT
gi|514486632|gb|KE346360.1|	3232217	3232232	ACG	15	-	5	TCG
gi|514486632|gb|KE346360.1|	3232818	3232841	ACCAGC	23	+	3	CAGCAC
gi|514486632|gb|KE346360.1|	3233024	3233042	AGC	18	+	6	GCA
gi|514486632|gb|KE346360.1|	3233083	3233108	AGCTCC	25	-	4	GGAGCT
gi|514486632|gb|KE346360.1|	3233108	3233124	AAGCAG	16	-	2	CTGCTT
gi|514486632|gb|KE346360.1|	3233190	3233204	ACCAGC	14	-	2	TGGTGC
gi|514486632|gb|KE346360.1|	3233205	3233237	ACCAGC	32	-	5	TGGTGC
gi|514486632|gb|KE346360.1|	3233421	3233433	AACGAC	12	-	2	CGTTGT
gi|514486632|gb|KE346360.1|	3233452	3233466	AAAGG	14	+	2	GAAAG
gi|514486632|gb|KE346360.1|	3233473	3233510	A	37	+	37	A
gi|514486632|gb|KE346360.1|	3233609	3233635	AAAATC	26	-	4	TTGATT
gi|514486632|gb|KE346360.1|	3234334	3234347	AGC	13	+	4	CAG
gi|514486632|gb|KE346360.1|	3234382	3234395	ACCGCC	13	+	2	CCACCG
gi|514486632|gb|KE346360.1|	3236386	3236403	AAAAAG	17	-	2	TTTTTC
gi|514486632|gb|KE346360.1|	3237095	3237107	AAGATC	12	-	2	CTTGAT
gi|514486632|gb|KE346360.1|	3237342	3237356	ACCACG	14	-	2	GTGGTC
gi|514486632|gb|KE346360.1|	3239255	3239270	AACGC	15	+	3	CAACG
gi|514486632|gb|KE346360.1|	3239547	3239576	AAAAT	29	+	5	AAAAT
gi|514486632|gb|KE346360.1|	3239632	3239654	ATCC	22	+	5	CATC
gi|514486632|gb|KE346360.1|	3239722	3239734	AGG	12	+	4	GGA
gi|514486632|gb|KE346360.1|	3239788	3239812	AAC	24	+	8	ACA
gi|514486632|gb|KE346360.1|	3240205	3240233	ATC	28	-	9	TGA
gi|514486632|gb|KE346360.1|	3240635	3240692	AC	57	+	28	AC
gi|514486632|gb|KE346360.1|	3242550	3242572	AATG	22	+	5	AATG
gi|514486632|gb|KE346360.1|	3242782	3242795	ACCGCC	13	-	2	GTGGCG
gi|514486632|gb|KE346360.1|	3242790	3242813	CCG	23	-	7	GGC
gi|514486632|gb|KE346360.1|	3243470	3243484	CCG	14	-	4	GCG
gi|514486632|gb|KE346360.1|	3244403	3244419	AGC	16	+	5	AGC
gi|514486632|gb|KE346360.1|	3244431	3244509	AAC	78	+	26	ACA
gi|514486632|gb|KE346360.1|	3244683	3244695	AAAAAC	12	-	2	TTTTTG
gi|514486632|gb|KE346360.1|	3244697	3244709	AAAAAG	12	-	2	CTTTTT
gi|514486632|gb|KE346360.1|	3244745	3244757	AAAAAC	12	-	2	TTTTTG
gi|514486632|gb|KE346360.1|	3244759	3244771	AAAAAG	12	-	2	CTTTTT
gi|514486632|gb|KE346360.1|	3244983	3245002	AAC	19	-	6	TTG
gi|514486632|gb|KE346360.1|	3245210	3245225	A	15	-	15	T
gi|514486632|gb|KE346360.1|	3245265	3245282	AG	17	-	8	CT
gi|514486632|gb|KE346360.1|	3245484	3245502	ACTC	18	+	4	TCAC
gi|514486632|gb|KE346360.1|	3245496	3245510	ACTCTC	14	+	2	TCACTC
gi|514486632|gb|KE346360.1|	3245505	3245522	AG	17	-	8	CT
gi|514486632|gb|KE346360.1|	3245645	3245660	ACTCTC	15	+	2	CTCTCA
gi|514486632|gb|KE346360.1|	3245756	3245768	AAAAC	12	-	2	GTTTT
gi|514486632|gb|KE346360.1|	3245767	3245779	AAAAAC	12	-	2	TGTTTT
gi|514486632|gb|KE346360.1|	3245816	3245837	AAAAC	21	-	4	GTTTT
gi|514486632|gb|KE346360.1|	3245854	3245867	AG	13	-	6	CT
gi|514486632|gb|KE346360.1|	3246185	3246197	AATAG	12	-	2	ATTCT
gi|514486632|gb|KE346360.1|	3247247	3247265	AAAAC	18	-	3	TTTTG
gi|514486632|gb|KE346360.1|	3247291	3247305	AAAAC	14	-	2	TTTGT
gi|514486632|gb|KE346360.1|	3248737	3248749	AAAGC	12	+	2	AAAGC
gi|514486632|gb|KE346360.1|	3249057	3249069	AACTG	12	+	2	GAACT
gi|514486632|gb|KE346360.1|	3249166	3249186	A	20	-	20	T
gi|514486632|gb|KE346360.1|	3249936	3249948	AACAAG	12	+	2	GAACAA
gi|514486632|gb|KE346360.1|	3250021	3250037	AG	16	-	8	TC
gi|514486632|gb|KE346360.1|	3250514	3250526	AAGCTG	12	-	2	AGCTTC
gi|514486632|gb|KE346360.1|	3251541	3251553	ACGAGG	12	+	2	GGACGA
gi|514486632|gb|KE346360.1|	3252219	3252231	ACGAGT	12	-	2	TCGTAC
gi|514486632|gb|KE346360.1|	3253912	3253935	AGC	23	-	7	GCT
gi|514486632|gb|KE346360.1|	3254326	3254343	AGCATC	17	+	2	CAGCAT
gi|514486632|gb|KE346360.1|	3254349	3254361	AGC	12	+	4	GCA
gi|514486632|gb|KE346360.1|	3254356	3254373	AGCATC	17	+	2	CAGCAT
gi|514486632|gb|KE346360.1|	3254394	3254409	ACG	15	+	5	GAC
gi|514486632|gb|KE346360.1|	3255288	3255301	A	13	-	13	T
gi|514486632|gb|KE346360.1|	3255304	3255316	A	12	-	12	T
gi|514486632|gb|KE346360.1|	3255435	3255454	AC	19	-	9	GT
gi|514486632|gb|KE346360.1|	3255697	3255711	AAAAG	14	-	2	TTTTC
gi|514486632|gb|KE346360.1|	3255854	3255867	AGC	13	+	4	AGC
gi|514486632|gb|KE346360.1|	3255896	3255917	A	21	-	21	T
gi|514486632|gb|KE346360.1|	3255953	3255970	A	17	-	17	T
gi|514486632|gb|KE346360.1|	3256131	3256151	A	20	-	20	T
gi|514486632|gb|KE346360.1|	3256204	3256218	A	14	-	14	T
gi|514486632|gb|KE346360.1|	3256256	3256271	A	15	-	15	T
gi|514486632|gb|KE346360.1|	3256294	3256308	ATC	14	+	4	CAT
gi|514486632|gb|KE346360.1|	3256306	3256320	AAC	14	+	4	CAA
gi|514486632|gb|KE346360.1|	3256935	3256948	A	13	-	13	T
gi|514486632|gb|KE346360.1|	3256978	3256992	AAAAAG	14	-	2	TTTTCT
gi|514486632|gb|KE346360.1|	3257038	3257051	AAG	13	-	4	TCT
gi|514486632|gb|KE346360.1|	3257054	3257066	AACAG	12	-	2	CTGTT
gi|514486632|gb|KE346360.1|	3257676	3257690	ACGAGG	14	+	2	GACGAG
gi|514486632|gb|KE346360.1|	3257726	3257741	ACCGCC	15	+	2	CACCGC
gi|514486632|gb|KE346360.1|	3258288	3258317	AGC	29	+	9	AGC
gi|514486632|gb|KE346360.1|	3258332	3258344	AACAGC	12	+	2	CAGCAA
gi|514486632|gb|KE346360.1|	3258439	3258458	AGG	19	-	6	CCT
gi|514486632|gb|KE346360.1|	3259068	3259083	AGC	15	-	5	TGC
gi|514486632|gb|KE346360.1|	3259201	3259214	A	13	+	13	A
gi|514486632|gb|KE346360.1|	3259416	3259428	AGGCGG	12	+	2	GAGGCG
gi|514486632|gb|KE346360.1|	3259448	3259460	AAGGGC	12	-	2	GCCCTT
gi|514486632|gb|KE346360.1|	3260494	3260507	AACTCG	13	-	2	TCGAGT
gi|514486632|gb|KE346360.1|	3262162	3262176	AAAG	14	+	3	AAAG
gi|514486632|gb|KE346360.1|	3262401	3262416	ATGCCC	15	-	2	GCATGG
gi|514486632|gb|KE346360.1|	3262766	3262778	AAGCTC	12	-	2	TTGAGC
gi|514486632|gb|KE346360.1|	3263960	3263973	A	13	+	13	A
gi|514486632|gb|KE346360.1|	3264562	3264575	ACCAG	13	+	2	AGACC
gi|514486632|gb|KE346360.1|	3265247	3265261	A	14	-	14	T
gi|514486632|gb|KE346360.1|	3265472	3265489	A	17	+	17	A
gi|514486632|gb|KE346360.1|	3265565	3265578	ACTCTG	13	-	2	TCAGAG
gi|514486632|gb|KE346360.1|	3265653	3265667	A	14	+	14	A
gi|514486632|gb|KE346360.1|	3265699	3265713	A	14	-	14	T
gi|514486632|gb|KE346360.1|	3266049	3266063	A	14	+	14	A
gi|514486632|gb|KE346360.1|	3266066	3266080	A	14	+	14	A
gi|514486632|gb|KE346360.1|	3266365	3266377	AC	12	-	6	GT
gi|514486632|gb|KE346360.1|	3266463	3266484	A	21	+	21	A
gi|514486632|gb|KE346360.1|	3266605	3266617	AGG	12	+	4	GAG
gi|514486632|gb|KE346360.1|	3266655	3266668	A	13	+	13	A
gi|514486632|gb|KE346360.1|	3266687	3266702	A	15	+	15	A
gi|514486632|gb|KE346360.1|	3266824	3266836	A	12	+	12	A
gi|514486632|gb|KE346360.1|	3266932	3266956	A	24	+	24	A
gi|514486632|gb|KE346360.1|	3267061	3267077	AC	16	+	8	CA
gi|514486632|gb|KE346360.1|	3267772	3267784	AAATCC	12	+	2	CAAATC
gi|514486632|gb|KE346360.1|	3267947	3267963	AG	16	+	8	GA
gi|514486632|gb|KE346360.1|	3268113	3268130	A	17	-	17	T
gi|514486632|gb|KE346360.1|	3268250	3268267	AAG	17	-	5	TCT
gi|514486632|gb|KE346360.1|	3270618	3270632	AGGCCG	14	-	2	CTCGGC
gi|514486632|gb|KE346360.1|	3272224	3272238	AACAGC	14	-	2	TGTTGC
gi|514486632|gb|KE346360.1|	3272247	3272265	AAC	18	-	6	TTG
gi|514486632|gb|KE346360.1|	3272263	3272282	AGC	19	-	6	TGC
gi|514486632|gb|KE346360.1|	3272308	3272320	AAGGCG	12	+	2	GGCGAA
gi|514486632|gb|KE346360.1|	3273216	3273230	AGGCGG	14	+	2	GGAGGC
gi|514486632|gb|KE346360.1|	3273766	3273810	AGC	44	-	14	TGC
gi|514486632|gb|KE346360.1|	3276976	3276988	ACGGCG	12	+	2	GCGACG
gi|514486632|gb|KE346360.1|	3277371	3277386	ATCC	15	+	3	TCCA
gi|514486632|gb|KE346360.1|	3277639	3277653	AAAAG	14	+	2	AAAAG
gi|514486632|gb|KE346360.1|	3277836	3277849	AAAG	13	-	3	CTTT
gi|514486632|gb|KE346360.1|	3277866	3277879	AG	13	-	6	CT
gi|514486632|gb|KE346360.1|	3277876	3277889	ACTC	13	+	3	CTCA
gi|514486632|gb|KE346360.1|	3277914	3277948	AG	34	-	17	TC
gi|514486632|gb|KE346360.1|	3278084	3278096	ACG	12	+	4	CGA
gi|514486632|gb|KE346360.1|	3278142	3278168	ACG	26	+	8	GAC
gi|514486632|gb|KE346360.1|	3278163	3278179	ACGAGG	16	+	2	GACGAG
gi|514486632|gb|KE346360.1|	3278242	3278258	AGCGGC	16	-	2	CTGCCG
gi|514486632|gb|KE346360.1|	3278253	3278269	AGC	16	-	5	GCT
gi|514486632|gb|KE346360.1|	3278466	3278480	ACGATG	14	+	2	GATGAC
gi|514486632|gb|KE346360.1|	3278475	3278492	ACG	17	+	5	GAC
gi|514486632|gb|KE346360.1|	3278496	3278512	ACGATG	16	+	2	GATGAC
gi|514486632|gb|KE346360.1|	3278526	3278543	ACGAGG	17	+	2	GACGAG
gi|514486632|gb|KE346360.1|	3278538	3278552	ACG	14	+	4	GAC
gi|514486632|gb|KE346360.1|	3278762	3278774	AGGGCG	12	+	2	GCGAGG
gi|514486632|gb|KE346360.1|	3278813	3278825	AGC	12	+	4	GCA
gi|514486632|gb|KE346360.1|	3279881	3279898	AGC	17	+	5	CAG
gi|514486632|gb|KE346360.1|	3279896	3279922	AAC	26	+	8	CAA
gi|514486632|gb|KE346360.1|	3280668	3280681	AAAAC	13	-	2	GTTTT
gi|514486632|gb|KE346360.1|	3281184	3281196	AAAAAG	12	+	2	AAGAAA
gi|514486632|gb|KE346360.1|	3281660	3281672	ACC	12	-	4	GTG
gi|514486632|gb|KE346360.1|	3281673	3281689	ACC	16	-	5	GTG
gi|514486632|gb|KE346360.1|	3282347	3282360	AAC	13	-	4	GTT
gi|514486632|gb|KE346360.1|	3282422	3282435	AGCATC	13	+	2	CAGCAT
gi|514486632|gb|KE346360.1|	3282510	3282529	CCG	19	-	6	GGC
gi|514486632|gb|KE346360.1|	3282546	3282559	AGCCG	13	+	2	AGCCG
gi|514486632|gb|KE346360.1|	3282628	3282641	ACAGCC	13	-	2	GCTGTG
gi|514486632|gb|KE346360.1|	3283035	3283047	A	12	-	12	T
gi|514486632|gb|KE346360.1|	3284734	3284747	AATCC	13	-	2	TTGGA
gi|514486632|gb|KE346360.1|	3285510	3285522	AAAAC	12	-	2	TTGTT
gi|514486632|gb|KE346360.1|	3285529	3285545	A	16	-	16	T
gi|514486632|gb|KE346360.1|	3285547	3285561	A	14	-	14	T
gi|514486632|gb|KE346360.1|	3285748	3285760	AAAG	12	-	3	TTTC
gi|514486632|gb|KE346360.1|	3285865	3285877	AGAGGC	12	-	2	CCTCTG
gi|514486632|gb|KE346360.1|	3287618	3287630	ACAGCG	12	-	2	TCGCTG
gi|514486632|gb|KE346360.1|	3288227	3288249	AAC	22	-	7	TTG
gi|514486632|gb|KE346360.1|	3288306	3288330	A	24	+	24	A
gi|514486632|gb|KE346360.1|	3288353	3288372	AAAAT	19	+	3	AAAAT
gi|514486632|gb|KE346360.1|	3288560	3288582	AAAG	22	+	5	GAAA
gi|514486632|gb|KE346360.1|	3288781	3288793	AGAGCG	12	+	2	GAGAGC
gi|514486632|gb|KE346360.1|	3288915	3288932	AG	17	-	8	CT
gi|514486632|gb|KE346360.1|	3289009	3289021	AAAAAG	12	-	2	CTTTTT
gi|514486632|gb|KE346360.1|	3289033	3289046	A	13	-	13	T
gi|514486632|gb|KE346360.1|	3289052	3289064	ATCGCC	12	+	2	CCATCG
gi|514486632|gb|KE346360.1|	3289309	3289328	AAAAAC	19	+	3	AAAAAC
gi|514486632|gb|KE346360.1|	3289425	3289438	CCG	13	+	4	CCG
gi|514486632|gb|KE346360.1|	3289841	3289853	AAG	12	-	4	CTT
gi|514486632|gb|KE346360.1|	3289959	3289971	AGCGCG	12	-	2	TCGCGC
gi|514486632|gb|KE346360.1|	3290244	3290258	ACG	14	-	4	TCG
gi|514486632|gb|KE346360.1|	3291217	3291229	AAGCCC	12	-	2	GCTTGG
gi|514486632|gb|KE346360.1|	3292280	3292292	AAAGC	12	-	2	CTTTG
gi|514486632|gb|KE346360.1|	3292383	3292396	ACG	13	-	4	TCG
gi|514486632|gb|KE346360.1|	3292475	3292488	ACGATG	13	-	2	ATCGTC
gi|514486632|gb|KE346360.1|	3292580	3292592	AGC	12	-	4	CTG
gi|514486632|gb|KE346360.1|	3292671	3292685	ACG	14	-	4	TCG
gi|514486632|gb|KE346360.1|	3293090	3293106	ACCGCG	16	+	2	CCGCGA
gi|514486632|gb|KE346360.1|	3293104	3293116	AGGCCG	12	-	2	GCCTCG
gi|514486632|gb|KE346360.1|	3293337	3293351	AGCATC	14	+	2	CATCAG
gi|514486632|gb|KE346360.1|	3293779	3293791	AACAC	12	-	2	TGTTG
gi|514486632|gb|KE346360.1|	3294015	3294027	ACCCC	12	+	2	CCCAC
gi|514486632|gb|KE346360.1|	3294171	3294187	AAAATT	16	-	2	TTTTAA
gi|514486632|gb|KE346360.1|	3294390	3294411	A	21	-	21	T
gi|514486632|gb|KE346360.1|	3294630	3294651	ACCAGT	21	+	3	CAGTAC
gi|514486632|gb|KE346360.1|	3294648	3294664	AACAGC	16	+	2	CAGCAA
gi|514486632|gb|KE346360.1|	3294954	3294968	AGCTCC	14	+	2	CAGCTC
gi|514486632|gb|KE346360.1|	3294996	3295019	AGC	23	+	7	CAG
gi|514486632|gb|KE346360.1|	3295280	3295316	A	36	-	36	T
gi|514486632|gb|KE346360.1|	3296024	3296037	A	13	-	13	T
gi|514486632|gb|KE346360.1|	3296110	3296123	ACTC	13	+	3	TCAC
gi|514486632|gb|KE346360.1|	3296230	3296242	AAAAAC	12	-	2	TTGTTT
gi|514486632|gb|KE346360.1|	3296405	3296419	AACAGC	14	+	2	CAGCAA
gi|514486632|gb|KE346360.1|	3296462	3296476	AACAGC	14	+	2	CAACAG
gi|514486632|gb|KE346360.1|	3296471	3296488	AGC	17	+	5	CAG
gi|514486632|gb|KE346360.1|	3296495	3296509	AACAGC	14	+	2	CAGCAA
gi|514486632|gb|KE346360.1|	3296640	3296653	ACTGAG	13	-	2	CTCAGT
gi|514486632|gb|KE346360.1|	3296837	3296849	AAATC	12	-	2	TGATT
gi|514486632|gb|KE346360.1|	3296887	3296899	AAC	12	-	4	TTG
gi|514486632|gb|KE346360.1|	3297170	3297182	AAACAC	12	-	2	TGTTTG
gi|514486632|gb|KE346360.1|	3297207	3297221	AAG	14	-	4	CTT
gi|514486632|gb|KE346360.1|	3297873	3297887	AAAAC	14	-	2	TTTTG
gi|514486632|gb|KE346360.1|	3298134	3298146	AAAC	12	-	3	TTTG
gi|514486632|gb|KE346360.1|	3298187	3298202	A	15	-	15	T
gi|514486632|gb|KE346360.1|	3298790	3298802	AGCCCG	12	+	2	CGAGCC
gi|514486632|gb|KE346360.1|	3298976	3298992	A	16	-	16	T
gi|514486632|gb|KE346360.1|	3299092	3299106	ACG	14	-	4	TCG
gi|514486632|gb|KE346360.1|	3299105	3299122	AGC	17	+	5	CAG
gi|514486632|gb|KE346360.1|	3299314	3299329	AGC	15	+	5	GCA
gi|514486632|gb|KE346360.1|	3299617	3299634	ACCGCC	17	+	2	GCCACC
gi|514486632|gb|KE346360.1|	3299937	3299955	ACG	18	+	6	CGA
gi|514486632|gb|KE346360.1|	3299953	3299967	ATC	14	-	4	GAT
gi|514486632|gb|KE346360.1|	3302076	3302090	AAC	14	-	4	TGT
gi|514486632|gb|KE346360.1|	3302232	3302246	ACCGC	14	-	2	TGCGG
gi|514486632|gb|KE346360.1|	3302515	3302532	AGCAGG	17	+	2	GGAGCA
gi|514486632|gb|KE346360.1|	3302733	3302745	ACG	12	-	4	GTC
gi|514486632|gb|KE346360.1|	3302746	3302758	ACCACG	12	-	2	TGGTCG
gi|514486632|gb|KE346360.1|	3303160	3303174	AGCGC	14	+	2	GCGCA
gi|514486632|gb|KE346360.1|	3303391	3303403	AGCGGG	12	+	2	GCGGGA
gi|514486632|gb|KE346360.1|	3303398	3303422	AACGGG	24	+	4	CGGGAA
gi|514486632|gb|KE346360.1|	3303613	3303639	AGC	26	-	8	TGC
gi|514486632|gb|KE346360.1|	3303643	3303658	ACC	15	-	5	TGG
gi|514486632|gb|KE346360.1|	3303664	3303678	ATGGCC	14	+	2	TGGCCA
gi|514486632|gb|KE346360.1|	3304036	3304050	A	14	+	14	A
gi|514486632|gb|KE346360.1|	3304053	3304065	A	12	+	12	A
gi|514486632|gb|KE346360.1|	3304239	3304252	AAAAG	13	+	2	AAAAG
gi|514486632|gb|KE346360.1|	3304390	3304407	CCG	17	-	5	GGC
gi|514486632|gb|KE346360.1|	3304537	3304549	ACCACG	12	-	2	CGTGGT
gi|514486632|gb|KE346360.1|	3304577	3304593	AGGCCG	16	+	2	GAGGCC
gi|514486632|gb|KE346360.1|	3304588	3304611	ACCTCG	23	-	3	CGAGGT
gi|514486632|gb|KE346360.1|	3304684	3304696	AGCGGC	12	-	2	GCTGCC
gi|514486632|gb|KE346360.1|	3304748	3304760	AACCCC	12	-	2	GGGTTG
gi|514486632|gb|KE346360.1|	3304780	3304792	CCG	12	-	4	GGC
gi|514486632|gb|KE346360.1|	3304831	3304843	ACG	12	+	4	CGA
gi|514486632|gb|KE346360.1|	3304885	3304903	AGC	18	-	6	CTG
gi|514486632|gb|KE346360.1|	3305308	3305323	AAGC	15	+	3	CAAG
gi|514486632|gb|KE346360.1|	3306073	3306085	AAACAC	12	-	2	TTTGTG
gi|514486632|gb|KE346360.1|	3306652	3306664	A	12	+	12	A
gi|514486632|gb|KE346360.1|	3306669	3306681	AAAAAC	12	+	2	CAAAAA
gi|514486632|gb|KE346360.1|	3306894	3306906	AAAAC	12	+	2	ACAAA
gi|514486632|gb|KE346360.1|	3308569	3308582	AGGATC	13	-	2	ATCCTG
gi|514486632|gb|KE346360.1|	3308674	3308691	ACGCTC	17	+	2	CTCACG
gi|514486632|gb|KE346360.1|	3309295	3309307	A	12	+	12	A
gi|514486632|gb|KE346360.1|	3309858	3309872	AAACGT	14	-	2	TTACGT
gi|514486632|gb|KE346360.1|	3312643	3312661	AAC	18	+	6	CAA
gi|514486632|gb|KE346360.1|	3312807	3312819	AAAGCC	12	-	2	TTGGCT
gi|514486632|gb|KE346360.1|	3313017	3313030	AAACTC	13	-	2	TTTGAG
gi|514486632|gb|KE346360.1|	3313159	3313175	AGAGGG	16	+	2	GAGAGG
gi|514486632|gb|KE346360.1|	3313185	3313204	A	19	-	19	T
gi|514486632|gb|KE346360.1|	3314337	3314349	AAGCAG	12	+	2	AGAAGC
gi|514486632|gb|KE346360.1|	3314438	3314451	AAG	13	+	4	GAA
gi|514486632|gb|KE346360.1|	3314461	3314474	AAG	13	+	4	AGA
gi|514486632|gb|KE346360.1|	3314586	3314598	AAAAC	12	-	2	TTTTG
gi|514486632|gb|KE346360.1|	3315005	3315017	ACGCCG	12	-	2	CGGCGT
gi|514486632|gb|KE346360.1|	3315352	3315371	AAAG	19	+	4	AGAA
gi|514486632|gb|KE346360.1|	3315749	3315763	A	14	+	14	A
gi|514486632|gb|KE346360.1|	3316620	3316634	AAGTGC	14	+	2	AGTGCA
gi|514486632|gb|KE346360.1|	3316636	3316650	AAGAGC	14	+	2	GCAAGA
gi|514486632|gb|KE346360.1|	3316863	3316883	A	20	-	20	T
gi|514486632|gb|KE346360.1|	3317056	3317075	A	19	+	19	A
gi|514486632|gb|KE346360.1|	3317315	3317336	A	21	-	21	T
gi|514486632|gb|KE346360.1|	3317878	3317890	AAAGAG	12	+	2	GAGAAA
gi|514486632|gb|KE346360.1|	3317897	3317914	A	17	+	17	A
gi|514486632|gb|KE346360.1|	3317932	3317951	A	19	+	19	A
gi|514486632|gb|KE346360.1|	3317966	3317978	AAAATG	12	+	2	AATGAA
gi|514486632|gb|KE346360.1|	3317981	3318005	A	24	+	24	A
gi|514486632|gb|KE346360.1|	3319399	3319411	AGC	12	+	4	GCA
gi|514486632|gb|KE346360.1|	3319799	3319811	ACG	12	-	4	GTC
gi|514486632|gb|KE346360.1|	3321252	3321266	AAAAG	14	+	2	AAAAG
gi|514486632|gb|KE346360.1|	3321264	3321276	AAAAAG	12	+	2	AAAAAG
gi|514486632|gb|KE346360.1|	3321419	3321431	A	12	+	12	A
gi|514486632|gb|KE346360.1|	3321597	3321609	AAAAT	12	+	2	AATAA
gi|514486632|gb|KE346360.1|	3322369	3322384	AAAC	15	+	3	AAAC
gi|514486632|gb|KE346360.1|	3326264	3326292	AGGATG	28	-	4	CATCCT
gi|514486632|gb|KE346360.1|	3328067	3328079	ACCGTG	12	+	2	ACCGTG
gi|514486632|gb|KE346360.1|	3328353	3328365	AAAAC	12	+	2	ACAAA
gi|514486632|gb|KE346360.1|	3329132	3329150	A	18	-	18	T
gi|514486632|gb|KE346360.1|	3329230	3329243	AAACAC	13	+	2	ACACAA
gi|514486632|gb|KE346360.1|	3329846	3329868	A	22	-	22	T
gi|514486632|gb|KE346360.1|	3330037	3330049	ACGAG	12	+	2	AGACG
gi|514486632|gb|KE346360.1|	3330250	3330262	AAAAC	12	+	2	AAAAC
gi|514486632|gb|KE346360.1|	3330573	3330585	AGGG	12	-	3	CCCT
gi|514486632|gb|KE346360.1|	3330956	3330968	AAAGCC	12	-	2	TGGCTT
gi|514486632|gb|KE346360.1|	3331065	3331077	ACG	12	-	4	TCG
gi|514486632|gb|KE346360.1|	3331421	3331433	ACTCAG	12	+	2	AGACTC
gi|514486632|gb|KE346360.1|	3331959	3331973	AAGCCC	14	-	2	GGCTTG
gi|514486632|gb|KE346360.1|	3332065	3332078	AGCGCG	13	-	2	GCTCGC
gi|514486632|gb|KE346360.1|	3332174	3332186	ACGGCC	12	-	2	CGTGGC
gi|514486632|gb|KE346360.1|	3333113	3333126	ACCG	13	+	3	CGAC
gi|514486632|gb|KE346360.1|	3333602	3333617	ACACGG	15	-	2	GTCCGT
gi|514486632|gb|KE346360.1|	3333672	3333685	AGC	13	-	4	GCT
gi|514486632|gb|KE346360.1|	3333808	3333825	ATC	17	+	5	CAT
gi|514486632|gb|KE346360.1|	3333830	3333842	AAC	12	-	4	GTT
gi|514486632|gb|KE346360.1|	3333844	3333856	ACTGGC	12	+	2	GCACTG
gi|514486632|gb|KE346360.1|	3333954	3333979	A	25	+	25	A
gi|514486632|gb|KE346360.1|	3334052	3334067	AC	15	+	7	AC
gi|514486632|gb|KE346360.1|	3334363	3334378	CCG	15	+	5	GCC
gi|514486632|gb|KE346360.1|	3334379	3334392	CCG	13	+	4	CCG
gi|514486632|gb|KE346360.1|	3334463	3334477	CCG	14	-	4	GGC
gi|514486632|gb|KE346360.1|	3334864	3334876	ACCTCC	12	-	2	TGGAGG
gi|514486632|gb|KE346360.1|	3335080	3335094	AAAAC	14	+	2	CAAAA
gi|514486632|gb|KE346360.1|	3335102	3335118	A	16	+	16	A
gi|514486632|gb|KE346360.1|	3335509	3335521	AGC	12	-	4	TGC
gi|514486632|gb|KE346360.1|	3335631	3335650	AGG	19	+	6	AGG
gi|514486632|gb|KE346360.1|	3335665	3335682	AGGCGG	17	+	2	GGCGGA
gi|514486632|gb|KE346360.1|	3335685	3335697	ACC	12	+	4	ACC
gi|514486632|gb|KE346360.1|	3336995	3337009	AAACTG	14	+	2	AAACTG
gi|514486632|gb|KE346360.1|	3337004	3337016	AAGCTG	12	+	2	CTGAAG
gi|514486632|gb|KE346360.1|	3337021	3337048	A	27	-	27	T
gi|514486632|gb|KE346360.1|	3337226	3337244	A	18	+	18	A
gi|514486632|gb|KE346360.1|	3337273	3337289	A	16	+	16	A
gi|514486632|gb|KE346360.1|	3337381	3337393	ACCCCC	12	-	2	GGGGGT
gi|514486632|gb|KE346360.1|	3337635	3337652	AAC	17	+	5	ACA
gi|514486632|gb|KE346360.1|	3337817	3337845	A	28	+	28	A
gi|514486632|gb|KE346360.1|	3337846	3337861	AAAGG	15	+	3	AAAGG
gi|514486632|gb|KE346360.1|	3338032	3338048	AAAC	16	+	4	CAAA
gi|514486632|gb|KE346360.1|	3338051	3338063	A	12	+	12	A
gi|514486632|gb|KE346360.1|	3338071	3338083	A	12	+	12	A
gi|514486632|gb|KE346360.1|	3338465	3338477	ACGAGG	12	+	2	ACGAGG
gi|514486632|gb|KE346360.1|	3338637	3338649	AAGCGC	12	+	2	GCAAGC
gi|514486632|gb|KE346360.1|	3339050	3339067	AAGCAG	17	+	2	CAGAAG
gi|514486632|gb|KE346360.1|	3339312	3339325	AAGAGC	13	+	2	AGAGCA
gi|514486632|gb|KE346360.1|	3339379	3339393	AGC	14	+	4	GCA
gi|514486632|gb|KE346360.1|	3341715	3341727	AAGGTG	12	+	2	GTGAAG
gi|514486632|gb|KE346360.1|	3343550	3343564	AAAGGC	14	-	2	TGCCTT
gi|514486632|gb|KE346360.1|	3345520	3345551	A	31	+	31	A
gi|514486632|gb|KE346360.1|	3346346	3346361	AAGC	15	+	3	CAAG
gi|514486632|gb|KE346360.1|	3346402	3346414	AAAC	12	+	3	CAAA
gi|514486632|gb|KE346360.1|	3346968	3346980	ACGTGC	12	+	2	GCACGT
gi|514486632|gb|KE346360.1|	3347047	3347062	AAAAC	15	+	3	CAAAA
gi|514486632|gb|KE346360.1|	3347058	3347072	AAAAG	14	+	2	AAAAG
gi|514486632|gb|KE346360.1|	3347379	3347595	AC	216	+	108	AC
gi|514486632|gb|KE346360.1|	3347621	3347649	AC	28	+	14	AC
gi|514486632|gb|KE346360.1|	3347652	3347684	AC	32	+	16	CA
gi|514486632|gb|KE346360.1|	3347693	3347710	AC	17	+	8	CA
gi|514486632|gb|KE346360.1|	3347893	3347969	AC	76	+	38	CA
gi|514486632|gb|KE346360.1|	3347968	3347991	A	23	+	23	A
gi|514486632|gb|KE346360.1|	3349291	3349342	A	51	+	51	A
gi|514486632|gb|KE346360.1|	3349366	3349378	AATTC	12	+	2	TTCAA
gi|514486632|gb|KE346360.1|	3350009	3350021	C	12	-	12	G
gi|514486632|gb|KE346360.1|	3350271	3350293	AG	22	-	11	TC
gi|514486632|gb|KE346360.1|	3350389	3350401	AG	12	+	6	GA
gi|514486632|gb|KE346360.1|	3350429	3350443	A	14	-	14	T
gi|514486632|gb|KE346360.1|	3350468	3350480	AAGAG	12	-	2	CTTCT
gi|514486632|gb|KE346360.1|	3350600	3350615	A	15	-	15	T
gi|514486632|gb|KE346360.1|	3351397	3351449	AAC	52	-	17	TTG
gi|514486632|gb|KE346360.1|	3351882	3351895	A	13	-	13	T
gi|514486632|gb|KE346360.1|	3353908	3353955	AG	47	+	23	AG
gi|514486632|gb|KE346360.1|	3353966	3353978	AAAGAG	12	+	2	AGAGAA
gi|514486632|gb|KE346360.1|	3354058	3354073	A	15	+	15	A
gi|514486632|gb|KE346360.1|	3354071	3354084	AAGCGG	13	+	2	AAGCGG
gi|514486632|gb|KE346360.1|	3354163	3354177	AAG	14	+	4	GAA
gi|514486632|gb|KE346360.1|	3354185	3354197	AAGGGG	12	+	2	GAAGGG
gi|514486632|gb|KE346360.1|	3354516	3354536	A	20	+	20	A
gi|514486632|gb|KE346360.1|	3356112	3356124	AAAAAC	12	-	2	GTTTTT
gi|514486632|gb|KE346360.1|	3358183	3358201	ACG	18	+	6	CGA
gi|514486632|gb|KE346360.1|	3358433	3358445	ACT	12	+	4	ACT
gi|514486632|gb|KE346360.1|	3358448	3358460	ACGACT	12	+	2	ACGACT
gi|514486632|gb|KE346360.1|	3358458	3358483	AGC	25	-	8	CTG
gi|514486632|gb|KE346360.1|	3358503	3358524	AGAGCC	21	-	3	CTGGCT
gi|514486632|gb|KE346360.1|	3359483	3359495	AGCCGC	12	+	2	CGCAGC
gi|514486632|gb|KE346360.1|	3361106	3361118	ACCATC	12	-	2	GATGGT
gi|514486632|gb|KE346360.1|	3361629	3361641	AAAAAT	12	+	2	AAAAAT
gi|514486632|gb|KE346360.1|	3362020	3362032	AAC	12	+	4	ACA
gi|514486632|gb|KE346360.1|	3362212	3362224	AAGCTC	12	-	2	AGCTTG
gi|514486632|gb|KE346360.1|	3362392	3362407	AC	15	+	7	AC
gi|514486632|gb|KE346360.1|	3362423	3362436	A	13	+	13	A
gi|514486632|gb|KE346360.1|	3363047	3363062	ACTC	15	-	3	GTGA
gi|514486632|gb|KE346360.1|	3363830	3363843	AGCATG	13	+	2	GAGCAT
gi|514486632|gb|KE346360.1|	3364582	3364603	A	21	-	21	T
gi|514486632|gb|KE346360.1|	3365050	3365063	ACC	13	-	4	GGT
gi|514486632|gb|KE346360.1|	3365059	3365071	ACACCC	12	-	2	GGTGTG
gi|514486632|gb|KE346360.1|	3365181	3365209	A	28	-	28	T
gi|514486632|gb|KE346360.1|	3365513	3365526	CCCCCG	13	-	2	GGGGGC
gi|514486632|gb|KE346360.1|	3367180	3367197	AGC	17	+	5	GCA
gi|514486632|gb|KE346360.1|	3367296	3367309	AAATCC	13	-	2	ATTTGG
gi|514486632|gb|KE346360.1|	3367347	3367361	ACGCG	14	-	2	GCGTC
gi|514486632|gb|KE346360.1|	3368572	3368584	A	12	-	12	T
gi|514486632|gb|KE346360.1|	3369115	3369128	ACG	13	+	4	CGA
gi|514486632|gb|KE346360.1|	3369129	3369146	ACG	17	+	5	ACG
gi|514486632|gb|KE346360.1|	3369245	3369257	A	12	+	12	A
gi|514486632|gb|KE346360.1|	3369433	3369456	A	23	+	23	A
gi|514486632|gb|KE346360.1|	3369453	3369465	AAAGAC	12	+	2	AAAGAC
gi|514486632|gb|KE346360.1|	3369727	3369739	AAAGTC	12	-	2	ACTTTG
gi|514486632|gb|KE346360.1|	3369745	3369759	AAAGCC	14	-	2	CTTTGG
gi|514486632|gb|KE346360.1|	3369884	3369899	A	15	+	15	A
gi|514486632|gb|KE346360.1|	3369922	3369937	AAG	15	-	5	TTC
gi|514486632|gb|KE346360.1|	3370807	3370823	AGGGGG	16	-	2	CTCCCC
gi|514486632|gb|KE346360.1|	3370912	3370925	AAGTGC	13	+	2	CAAGTG
gi|514486632|gb|KE346360.1|	3371239	3371252	AGCGCG	13	-	2	CTCGCG
gi|514486632|gb|KE346360.1|	3371419	3371431	AAGCAC	12	-	2	CTTGTG
gi|514486632|gb|KE346360.1|	3371588	3371605	AAGACG	17	-	2	TCTTCG
gi|514486632|gb|KE346360.1|	3373452	3373465	AAG	13	+	4	AGA
gi|514486632|gb|KE346360.1|	3373557	3373569	AAGATG	12	+	2	TGAAGA
gi|514486632|gb|KE346360.1|	3373930	3373942	AAAAAG	12	-	2	TTTTTC
gi|514486632|gb|KE346360.1|	3374181	3374194	AAGGAC	13	+	2	AAGGAC
gi|514486632|gb|KE346360.1|	3374236	3374251	CCCG	15	-	3	GGGC
gi|514486632|gb|KE346360.1|	3374271	3374289	A	18	+	18	A
gi|514486632|gb|KE346360.1|	3374296	3374313	AACAAG	17	+	2	AAGAAC
gi|514486632|gb|KE346360.1|	3374368	3374382	AGGGGC	14	+	2	GCAGGG
gi|514486632|gb|KE346360.1|	3375697	3375713	ACCTGC	16	-	2	GCAGGT
gi|514486632|gb|KE346360.1|	3375813	3375825	AGCGGC	12	+	2	GGCAGC
gi|514486632|gb|KE346360.1|	3376420	3376435	A	15	+	15	A
gi|514486632|gb|KE346360.1|	3376604	3376619	A	15	+	15	A
gi|514486632|gb|KE346360.1|	3379446	3379467	AAC	21	+	7	ACA
gi|514486632|gb|KE346360.1|	3379726	3379741	ACCTGC	15	-	2	CAGGTG
gi|514486632|gb|KE346360.1|	3380147	3380160	ACAGGC	13	-	2	GCCTGT
gi|514486632|gb|KE346360.1|	3380321	3380334	AGC	13	+	4	GCA
gi|514486632|gb|KE346360.1|	3380769	3380781	AACGAC	12	-	2	TTGTCG
gi|514486632|gb|KE346360.1|	3381724	3381739	AGGG	15	+	3	GAGG
gi|514486632|gb|KE346360.1|	3381748	3381801	AG	53	+	26	GA
gi|514486632|gb|KE346360.1|	3381802	3381814	AG	12	+	6	GA
gi|514486632|gb|KE346360.1|	3381875	3381893	AAC	18	+	6	ACA
gi|514486632|gb|KE346360.1|	3381898	3381911	AAAACC	13	+	2	ACCAAA
gi|514486632|gb|KE346360.1|	3382158	3382171	AAGACG	13	-	2	CTTCGT
gi|514486632|gb|KE346360.1|	3383315	3383341	AGC	26	+	8	GCA
gi|514486632|gb|KE346360.1|	3383582	3383599	AGC	17	+	5	GCA
gi|514486632|gb|KE346360.1|	3383639	3383665	AGC	26	+	8	GCA
gi|514486632|gb|KE346360.1|	3383817	3383829	AAGCGC	12	-	2	TGCGCT
gi|514486632|gb|KE346360.1|	3383890	3383902	AAGAGG	12	-	2	CTCTTC
gi|514486632|gb|KE346360.1|	3384015	3384027	AAGGAG	12	-	2	CCTTCT
gi|514486632|gb|KE346360.1|	3384234	3384250	ACGAGG	16	-	2	CGTCCT
gi|514486632|gb|KE346360.1|	3384277	3384289	AAG	12	-	4	CTT
gi|514486632|gb|KE346360.1|	3384316	3384328	AACGCC	12	-	2	GTTGGC
gi|514486632|gb|KE346360.1|	3385049	3385065	AGC	16	+	5	GCA
gi|514486632|gb|KE346360.1|	3385231	3385248	AGC	17	+	5	AGC
gi|514486632|gb|KE346360.1|	3385318	3385333	AGC	15	+	5	AGC
gi|514486632|gb|KE346360.1|	3385566	3385580	ACGAGG	14	-	2	CGTCCT
gi|514486632|gb|KE346360.1|	3385776	3385788	ACATGG	12	-	2	CATGTC
gi|514486632|gb|KE346360.1|	3386075	3386087	ACTGCC	12	+	2	CTGCCA
gi|514486632|gb|KE346360.1|	3386217	3386251	A	34	-	34	T
gi|514486632|gb|KE346360.1|	3386293	3386305	AAAAAG	12	-	2	CTTTTT
gi|514486632|gb|KE346360.1|	3386470	3386483	A	13	+	13	A
gi|514486632|gb|KE346360.1|	3386519	3386532	AC	13	+	6	CA
gi|514486632|gb|KE346360.1|	3386663	3386675	ATC	12	-	4	ATG
gi|514486632|gb|KE346360.1|	3386774	3386787	AGGATG	13	+	2	GATGAG
gi|514486632|gb|KE346360.1|	3386906	3386918	AAGAAT	12	-	2	TTATTC
gi|514486632|gb|KE346360.1|	3388139	3388165	ACC	26	+	8	ACC
gi|514486632|gb|KE346360.1|	3388420	3388432	AACCGG	12	+	2	AACCGG
gi|514486632|gb|KE346360.1|	3388442	3388463	AACCAC	21	+	3	CAACCA
gi|514486632|gb|KE346360.1|	3390030	3390043	AAGGGC	13	+	2	CAAGGG
gi|514486632|gb|KE346360.1|	3390306	3390318	AAGGG	12	+	2	GGAAG
gi|514486632|gb|KE346360.1|	3390598	3390618	AAC	20	-	6	TTG
gi|514486632|gb|KE346360.1|	3390647	3390669	A	22	-	22	T
gi|514486632|gb|KE346360.1|	3391486	3391499	ACCGG	13	-	2	GGTCC
gi|514486632|gb|KE346360.1|	3391854	3391866	AGCTGC	12	+	2	GCAGCT
gi|514486632|gb|KE346360.1|	3391864	3391887	AACTCC	23	+	3	CTCCAA
gi|514486632|gb|KE346360.1|	3391902	3391915	AAGGTG	13	+	2	GTGAAG
gi|514486632|gb|KE346360.1|	3391910	3391923	AAGGAG	13	+	2	GAAGGA
gi|514486632|gb|KE346360.1|	3392960	3392973	AAAAAC	13	-	2	TTTTTG
gi|514486632|gb|KE346360.1|	3393059	3393081	AAC	22	-	7	TGT
gi|514486632|gb|KE346360.1|	3394618	3394632	AAAAC	14	-	2	TTTTG
gi|514486632|gb|KE346360.1|	3394666	3394679	ACAGT	13	+	2	TACAG
gi|514486632|gb|KE346360.1|	3394740	3394762	A	22	-	22	T
gi|514486632|gb|KE346360.1|	3395009	3395022	AAG	13	-	4	TCT
gi|514486632|gb|KE346360.1|	3395186	3395225	A	39	+	39	A
gi|514486632|gb|KE346360.1|	3395241	3395257	AAAC	16	-	4	TTTG
gi|514486632|gb|KE346360.1|	3395289	3395303	ACACTC	14	+	2	ACACTC
gi|514486632|gb|KE346360.1|	3398450	3398463	AGAGGG	13	+	2	GAGGGA
gi|514486632|gb|KE346360.1|	3398538	3398550	AAAAC	12	+	2	AAACA
gi|514486632|gb|KE346360.1|	3399325	3399338	ACGCTG	13	+	2	GACGCT
gi|514486632|gb|KE346360.1|	3399459	3399473	ACC	14	+	4	ACC
gi|514486632|gb|KE346360.1|	3399966	3399978	AAAAC	12	-	2	TTTTG
gi|514486632|gb|KE346360.1|	3399983	3399996	AAAACC	13	-	2	GTTTTG
gi|514486632|gb|KE346360.1|	3400114	3400131	AAGCCG	17	+	2	AGCCGA
gi|514486632|gb|KE346360.1|	3400276	3400288	AATGC	12	+	2	AATGC
gi|514486632|gb|KE346360.1|	3400303	3400323	A	20	-	20	T
gi|514486632|gb|KE346360.1|	3400646	3400684	A	38	-	38	T
gi|514486632|gb|KE346360.1|	3401247	3401262	AGG	15	-	5	TCC
gi|514486632|gb|KE346360.1|	3401665	3401679	AGATGC	14	-	2	ATCTGC
gi|514486632|gb|KE346360.1|	3402505	3402522	ACTG	17	-	4	GTCA
gi|514486632|gb|KE346360.1|	3402588	3402610	A	22	-	22	T
gi|514486632|gb|KE346360.1|	3402614	3402629	A	15	-	15	T
gi|514486632|gb|KE346360.1|	3402633	3402649	A	16	-	16	T
gi|514486632|gb|KE346360.1|	3402653	3402677	A	24	-	24	T
gi|514486632|gb|KE346360.1|	3403212	3403224	AAACTG	12	-	2	AGTTTC
gi|514486632|gb|KE346360.1|	3403567	3403579	AATCAC	12	+	2	CAATCA
gi|514486632|gb|KE346360.1|	3405113	3405125	AAAAAC	12	+	2	AAAACA
gi|514486632|gb|KE346360.1|	3405277	3405293	A	16	-	16	T
gi|514486632|gb|KE346360.1|	3405288	3405311	AAAAAC	23	-	3	TTTTTG
gi|514486632|gb|KE346360.1|	3405306	3405324	A	18	-	18	T
gi|514486632|gb|KE346360.1|	3405430	3405444	AGC	14	+	4	GCA
gi|514486632|gb|KE346360.1|	3405473	3405490	AGCAGG	17	-	2	CTGCTC
gi|514486632|gb|KE346360.1|	3405587	3405599	AAGATG	12	-	2	CTTCAT
gi|514486632|gb|KE346360.1|	3405605	3405617	ACCAGC	12	+	2	CAGCAC
gi|514486632|gb|KE346360.1|	3405720	3405732	CCCCCG	12	+	2	CCCGCC
gi|514486632|gb|KE346360.1|	3405732	3405753	AACAGC	21	+	3	GCAACA
gi|514486632|gb|KE346360.1|	3405748	3405762	AGC	14	+	4	CAG
gi|514486632|gb|KE346360.1|	3406255	3406267	AAAC	12	-	3	GTTT
gi|514486632|gb|KE346360.1|	3406474	3406487	AGAGC	13	-	2	GCTCT
gi|514486632|gb|KE346360.1|	3407205	3407219	ACACCC	14	+	2	ACACCC
gi|514486632|gb|KE346360.1|	3409283	3409296	ACCGCG	13	+	2	GCGACC
gi|514486632|gb|KE346360.1|	3409944	3409956	AGCCGC	12	-	2	GGCTGC
gi|514486632|gb|KE346360.1|	3410476	3410491	ACC	15	+	5	ACC
gi|514486632|gb|KE346360.1|	3410702	3410721	AGG	19	-	6	CCT
gi|514486632|gb|KE346360.1|	3411539	3411553	AAACAC	14	-	2	GTGTTT
gi|514486632|gb|KE346360.1|	3411922	3411940	A	18	+	18	A
gi|514486632|gb|KE346360.1|	3411981	3411994	AAAGGG	13	-	2	TTCCCT
gi|514486632|gb|KE346360.1|	3413503	3413515	AGGATG	12	-	2	TCCTCA
gi|514486632|gb|KE346360.1|	3414049	3414061	ATCGCC	12	-	2	TGGCGA
gi|514486632|gb|KE346360.1|	3415218	3415230	AGAGG	12	-	2	CTCCT
gi|514486632|gb|KE346360.1|	3415488	3415500	ACTC	12	+	3	ACTC
gi|514486632|gb|KE346360.1|	3415494	3415507	ACTCTC	13	+	2	TCACTC
gi|514486632|gb|KE346360.1|	3415519	3415533	AAACAC	14	+	2	CAAACA
gi|514486632|gb|KE346360.1|	3415620	3415637	AAAAT	17	+	3	AATAA
gi|514486632|gb|KE346360.1|	3415763	3415776	ACTCC	13	-	2	AGTGG
gi|514486632|gb|KE346360.1|	3415770	3415782	AACTCC	12	-	2	TGGAGT
gi|514486632|gb|KE346360.1|	3415781	3415804	AACTCC	23	-	3	TGGAGT
gi|514486632|gb|KE346360.1|	3416000	3416012	AACTTG	12	+	2	TGAACT
gi|514486632|gb|KE346360.1|	3416124	3416138	AAGCC	14	+	2	AAGCC
gi|514486632|gb|KE346360.1|	3416188	3416204	AG	16	-	8	TC
gi|514486632|gb|KE346360.1|	3416664	3416677	AAGC	13	+	3	AGCA
gi|514486632|gb|KE346360.1|	3416794	3416809	AAAAC	15	+	3	CAAAA
gi|514486632|gb|KE346360.1|	3416805	3416822	A	17	+	17	A
gi|514486632|gb|KE346360.1|	3416915	3416927	AAACCC	12	+	2	CCCAAA
gi|514486632|gb|KE346360.1|	3416925	3416937	AAGTAC	12	+	2	AAGTAC
gi|514486632|gb|KE346360.1|	3417084	3417097	AC	13	-	6	TG
gi|514486632|gb|KE346360.1|	3417102	3417114	AC	12	-	6	TG
gi|514486632|gb|KE346360.1|	3417270	3417283	ACGGCG	13	-	2	GCCGTC
gi|514486632|gb|KE346360.1|	3417278	3417291	ACG	13	-	4	CGT
gi|514486632|gb|KE346360.1|	3417355	3417373	ACG	18	-	6	TCG
gi|514486632|gb|KE346360.1|	3419063	3419075	ACATG	12	-	2	TGTCA
gi|514486632|gb|KE346360.1|	3419289	3419305	AATGT	16	+	3	AATGT
gi|514486632|gb|KE346360.1|	3419959	3419973	AACTG	14	-	2	TTCAG
gi|514486632|gb|KE346360.1|	3419974	3419992	AACTG	18	-	3	TCAGT
gi|514486632|gb|KE346360.1|	3420233	3420245	A	12	-	12	T
gi|514486632|gb|KE346360.1|	3420593	3420622	AAAACC	29	+	4	CCAAAA
gi|514486632|gb|KE346360.1|	3420636	3420654	AGCG	18	-	4	CTCG
gi|514486632|gb|KE346360.1|	3420710	3420725	AATGC	15	-	3	CATTG
gi|514486632|gb|KE346360.1|	3420785	3420805	A	20	-	20	T
gi|514486632|gb|KE346360.1|	3420871	3420883	ACGAGG	12	-	2	CTCGTC
gi|514486632|gb|KE346360.1|	3420882	3420895	AGC	13	-	4	CTG
gi|514486632|gb|KE346360.1|	3420984	3421017	A	33	+	33	A
gi|514486632|gb|KE346360.1|	3421066	3421081	AAAGCG	15	-	2	CTTTCG
gi|514486632|gb|KE346360.1|	3421231	3421246	A	15	+	15	A
gi|514486632|gb|KE346360.1|	3421339	3421368	ACTC	29	-	7	GTGA
gi|514486632|gb|KE346360.1|	3421559	3421574	AAC	15	-	5	TTG
gi|514486632|gb|KE346360.1|	3422546	3422558	AAAC	12	-	3	TTGT
gi|514486632|gb|KE346360.1|	3422589	3422603	ACCCC	14	+	2	CCCCA
gi|514486632|gb|KE346360.1|	3423276	3423289	AAGCTC	13	+	2	CTCAAG
gi|514486632|gb|KE346360.1|	3423658	3423670	AAAAC	12	+	2	AAACA
gi|514486632|gb|KE346360.1|	3423677	3423693	AAAAAG	16	-	2	CTTTTT
gi|514486632|gb|KE346360.1|	3423769	3423785	AG	16	-	8	CT
gi|514486632|gb|KE346360.1|	3424157	3424170	AAAACC	13	-	2	TGGTTT
gi|514486632|gb|KE346360.1|	3424516	3424528	A	12	-	12	T
gi|514486632|gb|KE346360.1|	3424599	3424611	A	12	-	12	T
gi|514486632|gb|KE346360.1|	3424766	3424788	AAC	22	-	7	TGT
gi|514486632|gb|KE346360.1|	3425034	3425135	AG	101	-	50	TC
gi|514486632|gb|KE346360.1|	3425785	3425801	ACCAGC	16	+	2	CCAGCA
gi|514486632|gb|KE346360.1|	3425798	3425813	ACTGCT	15	-	2	CAGTAG
gi|514486632|gb|KE346360.1|	3426794	3426809	AGCCGC	15	-	2	TGCGGC
gi|514486632|gb|KE346360.1|	3427187	3427199	AAAAGG	12	+	2	GGAAAA
gi|514486632|gb|KE346360.1|	3428201	3428217	AGC	16	+	5	GCA
gi|514486632|gb|KE346360.1|	3428298	3428311	AGCGGC	13	-	2	GCTGCC
gi|514486632|gb|KE346360.1|	3428444	3428458	ACATGG	14	-	2	CATGTC
gi|514486632|gb|KE346360.1|	3428716	3428728	AATGAC	12	+	2	ACAATG
gi|514486632|gb|KE346360.1|	3429002	3429027	A	25	-	25	T
gi|514486632|gb|KE346360.1|	3430263	3430286	A	23	-	23	T
gi|514486632|gb|KE346360.1|	3430402	3430426	AGAGCC	24	-	4	CTCTGG
gi|514486632|gb|KE346360.1|	3431769	3431781	AAACG	12	+	2	AAACG
gi|514486632|gb|KE346360.1|	3432727	3432739	ACG	12	+	4	ACG
gi|514486632|gb|KE346360.1|	3433211	3433231	AACAGC	20	-	3	TGCTGT
gi|514486632|gb|KE346360.1|	3433336	3433350	AGATCG	14	-	2	TCTCGA
gi|514486632|gb|KE346360.1|	3433997	3434009	ACATGG	12	-	2	TGTCCA
gi|514486632|gb|KE346360.1|	3435057	3435069	ACGCGC	12	+	2	GCGCAC
gi|514486632|gb|KE346360.1|	3435212	3435231	A	19	-	19	T
gi|514486632|gb|KE346360.1|	3435522	3435534	AGCTC	12	-	2	CTGAG
gi|514486632|gb|KE346360.1|	3435805	3435819	AAGTCG	14	-	2	TCGACT
gi|514486632|gb|KE346360.1|	3435931	3435945	AAAAG	14	-	2	TTTTC
gi|514486632|gb|KE346360.1|	3436048	3436102	AG	54	-	27	TC
gi|514486632|gb|KE346360.1|	3436410	3436425	ACTCCC	15	+	2	CTCCCA
gi|514486632|gb|KE346360.1|	3436528	3436542	AAC	14	-	4	GTT
gi|514486632|gb|KE346360.1|	3436779	3436795	ATC	16	+	5	ATC
gi|514486632|gb|KE346360.1|	3437379	3437391	AAGACG	12	+	2	CGAAGA
gi|514486632|gb|KE346360.1|	3437494	3437508	ACGATG	14	+	2	GACGAT
gi|514486632|gb|KE346360.1|	3437550	3437565	AGG	15	-	5	CTC
gi|514486632|gb|KE346360.1|	3437560	3437572	AAGAGG	12	-	2	TCCTCT
gi|514486632|gb|KE346360.1|	3437754	3437766	AGGATG	12	-	2	CCTCAT
gi|514486632|gb|KE346360.1|	3437762	3437774	AACATG	12	-	2	TCATGT
gi|514486632|gb|KE346360.1|	3438656	3438669	AAAAAC	13	-	2	TGTTTT
gi|514486632|gb|KE346360.1|	3438699	3438711	AAAAAC	12	-	2	TGTTTT
gi|514486632|gb|KE346360.1|	3439081	3439095	AAAAG	14	-	2	TTTTC
gi|514486632|gb|KE346360.1|	3439214	3439226	AAAACG	12	+	2	AAACGA
gi|514486632|gb|KE346360.1|	3439250	3439274	A	24	+	24	A
gi|514486632|gb|KE346360.1|	3439468	3439498	A	30	-	30	T
gi|514486632|gb|KE346360.1|	3439729	3439742	A	13	-	13	T
gi|514486632|gb|KE346360.1|	3439743	3439757	A	14	-	14	T
gi|514486632|gb|KE346360.1|	3439929	3439954	A	25	-	25	T
gi|514486632|gb|KE346360.1|	3439984	3440000	A	16	-	16	T
gi|514486632|gb|KE346360.1|	3440034	3440048	AAG	14	-	4	TCT
gi|514486632|gb|KE346360.1|	3440233	3440245	AGGCCC	12	+	2	GCCCAG
gi|514486632|gb|KE346360.1|	3441305	3441317	AAG	12	-	4	CTT
gi|514486632|gb|KE346360.1|	3441393	3441407	AAAAG	14	-	2	TTTTC
gi|514486632|gb|KE346360.1|	3442818	3442916	AG	98	-	49	CT
gi|514486632|gb|KE346360.1|	3443571	3443583	AGCATC	12	+	2	CAGCAT
gi|514486632|gb|KE346360.1|	3444687	3444699	AATCC	12	-	2	TTGGA
gi|514486632|gb|KE346360.1|	3444707	3444720	AATCC	13	-	2	ATTGG
gi|514486632|gb|KE346360.1|	3444914	3444926	AAAG	12	-	3	TTCT
gi|514486632|gb|KE346360.1|	3445248	3445260	AGC	12	-	4	TGC
gi|514486632|gb|KE346360.1|	3445731	3445744	AAAC	13	-	3	TTTG
gi|514486632|gb|KE346360.1|	3446599	3446612	ATCCCC	13	+	2	CCATCC
gi|514486632|gb|KE346360.1|	3447096	3447110	ATC	14	+	4	ATC
gi|514486632|gb|KE346360.1|	3448109	3448122	ATC	13	+	4	ATC
gi|514486632|gb|KE346360.1|	3448549	3448561	AAGGAC	12	+	2	CAAGGA
gi|514486632|gb|KE346360.1|	3448610	3448624	AACG	14	+	3	AACG
gi|514486632|gb|KE346360.1|	3448627	3448652	A	25	+	25	A
gi|514486632|gb|KE346360.1|	3448837	3448851	AAAAAC	14	-	2	TTTTTG
gi|514486632|gb|KE346360.1|	3448881	3448895	AAATG	14	-	2	TTTCA
gi|514486632|gb|KE346360.1|	3449118	3449130	ACCCC	12	-	2	GGGGT
gi|514486632|gb|KE346360.1|	3449369	3449382	A	13	+	13	A
gi|514486632|gb|KE346360.1|	3449959	3449973	AAT	14	-	4	TTA
gi|514486632|gb|KE346360.1|	3449971	3449989	A	18	-	18	T
gi|514486632|gb|KE346360.1|	3450256	3450280	A	24	+	24	A
gi|514486632|gb|KE346360.1|	3450304	3450316	A	12	+	12	A
gi|514486632|gb|KE346360.1|	3450659	3450680	A	21	-	21	T
gi|514486632|gb|KE346360.1|	3450682	3450694	A	12	-	12	T
gi|514486632|gb|KE346360.1|	3450892	3450904	A	12	-	12	T
gi|514486632|gb|KE346360.1|	3451027	3451040	A	13	-	13	T
gi|514486632|gb|KE346360.1|	3451419	3451443	A	24	-	24	T
gi|514486632|gb|KE346360.1|	3452002	3452014	ACCAGC	12	+	2	CCAGCA
gi|514486632|gb|KE346360.1|	3452186	3452202	AGC	16	-	5	GCT
gi|514486632|gb|KE346360.1|	3452911	3452923	AAGGAC	12	+	2	CAAGGA
gi|514486632|gb|KE346360.1|	3454007	3454019	ACGTCC	12	+	2	TCCACG
gi|514486632|gb|KE346360.1|	3455644	3455657	AAAAC	13	-	2	TTTGT
gi|514486632|gb|KE346360.1|	3455667	3455685	A	18	-	18	T
gi|514486632|gb|KE346360.1|	3456226	3456247	A	21	-	21	T
gi|514486632|gb|KE346360.1|	3456660	3456672	AAAAAC	12	-	2	TTTGTT
gi|514486632|gb|KE346360.1|	3456843	3456855	AAAAAC	12	+	2	AAAACA
gi|514486632|gb|KE346360.1|	3458741	3458754	ACACAT	13	+	2	ATACAC
gi|514486632|gb|KE346360.1|	3459863	3459875	ATGCC	12	+	2	GCCAT
gi|514486632|gb|KE346360.1|	3459929	3459941	ACCTCG	12	-	2	GGTCGA
gi|514486632|gb|KE346360.1|	3460029	3460048	ATGCC	19	-	3	GGCAT
gi|514486632|gb|KE346360.1|	3460618	3460630	AGATGG	12	-	2	TCCATC
gi|514486632|gb|KE346360.1|	3460865	3460879	AAACC	14	+	2	CAAAC
gi|514486632|gb|KE346360.1|	3461330	3461346	ACCCC	16	-	3	GGGGT
gi|514486632|gb|KE346360.1|	3462038	3462050	AAGCC	12	+	2	CAAGC
gi|514486632|gb|KE346360.1|	3464248	3464261	C	13	-	13	G
gi|514486632|gb|KE346360.1|	3464307	3464325	A	18	-	18	T
gi|514486632|gb|KE346360.1|	3464936	3464951	AAAAT	15	+	3	AAAAT
gi|514486632|gb|KE346360.1|	3466028	3466045	AAC	17	-	5	TGT
gi|514486632|gb|KE346360.1|	3466700	3466724	AAC	24	-	8	GTT
gi|514486632|gb|KE346360.1|	3466787	3466806	ACCATG	19	+	3	TGACCA
gi|514486632|gb|KE346360.1|	3466875	3466889	AGC	14	-	4	GCT
gi|514486632|gb|KE346360.1|	3466890	3466903	AGC	13	-	4	GCT
gi|514486632|gb|KE346360.1|	3467077	3467089	AC	12	+	6	AC
gi|514486632|gb|KE346360.1|	3467128	3467142	AGC	14	+	4	GCA
gi|514486632|gb|KE346360.1|	3467189	3467205	A	16	+	16	A
gi|514486632|gb|KE346360.1|	3468225	3468246	AC	21	-	10	TG
gi|514486632|gb|KE346360.1|	3468422	3468434	ACG	12	+	4	GAC
gi|514486632|gb|KE346360.1|	3469493	3469505	AAGGTG	12	-	2	CCTTCA
gi|514486632|gb|KE346360.1|	3470014	3470094	AG	80	+	40	GA
gi|514486632|gb|KE346360.1|	3470095	3470217	AG	122	+	61	AG
gi|514486632|gb|KE346360.1|	3470397	3470410	AAAAAC	13	-	2	TTGTTT
gi|514486632|gb|KE346360.1|	3470457	3470471	AAGAG	14	-	2	CTCTT
gi|514486632|gb|KE346360.1|	3470757	3470802	A	45	-	45	T
gi|514486632|gb|KE346360.1|	3470967	3470991	A	24	-	24	T
gi|514486632|gb|KE346360.1|	3471193	3471216	A	23	-	23	T
gi|514486632|gb|KE346360.1|	3471284	3471297	AAGCGC	13	-	2	CGCTTG
gi|514486632|gb|KE346360.1|	3471441	3471458	AAAAAC	17	+	2	AAAAAC
gi|514486632|gb|KE346360.1|	3471453	3471465	A	12	+	12	A
gi|514486632|gb|KE346360.1|	3471679	3471692	A	13	-	13	T
gi|514486632|gb|KE346360.1|	3471865	3471878	AAAAT	13	-	2	TTTTA
gi|514486632|gb|KE346360.1|	3471888	3471910	A	22	-	22	T
gi|514486632|gb|KE346360.1|	3471906	3471924	AAAACC	18	-	3	TTTTGG
gi|514486632|gb|KE346360.1|	3472349	3472361	AAAGTC	12	-	2	TTGACT
gi|514486632|gb|KE346360.1|	3473146	3473159	AGCATC	13	+	2	CATCAG
gi|514486632|gb|KE346360.1|	3473239	3473265	AGC	26	+	8	CAG
gi|514486632|gb|KE346360.1|	3474004	3474018	AGC	14	+	4	CAG
gi|514486632|gb|KE346360.1|	3474099	3474117	AACAGC	18	+	3	GCAACA
gi|514486632|gb|KE346360.1|	3474232	3474245	AACAGC	13	+	2	CAGCAA
gi|514486632|gb|KE346360.1|	3474448	3474460	CCG	12	+	4	GCC
gi|514486632|gb|KE346360.1|	3474589	3474602	AGCGGC	13	-	2	GCCGCT
gi|514486632|gb|KE346360.1|	3474700	3474717	AACAGC	17	+	2	CAGCAA
gi|514486632|gb|KE346360.1|	3474738	3474750	AGC	12	+	4	GCA
gi|514486632|gb|KE346360.1|	3474793	3474810	AACAGC	17	+	2	CAGCAA
gi|514486632|gb|KE346360.1|	3474881	3474893	ATCGCC	12	+	2	ATCGCC
gi|514486632|gb|KE346360.1|	3475133	3475149	AAAAAG	16	-	2	TTTTTC
gi|514486632|gb|KE346360.1|	3475151	3475166	A	15	-	15	T
gi|514486632|gb|KE346360.1|	3475180	3475196	AAAAAG	16	-	2	TTTTTC
gi|514486632|gb|KE346360.1|	3475291	3475305	ACGC	14	-	3	GTGC
gi|514486632|gb|KE346360.1|	3476080	3476092	AAGGAG	12	+	2	AAGGAG
gi|514486632|gb|KE346360.1|	3477296	3477309	CCCCG	13	-	2	GGCGG
gi|514486632|gb|KE346360.1|	3477833	3477847	AACAGC	14	-	2	TTGCTG
gi|514486632|gb|KE346360.1|	3478806	3478829	A	23	-	23	T
gi|514486632|gb|KE346360.1|	3478977	3478992	AAAC	15	+	3	AAAC
gi|514486632|gb|KE346360.1|	3479458	3479471	AAC	13	+	4	ACA
gi|514486632|gb|KE346360.1|	3479799	3479818	AAAC	19	+	4	AAAC
gi|514486632|gb|KE346360.1|	3479815	3479832	A	17	+	17	A
gi|514486632|gb|KE346360.1|	3480011	3480023	ATCCG	12	-	2	CGGAT
gi|514486632|gb|KE346360.1|	3482682	3482694	AAAGGC	12	+	2	AAGGCA
gi|514486632|gb|KE346360.1|	3484076	3484091	AAAATG	15	-	2	TTTTCA
gi|514486632|gb|KE346360.1|	3485767	3485781	ACCATG	14	+	2	CCATGA
gi|514486632|gb|KE346360.1|	3485811	3485825	ACGGCG	14	+	2	CGACGG
gi|514486632|gb|KE346360.1|	3486169	3486185	AACAGC	16	-	2	GCTGTT
gi|514486632|gb|KE346360.1|	3486180	3486200	AGC	20	-	6	TGC
gi|514486632|gb|KE346360.1|	3486195	3486218	AACAGC	23	-	3	TGCTGT
gi|514486632|gb|KE346360.1|	3486723	3486739	AAAAGG	16	-	2	TTTTCC
gi|514486632|gb|KE346360.1|	3486735	3486751	A	16	-	16	T
gi|514486632|gb|KE346360.1|	3486850	3486865	ACACAT	15	+	2	ACATAC
gi|514486632|gb|KE346360.1|	3487176	3487188	AATCAG	12	+	2	TCAGAA
gi|514486632|gb|KE346360.1|	3489351	3489365	ACG	14	-	4	TCG
gi|514486632|gb|KE346360.1|	3490888	3490900	A	12	-	12	T
gi|514486632|gb|KE346360.1|	3490913	3490930	AAAAG	17	-	3	TTCTT
gi|514486632|gb|KE346360.1|	3491066	3491078	AATGC	12	-	2	TGCAT
gi|514486632|gb|KE346360.1|	3492081	3492096	AAAAC	15	+	3	AAAAC
gi|514486632|gb|KE346360.1|	3494231	3494243	AATGCC	12	+	2	CAATGC
gi|514486632|gb|KE346360.1|	3494396	3494410	ACG	14	-	4	TCG
gi|514486632|gb|KE346360.1|	3495454	3495467	A	13	-	13	T
gi|514486632|gb|KE346360.1|	3495936	3495948	A	12	-	12	T
gi|514486632|gb|KE346360.1|	3495961	3495978	AAAAG	17	-	3	TTCTT
gi|514486632|gb|KE346360.1|	3496114	3496126	AATGC	12	-	2	TGCAT
gi|514486632|gb|KE346360.1|	3496463	3496480	AC	17	-	8	GT
gi|514486632|gb|KE346360.1|	3496991	3497003	AAAAC	12	+	2	AACAA
gi|514486632|gb|KE346360.1|	3497013	3497040	A	27	+	27	A
gi|514486632|gb|KE346360.1|	3497087	3497102	AAAAC	15	+	3	AAAAC
gi|514486632|gb|KE346360.1|	3497358	3497370	A	12	-	12	T
gi|514486632|gb|KE346360.1|	3499136	3499149	ACGTC	13	-	2	GTGAC
gi|514486632|gb|KE346360.1|	3499398	3499411	ACG	13	-	4	TCG
gi|514486632|gb|KE346360.1|	3500099	3500112	AAAGGG	13	-	2	TTCCCT
gi|514486632|gb|KE346360.1|	3500509	3500534	AG	25	-	12	TC
gi|514486632|gb|KE346360.1|	3501022	3501036	A	14	+	14	A
gi|514486632|gb|KE346360.1|	3501252	3501264	AACCTC	12	-	2	GGTTGA
gi|514486632|gb|KE346360.1|	3502121	3502135	AACAGC	14	+	2	AACAGC
gi|514486632|gb|KE346360.1|	3502480	3502492	AAACAC	12	-	2	GTTTGT
gi|514486632|gb|KE346360.1|	3504809	3504822	A	13	-	13	T
gi|514486632|gb|KE346360.1|	3505438	3505453	A	15	-	15	T
gi|514486632|gb|KE346360.1|	3505643	3505665	A	22	+	22	A
gi|514486632|gb|KE346360.1|	3506963	3506975	AAACAC	12	-	2	GTTTGT
gi|514486632|gb|KE346360.1|	3508339	3508353	ACCAGC	14	-	2	GCTGGT
gi|514486632|gb|KE346360.1|	3509607	3509629	AAAAAT	22	-	3	TTTTAT
gi|514486632|gb|KE346360.1|	3509806	3509818	AAAGAG	12	-	2	TCTCTT
gi|514486632|gb|KE346360.1|	3510392	3510406	AAAGGC	14	-	2	TTGCCT
gi|514486632|gb|KE346360.1|	3510795	3510807	AAGAGG	12	+	2	AGGAAG
gi|514486632|gb|KE346360.1|	3511368	3511381	AAGACG	13	+	2	ACGAAG
gi|514486632|gb|KE346360.1|	3511389	3511402	AATGAG	13	+	2	AGAATG
gi|514486632|gb|KE346360.1|	3513767	3513779	AGC	12	-	4	TGC
gi|514486632|gb|KE346360.1|	3515493	3515512	ACG	19	-	6	TCG
gi|514486632|gb|KE346360.1|	3515848	3515864	ACCACT	16	+	2	ACTACC
gi|514486632|gb|KE346360.1|	3515866	3515882	ACT	16	+	5	ACT
gi|514486632|gb|KE346360.1|	3516648	3516660	AGCG	12	-	3	TCGC
gi|514486632|gb|KE346360.1|	3516927	3516948	A	21	+	21	A
gi|514486632|gb|KE346360.1|	3517439	3517451	ACCGCC	12	+	2	GCCACC
gi|514486632|gb|KE346360.1|	3518303	3518322	AC	19	-	9	TG
gi|514486632|gb|KE346360.1|	3518776	3518803	ACG	27	-	9	CGT
gi|514486632|gb|KE346360.1|	3519134	3519146	ACGAGC	12	-	2	TGCTCG
gi|514486632|gb|KE346360.1|	3519169	3519185	AGCCAT	16	+	2	ATAGCC
gi|514486632|gb|KE346360.1|	3519382	3519416	AGC	34	-	11	CTG
gi|514486632|gb|KE346360.1|	3519753	3519767	AAC	14	-	4	TGT
gi|514486632|gb|KE346360.1|	3519831	3519845	AGC	14	-	4	TGC
gi|514486632|gb|KE346360.1|	3520049	3520061	AGATGC	12	-	2	CTGCAT
gi|514486632|gb|KE346360.1|	3520080	3520094	AACAGC	14	-	2	TGCTGT
gi|514486632|gb|KE346360.1|	3520185	3520199	ACGAGG	14	-	2	TCCTCG
gi|514486632|gb|KE346360.1|	3520203	3520217	AAGAGG	14	-	2	TCTTCC
gi|514486632|gb|KE346360.1|	3520212	3520226	AGG	14	-	4	TCC
gi|514486632|gb|KE346360.1|	3520761	3520773	ACAGGC	12	+	2	GGCACA
gi|514486632|gb|KE346360.1|	3521230	3521242	ACC	12	-	4	GTG
gi|514486632|gb|KE346360.1|	3521905	3521917	ACGCCG	12	-	2	CGTCGG
gi|514486632|gb|KE346360.1|	3522183	3522195	ACCTCG	12	+	2	CCTCGA
gi|514486632|gb|KE346360.1|	3522230	3522242	AACAGC	12	-	2	TGTTGC
gi|514486632|gb|KE346360.1|	3522381	3522394	ACG	13	-	4	TCG
gi|514486632|gb|KE346360.1|	3522611	3522624	AC	13	+	6	AC
gi|514486632|gb|KE346360.1|	3523084	3523106	ACC	22	+	7	CCA
gi|514486632|gb|KE346360.1|	3523123	3523136	AAGCAC	13	+	2	CACAAG
gi|514486632|gb|KE346360.1|	3523179	3523191	ACAGCC	12	+	2	CAGCCA
gi|514486632|gb|KE346360.1|	3523209	3523229	AAAAAG	20	+	3	AAAAGA
gi|514486632|gb|KE346360.1|	3523404	3523440	A	36	+	36	A
gi|514486632|gb|KE346360.1|	3523441	3523455	A	14	+	14	A
gi|514486632|gb|KE346360.1|	3523564	3523593	AG	29	+	14	GA
gi|514486632|gb|KE346360.1|	3523677	3523694	ACCATC	17	-	2	TGGTGA
gi|514486632|gb|KE346360.1|	3523785	3523802	A	17	+	17	A
gi|514486632|gb|KE346360.1|	3523804	3523826	AAAAT	22	-	4	TTTTA
gi|514486632|gb|KE346360.1|	3523821	3523838	AAT	17	-	5	TTA
gi|514486632|gb|KE346360.1|	3523836	3523852	A	16	-	16	T
gi|514486632|gb|KE346360.1|	3524028	3524047	AAAG	19	+	4	AAAG
gi|514486632|gb|KE346360.1|	3524051	3524063	A	12	+	12	A
gi|514486632|gb|KE346360.1|	3525270	3525286	AAAATC	16	+	2	CAAAAT
gi|514486632|gb|KE346360.1|	3525556	3525573	ATC	17	-	5	GAT
gi|514486632|gb|KE346360.1|	3525818	3525835	ACG	17	+	5	ACG
gi|514486632|gb|KE346360.1|	3525833	3525849	AAC	16	+	5	ACA
gi|514486632|gb|KE346360.1|	3526016	3526028	AACAG	12	+	2	AGAAC
gi|514486632|gb|KE346360.1|	3526793	3526805	ACGGGG	12	+	2	GACGGG
gi|514486632|gb|KE346360.1|	3527008	3527020	ACCCGC	12	-	2	GGTGCG
gi|514486632|gb|KE346360.1|	3527275	3527288	AATCGC	13	+	2	CAATCG
gi|514486632|gb|KE346360.1|	3527555	3527572	AG	17	+	8	GA
gi|514486632|gb|KE346360.1|	3528316	3528328	ACGGC	12	-	2	GCCGT
gi|514486632|gb|KE346360.1|	3529247	3529264	AAAAAT	17	+	2	TAAAAA
gi|514486632|gb|KE346360.1|	3530002	3530017	AC	15	+	7	AC
gi|514486632|gb|KE346360.1|	3531835	3531847	ACCATG	12	-	2	TCATGG
gi|514486632|gb|KE346360.1|	3531986	3532001	AAAAC	15	+	3	CAAAA
gi|514486632|gb|KE346360.1|	3532142	3532154	ATC	12	-	4	ATG
gi|514486632|gb|KE346360.1|	3532617	3532632	ATCGCC	15	+	2	GCCATC
gi|514486632|gb|KE346360.1|	3532835	3532847	AC	12	-	6	TG
gi|514486632|gb|KE346360.1|	3533030	3533042	ACTCTC	12	+	2	CTCTCA
gi|514486632|gb|KE346360.1|	3533468	3533485	AGC	17	+	5	AGC
gi|514486632|gb|KE346360.1|	3533534	3533563	AAGATC	29	+	4	CAAGAT
gi|514486632|gb|KE346360.1|	3533769	3533782	ACCCAG	13	+	2	ACCCAG
gi|514486632|gb|KE346360.1|	3533794	3533815	ACTGGC	21	-	3	TGCCAG
gi|514486632|gb|KE346360.1|	3534076	3534090	AAGCTC	14	-	2	GCTTGA
gi|514486632|gb|KE346360.1|	3535639	3535651	AAAGC	12	-	2	TTTGC
gi|514486632|gb|KE346360.1|	3535886	3535902	AGC	16	+	5	CAG
gi|514486632|gb|KE346360.1|	3535962	3535976	AGCGC	14	-	2	TGCGC
gi|514486632|gb|KE346360.1|	3536150	3536163	AGCTC	13	+	2	CTCAG
gi|514486632|gb|KE346360.1|	3536211	3536223	AG	12	+	6	AG
gi|514486632|gb|KE346360.1|	3536222	3536240	AC	18	-	9	GT
gi|514486632|gb|KE346360.1|	3536556	3536568	AGATGC	12	-	2	TCTGCA
gi|514486632|gb|KE346360.1|	3537426	3537439	AATGCC	13	+	2	CAATGC
gi|514486632|gb|KE346360.1|	3537536	3537550	AAAC	14	-	3	TTTG
gi|514486632|gb|KE346360.1|	3539741	3539753	A	12	-	12	T
gi|514486632|gb|KE346360.1|	3539810	3539825	AAAAC	15	+	3	CAAAA
gi|514486632|gb|KE346360.1|	3541283	3541296	AAAACG	13	+	2	AAACGA
gi|514486632|gb|KE346360.1|	3541378	3541391	ATCCG	13	-	2	ATCGG
gi|514486632|gb|KE346360.1|	3541882	3541896	AACAGC	14	-	2	TGTTGC
gi|514486632|gb|KE346360.1|	3541933	3541958	AGC	25	-	8	TGC
gi|514486632|gb|KE346360.1|	3542046	3542060	ACACG	14	-	2	GTCGT
gi|514486632|gb|KE346360.1|	3542093	3542108	AGC	15	-	5	TGC
gi|514486632|gb|KE346360.1|	3542215	3542230	AGC	15	-	5	CTG
gi|514486632|gb|KE346360.1|	3542228	3542242	AAC	14	-	4	TGT
gi|514486632|gb|KE346360.1|	3542572	3542585	A	13	+	13	A
gi|514486632|gb|KE346360.1|	3544016	3544029	AGGGGG	13	-	2	CCCTCC
gi|514486632|gb|KE346360.1|	3544027	3544039	AGG	12	-	4	CCT
gi|514486632|gb|KE346360.1|	3544397	3544410	ACAGC	13	-	2	GCTGT
gi|514486632|gb|KE346360.1|	3544729	3544742	ACCAG	13	+	2	CAGAC
gi|514486632|gb|KE346360.1|	3544766	3544778	AAAGCG	12	+	2	AGCGAA
gi|514486632|gb|KE346360.1|	3545013	3545026	AAAGC	13	+	2	AAGCA
gi|514486632|gb|KE346360.1|	3545042	3545055	AAAC	13	+	3	ACAA
gi|514486632|gb|KE346360.1|	3545052	3545065	A	13	+	13	A
gi|514486632|gb|KE346360.1|	3545123	3545137	ACCCC	14	-	2	GGGGT
gi|514486632|gb|KE346360.1|	3545604	3545617	ACTCC	13	+	2	CTCCA
gi|514486632|gb|KE346360.1|	3546305	3546320	A	15	-	15	T
gi|514486632|gb|KE346360.1|	3546547	3546559	AAG	12	+	4	AAG
gi|514486632|gb|KE346360.1|	3546756	3546771	ACGAGG	15	-	2	CGTCCT
gi|514486632|gb|KE346360.1|	3547939	3547951	ACACG	12	+	2	CACGA
gi|514486632|gb|KE346360.1|	3549018	3549030	AACAAG	12	-	2	TTCTTG
gi|514486632|gb|KE346360.1|	3549110	3549122	AATCCC	12	+	2	TCCCAA
gi|514486632|gb|KE346360.1|	3549225	3549237	AAAAAT	12	+	2	AAAAAT
gi|514486632|gb|KE346360.1|	3549617	3549629	AACC	12	+	3	CAAC
gi|514486632|gb|KE346360.1|	3550251	3550268	AGC	17	-	5	TGC
gi|514486632|gb|KE346360.1|	3550991	3551004	AAAAAC	13	+	2	AAAACA
gi|514486632|gb|KE346360.1|	3551081	3551096	AAAAC	15	+	3	AAAAC
gi|514486632|gb|KE346360.1|	3553311	3553324	AACCC	13	-	2	TGGGT
gi|514486632|gb|KE346360.1|	3553566	3553578	ACC	12	-	4	GGT
gi|514486632|gb|KE346360.1|	3553818	3553841	A	23	-	23	T
gi|514486632|gb|KE346360.1|	3554003	3554026	A	23	+	23	A
gi|514486632|gb|KE346360.1|	3554470	3554483	AC	13	+	6	AC
gi|514486632|gb|KE346360.1|	3554576	3554597	A	21	+	21	A
gi|514486632|gb|KE346360.1|	3554620	3554640	A	20	-	20	T
gi|514486632|gb|KE346360.1|	3554642	3554660	A	18	-	18	T
gi|514486632|gb|KE346360.1|	3554723	3554736	AGCTCC	13	-	2	GAGCTG
gi|514486632|gb|KE346360.1|	3554792	3554810	ACC	18	-	6	GTG
gi|514486632|gb|KE346360.1|	3554944	3554956	ACCAGC	12	-	2	TGGTGC
gi|514486632|gb|KE346360.1|	3555228	3555243	AGATCC	15	-	2	ATCTGG
gi|514486632|gb|KE346360.1|	3555427	3555439	ACAGCC	12	+	2	GCCACA
gi|514486632|gb|KE346360.1|	3555614	3555628	AACAAG	14	-	2	TTCTTG
gi|514486632|gb|KE346360.1|	3555674	3555691	AAG	17	+	5	GAA
gi|514486632|gb|KE346360.1|	3555841	3555854	AG	13	+	6	AG
gi|514486632|gb|KE346360.1|	3555854	3555867	AC	13	-	6	TG
gi|514486632|gb|KE346360.1|	3556201	3556215	AAAAG	14	-	2	TTTTC
gi|514486632|gb|KE346360.1|	3556697	3556710	ACGAGG	13	-	2	TCCTCG
gi|514486632|gb|KE346360.1|	3557007	3557035	AAAC	28	-	7	TTGT
gi|514486632|gb|KE346360.1|	3557261	3557274	AAAAC	13	-	2	TTTGT
gi|514486632|gb|KE346360.1|	3557934	3557958	AAC	24	-	8	TGT
gi|514486632|gb|KE346360.1|	3559325	3559337	A	12	+	12	A
gi|514486632|gb|KE346360.1|	3559781	3559793	AACAGC	12	+	2	CAACAG
gi|514486632|gb|KE346360.1|	3559897	3559910	AACG	13	+	3	GAAC
gi|514486632|gb|KE346360.1|	3560064	3560082	A	18	+	18	A
gi|514486632|gb|KE346360.1|	3560114	3560130	A	16	-	16	T
gi|514486632|gb|KE346360.1|	3560378	3560390	A	12	+	12	A
gi|514486632|gb|KE346360.1|	3560576	3560589	AGCC	13	-	3	TGGC
gi|514486632|gb|KE346360.1|	3560638	3560659	A	21	-	21	T
gi|514486632|gb|KE346360.1|	3560813	3560836	A	23	+	23	A
gi|514486632|gb|KE346360.1|	3560861	3560873	AAAACC	12	+	2	CCAAAA
gi|514486632|gb|KE346360.1|	3560869	3560888	A	19	+	19	A
gi|514486632|gb|KE346360.1|	3561038	3561051	AAGCTC	13	-	2	GAGCTT
gi|514486632|gb|KE346360.1|	3561193	3561211	AATGGG	18	+	3	ATGGGA
gi|514486632|gb|KE346360.1|	3561258	3561272	A	14	+	14	A
gi|514486632|gb|KE346360.1|	3561378	3561390	AACACC	12	+	2	ACCAAC
gi|514486632|gb|KE346360.1|	3562956	3562969	AAATCG	13	-	2	GATTTC
gi|514486632|gb|KE346360.1|	3563136	3563148	AACG	12	-	3	TTCG
gi|514486632|gb|KE346360.1|	3563502	3563519	ACGAGG	17	+	2	ACGAGG
gi|514486632|gb|KE346360.1|	3563745	3563758	AAGCAC	13	+	2	ACAAGC
gi|514486632|gb|KE346360.1|	3565284	3565300	A	16	-	16	T
gi|514486632|gb|KE346360.1|	3565499	3565526	A	27	-	27	T
gi|514486632|gb|KE346360.1|	3565917	3565931	AAAC	14	-	3	GTTT
gi|514486632|gb|KE346360.1|	3565939	3565952	AAAAGG	13	-	2	TTTCCT
gi|514486632|gb|KE346360.1|	3565954	3565968	AAAAT	14	-	2	TTTTA
gi|514486632|gb|KE346360.1|	3565982	3565995	A	13	-	13	T
gi|514486632|gb|KE346360.1|	3566347	3566369	A	22	-	22	T
gi|514486632|gb|KE346360.1|	3566603	3566619	AAG	16	-	5	CTT
gi|514486632|gb|KE346360.1|	3566620	3566637	AAG	17	-	5	TCT
gi|514486632|gb|KE346360.1|	3566643	3566655	AGCAGG	12	-	2	CTGCTC
gi|514486632|gb|KE346360.1|	3567327	3567339	AAC	12	+	4	ACA
gi|514486632|gb|KE346360.1|	3567594	3567607	AAACAC	13	-	2	TGTGTT
gi|514486632|gb|KE346360.1|	3567787	3567799	AAGCAC	12	-	2	TGCTTG
gi|514486632|gb|KE346360.1|	3567850	3567872	AAAAT	22	-	4	ATTTT
gi|514486632|gb|KE346360.1|	3568099	3568121	A	22	+	22	A
gi|514486632|gb|KE346360.1|	3568178	3568192	AAAAAC	14	-	2	TTGTTT
gi|514486632|gb|KE346360.1|	3568350	3568365	AAAACG	15	-	2	TTTTCG
gi|514486632|gb|KE346360.1|	3568580	3568594	A	14	+	14	A
gi|514486632|gb|KE346360.1|	3568633	3568645	AAC	12	+	4	ACA
gi|514486632|gb|KE346360.1|	3568793	3568805	A	12	+	12	A
gi|514486632|gb|KE346360.1|	3568835	3568854	A	19	-	19	T
gi|514486632|gb|KE346360.1|	3569087	3569103	A	16	+	16	A
gi|514486632|gb|KE346360.1|	3569142	3569158	A	16	-	16	T
gi|514486632|gb|KE346360.1|	3569225	3569240	A	15	-	15	T
gi|514486632|gb|KE346360.1|	3569248	3569263	AC	15	+	7	CA
gi|514486632|gb|KE346360.1|	3569264	3569295	AG	31	-	15	CT
gi|514486632|gb|KE346360.1|	3569815	3569827	AGG	12	+	4	GAG
gi|514486632|gb|KE346360.1|	3569826	3569838	AGCG	12	-	3	GCTC
gi|514486632|gb|KE346360.1|	3570143	3570155	AAGCAC	12	+	2	ACAAGC
gi|514486632|gb|KE346360.1|	3570334	3570346	AAGGAG	12	+	2	AAGGAG
gi|514486632|gb|KE346360.1|	3570588	3570603	AAG	15	+	5	GAA
gi|514486632|gb|KE346360.1|	3571465	3571477	ACGAG	12	-	2	CTCGT
gi|514486632|gb|KE346360.1|	3571768	3571780	AGGCCC	12	+	2	GCCCAG
gi|514486632|gb|KE346360.1|	3573670	3573682	AGGGCG	12	+	2	GGCGAG
gi|514486632|gb|KE346360.1|	3576457	3576471	AGCGGC	14	-	2	GCTGCC
gi|514486632|gb|KE346360.1|	3576582	3576595	ACCGCC	13	+	2	CGCCAC
gi|514486632|gb|KE346360.1|	3576799	3576814	ACGAG	15	-	3	CGTCT
gi|514486632|gb|KE346360.1|	3577197	3577218	ACAGAG	21	-	3	TCTGTC
gi|514486632|gb|KE346360.1|	3577225	3577237	ACAGAG	12	-	2	TCTCTG
gi|514486632|gb|KE346360.1|	3578021	3578034	AACGAC	13	-	2	TTGTCG
gi|514486632|gb|KE346360.1|	3578168	3578180	AATGCC	12	-	2	CATTGG
gi|514486632|gb|KE346360.1|	3578571	3578583	ACGATG	12	-	2	TCGTCA
gi|514486632|gb|KE346360.1|	3578606	3578621	AGCCCG	15	-	2	CTCGGG
gi|514486632|gb|KE346360.1|	3578839	3578853	AATGCC	14	-	2	CATTGG
gi|514486632|gb|KE346360.1|	3578854	3578869	AGC	15	+	5	GCA
gi|514486632|gb|KE346360.1|	3578932	3578945	AGC	13	+	4	CAG
gi|514486632|gb|KE346360.1|	3578990	3579007	AAC	17	-	5	GTT
gi|514486632|gb|KE346360.1|	3579130	3579142	AATCAC	12	-	2	TGATTG
gi|514486632|gb|KE346360.1|	3579177	3579190	ACTC	13	-	3	GTGA
gi|514486632|gb|KE346360.1|	3579184	3579202	ACTCTC	18	-	3	AGTGAG
gi|514486632|gb|KE346360.1|	3579474	3579486	ACACTC	12	-	2	TGAGTG
gi|514486632|gb|KE346360.1|	3579480	3579495	ACTC	15	-	3	TGAG
gi|514486632|gb|KE346360.1|	3579590	3579620	ACC	30	+	10	CAC
gi|514486632|gb|KE346360.1|	3579635	3579657	AAC	22	+	7	AAC
gi|514486632|gb|KE346360.1|	3579720	3579741	AGC	21	-	7	GCT
gi|514486632|gb|KE346360.1|	3582191	3582212	AAC	21	+	7	AAC
gi|514486632|gb|KE346360.1|	3582209	3582223	AACG	14	+	3	AACG
gi|514486632|gb|KE346360.1|	3582257	3582269	ACACT	12	-	2	AGTGT
gi|514486632|gb|KE346360.1|	3582379	3582394	ACTCTC	15	-	2	TGAGAG
gi|514486632|gb|KE346360.1|	3582403	3582419	ACTC	16	-	4	TGAG
gi|514486632|gb|KE346360.1|	3582413	3582425	ACTCTC	12	-	2	AGTGAG
gi|514486632|gb|KE346360.1|	3582473	3582496	A	23	+	23	A
gi|514486632|gb|KE346360.1|	3582519	3582536	A	17	-	17	T
gi|514486632|gb|KE346360.1|	3582542	3582556	AAAGC	14	-	2	TTGCT
gi|514486632|gb|KE346360.1|	3582706	3582723	A	17	-	17	T
gi|514486632|gb|KE346360.1|	3582724	3582742	A	18	-	18	T
gi|514486632|gb|KE346360.1|	3582900	3582920	A	20	+	20	A
gi|514486632|gb|KE346360.1|	3582952	3582975	A	23	-	23	T
gi|514486632|gb|KE346360.1|	3583003	3583023	A	20	-	20	T
gi|514486632|gb|KE346360.1|	3583073	3583086	AAAGTG	13	+	2	AAAGTG
gi|514486632|gb|KE346360.1|	3583099	3583111	AATC	12	-	3	ATTG
gi|514486632|gb|KE346360.1|	3583216	3583232	ATC	16	+	5	CAT
gi|514486632|gb|KE346360.1|	3583378	3583390	AGCTCC	12	+	2	CAGCTC
gi|514486632|gb|KE346360.1|	3584881	3584894	AAAAC	13	+	2	AAAAC
gi|514486632|gb|KE346360.1|	3585128	3585141	A	13	+	13	A
gi|514486632|gb|KE346360.1|	3586498	3586512	AAGCAC	14	-	2	TGTGCT
gi|514486632|gb|KE346360.1|	3586602	3586614	A	12	-	12	T
gi|514486632|gb|KE346360.1|	3586610	3586622	AAAATG	12	-	2	TTTTCA
gi|514486632|gb|KE346360.1|	3586823	3586845	A	22	-	22	T
gi|514486632|gb|KE346360.1|	3587309	3587329	A	20	-	20	T
gi|514486632|gb|KE346360.1|	3587364	3587379	A	15	-	15	T
gi|514486632|gb|KE346360.1|	3588078	3588090	AACTGG	12	-	2	TTCCAG
gi|514486632|gb|KE346360.1|	3590553	3590565	ACCAGC	12	-	2	GTGCTG
gi|514486632|gb|KE346360.1|	3590783	3590795	AAAC	12	+	3	AACA
gi|514486632|gb|KE346360.1|	3590962	3590974	A	12	+	12	A
gi|514486632|gb|KE346360.1|	3590980	3590998	AAAAG	18	+	3	AAAAG
gi|514486632|gb|KE346360.1|	3591394	3591406	AAGCC	12	+	2	AAGCC
gi|514486632|gb|KE346360.1|	3591413	3591427	AAAAC	14	+	2	AAAAC
gi|514486632|gb|KE346360.1|	3591673	3591692	A	19	+	19	A
gi|514486632|gb|KE346360.1|	3591707	3591722	A	15	+	15	A
gi|514486632|gb|KE346360.1|	3591926	3591951	A	25	+	25	A
gi|514486632|gb|KE346360.1|	3592136	3592165	A	29	-	29	T
gi|514486632|gb|KE346360.1|	3592341	3592355	A	14	+	14	A
gi|514486632|gb|KE346360.1|	3592361	3592376	AAG	15	+	5	AAG
gi|514486632|gb|KE346360.1|	3592419	3592434	ACAGGC	15	-	2	TGCCTG
gi|514486632|gb|KE346360.1|	3592602	3592615	AAAAAG	13	+	2	AGAAAA
gi|514486632|gb|KE346360.1|	3592714	3592731	ACC	17	+	5	ACC
gi|514486632|gb|KE346360.1|	3592961	3592979	A	18	+	18	A
gi|514486632|gb|KE346360.1|	3594064	3594078	AAGTGG	14	+	2	AGTGGA
gi|514486632|gb|KE346360.1|	3594079	3594091	AGC	12	+	4	AGC
gi|514486632|gb|KE346360.1|	3594338	3594362	AAGTG	24	+	4	GTGAA
gi|514486632|gb|KE346360.1|	3594412	3594431	A	19	+	19	A
gi|514486632|gb|KE346360.1|	3594564	3594577	AGAGGG	13	+	2	GAGAGG
gi|514486632|gb|KE346360.1|	3595487	3595501	AAACC	14	+	2	CAAAC
gi|514486632|gb|KE346360.1|	3596399	3596411	AATAC	12	+	2	CAATA
gi|514486632|gb|KE346360.1|	3596675	3596692	ACACAT	17	+	2	ACACAT
gi|514486632|gb|KE346360.1|	3596687	3596710	AC	23	+	11	AC
gi|514486632|gb|KE346360.1|	3597214	3597227	AGGCGG	13	+	2	GGAGGC
gi|514486632|gb|KE346360.1|	3597376	3597388	ACGATG	12	+	2	CGATGA
gi|514486632|gb|KE346360.1|	3597438	3597451	AGCCG	13	-	2	CTCGG
gi|514486632|gb|KE346360.1|	3599366	3599378	AACGCC	12	-	2	TTGGCG
gi|514486632|gb|KE346360.1|	3599682	3599702	AAAAC	20	+	4	ACAAA
gi|514486632|gb|KE346360.1|	3600224	3600245	AGC	21	-	7	CTG
gi|514486632|gb|KE346360.1|	3600248	3600263	AGC	15	-	5	TGC
gi|514486632|gb|KE346360.1|	3600264	3600276	AGC	12	-	4	GCT
gi|514486632|gb|KE346360.1|	3600484	3600507	ACTGAG	23	-	3	GTCTCA
gi|514486632|gb|KE346360.1|	3600704	3600723	AGC	19	-	6	CTG
gi|514486632|gb|KE346360.1|	3601293	3601305	AGGGGG	12	+	2	GGGGGA
gi|514486632|gb|KE346360.1|	3601659	3601672	A	13	-	13	T
gi|514486632|gb|KE346360.1|	3602088	3602108	AAC	20	-	6	GTT
gi|514486632|gb|KE346360.1|	3602106	3602120	ACG	14	-	4	GTC
gi|514486632|gb|KE346360.1|	3603057	3603069	ACGC	12	+	3	CACG
gi|514486632|gb|KE346360.1|	3603383	3603395	ACG	12	+	4	CGA
gi|514486632|gb|KE346360.1|	3603390	3603404	ACGAGG	14	+	2	GACGAG
gi|514486632|gb|KE346360.1|	3603420	3603433	AAC	13	-	4	TTG
gi|514486632|gb|KE346360.1|	3603855	3603868	A	13	+	13	A
gi|514486632|gb|KE346360.1|	3603869	3603892	AAT	23	+	7	AAT
gi|514486632|gb|KE346360.1|	3604035	3604048	AAC	13	+	4	AAC
gi|514486632|gb|KE346360.1|	3604292	3604305	AAAGG	13	+	2	GGAAA
gi|514486632|gb|KE346360.1|	3604358	3604371	AACAAG	13	+	2	CAAGAA
gi|514486632|gb|KE346360.1|	3605100	3605118	AGC	18	+	6	CAG
gi|514486632|gb|KE346360.1|	3605289	3605301	AGGATC	12	+	2	CAGGAT
gi|514486632|gb|KE346360.1|	3605443	3605457	AGGCG	14	-	2	CGCCT
gi|514486632|gb|KE346360.1|	3606003	3606017	ACTGCG	14	+	2	GCGACT
gi|514486632|gb|KE346360.1|	3606484	3606506	ACGATG	22	+	3	GATGAC
gi|514486632|gb|KE346360.1|	3607185	3607210	ACTCTC	25	-	4	GAGAGT
gi|514486632|gb|KE346360.1|	3607962	3607975	AAGGG	13	-	2	CCTTC
gi|514486632|gb|KE346360.1|	3608132	3608145	AAGGG	13	+	2	AAGGG
gi|514486632|gb|KE346360.1|	3608787	3608800	AAGTCC	13	-	2	ACTTGG
gi|514486632|gb|KE346360.1|	3608836	3608848	AAGTAC	12	-	2	CTTGTA
gi|514486632|gb|KE346360.1|	3609218	3609233	ACCACG	15	-	2	GTGGTC
gi|514486632|gb|KE346360.1|	3609745	3609759	AGC	14	+	4	CAG
gi|514486632|gb|KE346360.1|	3609905	3609922	AAAGG	17	+	3	AAAGG
gi|514486632|gb|KE346360.1|	3609920	3609934	AAAGGG	14	+	2	AAGGGA
gi|514486632|gb|KE346360.1|	3609966	3609986	A	20	+	20	A
gi|514486632|gb|KE346360.1|	3610056	3610070	AATCAC	14	+	2	AATCAC
gi|514486632|gb|KE346360.1|	3610192	3610205	A	13	+	13	A
gi|514486632|gb|KE346360.1|	3610667	3610686	AAAAAG	19	+	3	AAAAAG
gi|514486632|gb|KE346360.1|	3610852	3610874	AAATCC	22	-	3	TGGATT
gi|514486632|gb|KE346360.1|	3610877	3610891	ACTG	14	-	3	CAGT
gi|514486632|gb|KE346360.1|	3611017	3611032	AGC	15	-	5	TGC
gi|514486632|gb|KE346360.1|	3611099	3611115	AAGCAC	16	+	2	CAAGCA
gi|514486632|gb|KE346360.1|	3611323	3611350	ACCAGC	27	-	4	TGGTGC
gi|514486632|gb|KE346360.1|	3611520	3611532	ACC	12	+	4	CAC
gi|514486632|gb|KE346360.1|	3611945	3611958	ACGAGC	13	-	2	GCTCGT
gi|514486632|gb|KE346360.1|	3613053	3613065	AAACG	12	+	2	AACGA
gi|514486632|gb|KE346360.1|	3614217	3614229	AAGCCG	12	+	2	GAAGCC
gi|514486632|gb|KE346360.1|	3614728	3614748	AGC	20	-	6	CTG
gi|514486632|gb|KE346360.1|	3615259	3615271	A	12	-	12	T
gi|514486632|gb|KE346360.1|	3615491	3615507	AAGCC	16	+	3	AGCCA
gi|514486632|gb|KE346360.1|	3615668	3615682	CCG	14	-	4	GCG
gi|514486632|gb|KE346360.1|	3615837	3615851	AATGCC	14	+	2	TGCCAA
gi|514486632|gb|KE346360.1|	3615997	3616018	AGC	21	+	7	CAG
gi|514486632|gb|KE346360.1|	3617179	3617193	AAGGGG	14	-	2	CCTTCC
gi|514486632|gb|KE346360.1|	3617489	3617501	ACTCGG	12	-	2	CCGAGT
gi|514486632|gb|KE346360.1|	3617871	3617883	AAGTAC	12	-	2	TTGTAC
gi|514486632|gb|KE346360.1|	3618006	3618020	AAAGCT	14	+	2	AAAGCT
gi|514486632|gb|KE346360.1|	3618061	3618074	AAAAGC	13	+	2	AAAAGC
gi|514486632|gb|KE346360.1|	3618986	3618998	AAGGAG	12	-	2	TCTCCT
gi|514486632|gb|KE346360.1|	3618996	3619008	AAGGAG	12	-	2	CTCCTT
gi|514486632|gb|KE346360.1|	3620811	3620825	ACGCCC	14	+	2	GCCCAC
gi|514486632|gb|KE346360.1|	3621231	3621243	ACTAGC	12	+	2	AGCACT
gi|514486632|gb|KE346360.1|	3622641	3622658	AGC	17	-	5	GCT
gi|514486632|gb|KE346360.1|	3622827	3622841	AAC	14	+	4	AAC
gi|514486632|gb|KE346360.1|	3622866	3622883	AAAC	17	+	4	AAAC
gi|514486632|gb|KE346360.1|	3623173	3623186	A	13	+	13	A
gi|514486632|gb|KE346360.1|	3623187	3623202	A	15	+	15	A
gi|514486632|gb|KE346360.1|	3623735	3623751	A	16	+	16	A
gi|514486632|gb|KE346360.1|	3623855	3623879	AG	24	+	12	GA
gi|514486632|gb|KE346360.1|	3624136	3624149	AAT	13	+	4	TAA
gi|514486632|gb|KE346360.1|	3624512	3624524	AAGGGG	12	+	2	AAGGGG
gi|514486632|gb|KE346360.1|	3624760	3624772	ATCG	12	+	3	CGAT
gi|514486632|gb|KE346360.1|	3627097	3627109	AGGATC	12	-	2	TCCTGA
gi|514486632|gb|KE346360.1|	3627211	3627232	ACG	21	-	7	TCG
gi|514486632|gb|KE346360.1|	3628670	3628684	ACT	14	+	4	CTA
gi|514486632|gb|KE346360.1|	3628761	3628776	ACGAGC	15	-	2	GCTCGT
gi|514486632|gb|KE346360.1|	3629060	3629073	A	13	-	13	T
gi|514486632|gb|KE346360.1|	3629091	3629106	AAC	15	+	5	CAA
gi|514486632|gb|KE346360.1|	3629292	3629315	AGC	23	+	7	CAG
gi|514486632|gb|KE346360.1|	3629627	3629686	AGGATC	59	+	9	ATCAGG
gi|514486632|gb|KE346360.1|	3629697	3629712	ACG	15	-	5	TCG
gi|514486632|gb|KE346360.1|	3630066	3630114	AACCAG	48	-	8	TCTGGT
gi|514486632|gb|KE346360.1|	3630597	3630611	AGGATG	14	-	2	TCATCC
gi|514486632|gb|KE346360.1|	3631405	3631418	C	13	+	13	C
gi|514486632|gb|KE346360.1|	3631423	3631435	AAGG	12	-	3	CCTT
gi|514486632|gb|KE346360.1|	3631804	3631818	AGATGG	14	+	2	TGGAGA
gi|514486632|gb|KE346360.1|	3631828	3631840	AAACC	12	-	2	GGTTT
gi|514486632|gb|KE346360.1|	3634052	3634064	AAAATG	12	+	2	AAAATG
gi|514486632|gb|KE346360.1|	3635662	3635674	AGCTCC	12	-	2	GGAGCT
gi|514486632|gb|KE346360.1|	3636231	3636259	AGC	28	-	9	GCT
gi|514486632|gb|KE346360.1|	3636275	3636287	AACAGC	12	-	2	TGCTGT
gi|514486632|gb|KE346360.1|	3636488	3636506	AAG	18	+	6	AAG
gi|514486632|gb|KE346360.1|	3636549	3636561	ATCATG	12	+	2	GATCAT
gi|514486632|gb|KE346360.1|	3637246	3637258	ACACGC	12	+	2	CGCACA
gi|514486632|gb|KE346360.1|	3637503	3637546	AAC	43	+	14	ACA
gi|514486632|gb|KE346360.1|	3637545	3637573	AAAC	28	+	7	AAAC
gi|514486632|gb|KE346360.1|	3639395	3639409	ACTCAG	14	-	2	AGTCTG
gi|514486632|gb|KE346360.1|	3639490	3639502	ACGGCG	12	-	2	CGCCGT
gi|514486632|gb|KE346360.1|	3639667	3639696	ACT	29	-	9	GTA
gi|514486632|gb|KE346360.1|	3639946	3639961	AGAGGG	15	+	2	AGAGGG
gi|514486632|gb|KE346360.1|	3639965	3639978	AAAAGG	13	+	2	AGGAAA
gi|514486632|gb|KE346360.1|	3639999	3640011	AAAAAC	12	+	2	AAAAAC
gi|514486632|gb|KE346360.1|	3640329	3640341	ACCG	12	+	3	GACC
gi|514486632|gb|KE346360.1|	3641285	3641297	AACACC	12	-	2	TTGGTG
gi|514486632|gb|KE346360.1|	3641531	3641544	AACGAG	13	+	2	AGAACG
gi|514486632|gb|KE346360.1|	3642102	3642114	AAGCGG	12	+	2	CGGAAG
gi|514486632|gb|KE346360.1|	3642133	3642156	A	23	-	23	T
gi|514486632|gb|KE346360.1|	3642162	3642174	A	12	-	12	T
gi|514486632|gb|KE346360.1|	3642396	3642422	A	26	+	26	A
gi|514486632|gb|KE346360.1|	3642866	3642890	AAG	24	+	8	GAA
gi|514486632|gb|KE346360.1|	3642942	3642975	A	33	+	33	A
gi|514486632|gb|KE346360.1|	3643275	3643303	ATC	28	-	9	ATG
gi|514486632|gb|KE346360.1|	3643369	3643381	A	12	+	12	A
gi|514486632|gb|KE346360.1|	3643929	3643946	AAC	17	+	5	AAC
gi|514486632|gb|KE346360.1|	3644427	3644440	AACAGC	13	-	2	GTTGCT
gi|514486632|gb|KE346360.1|	3644663	3644688	A	25	+	25	A
gi|514486632|gb|KE346360.1|	3644820	3644838	A	18	+	18	A
gi|514486632|gb|KE346360.1|	3645446	3645459	AGATCC	13	+	2	GATCCA
gi|514486632|gb|KE346360.1|	3646017	3646030	AGC	13	+	4	CAG
gi|514486632|gb|KE346360.1|	3646533	3646546	AAAGC	13	-	2	TGCTT
gi|514486632|gb|KE346360.1|	3647296	3647309	AGCGCC	13	+	2	GCGCCA
gi|514486632|gb|KE346360.1|	3647304	3647319	ACTGGC	15	-	2	GCCAGT
gi|514486632|gb|KE346360.1|	3647996	3648008	ACC	12	-	4	TGG
gi|514486632|gb|KE346360.1|	3648418	3648431	ACC	13	-	4	GGT
gi|514486632|gb|KE346360.1|	3649309	3649322	ACTCAG	13	+	2	GACTCA
gi|514486632|gb|KE346360.1|	3651101	3651126	A	25	+	25	A
gi|514486632|gb|KE346360.1|	3651156	3651174	A	18	-	18	T
gi|514486632|gb|KE346360.1|	3651365	3651385	A	20	+	20	A
gi|514486632|gb|KE346360.1|	3651392	3651409	A	17	+	17	A
gi|514486632|gb|KE346360.1|	3651601	3651618	A	17	-	17	T
gi|514486632|gb|KE346360.1|	3651826	3651843	A	17	-	17	T
gi|514486632|gb|KE346360.1|	3651881	3651910	A	29	+	29	A
gi|514486632|gb|KE346360.1|	3651929	3651956	A	27	-	27	T
gi|514486632|gb|KE346360.1|	3652214	3652237	A	23	-	23	T
gi|514486632|gb|KE346360.1|	3652585	3652605	AAAAC	20	-	4	TTTTG
gi|514486632|gb|KE346360.1|	3652801	3652813	AACAAG	12	-	2	TGTTCT
gi|514486632|gb|KE346360.1|	3653687	3653701	AAAAAC	14	-	2	TTTTTG
gi|514486632|gb|KE346360.1|	3654005	3654017	AACAAG	12	-	2	CTTGTT
gi|514486632|gb|KE346360.1|	3654121	3654133	AAAG	12	-	3	TTTC
gi|514486632|gb|KE346360.1|	3654409	3654426	AACAAG	17	-	2	TTGTTC
gi|514486632|gb|KE346360.1|	3654529	3654542	AAAG	13	-	3	TTCT
gi|514486632|gb|KE346360.1|	3656671	3656683	AGC	12	+	4	AGC
gi|514486632|gb|KE346360.1|	3656692	3656706	ACT	14	-	4	AGT
gi|514486632|gb|KE346360.1|	3656891	3656903	ACGCCG	12	-	2	TCGGCG
gi|514486632|gb|KE346360.1|	3656986	3656998	ACG	12	-	4	GTC
gi|514486632|gb|KE346360.1|	3657159	3657173	AGATC	14	-	2	CTGAT
gi|514486632|gb|KE346360.1|	3657169	3657188	AGCTC	19	-	3	CTGAG
gi|514486632|gb|KE346360.1|	3659089	3659101	AAG	12	+	4	GAA
gi|514486632|gb|KE346360.1|	3659102	3659115	AAG	13	+	4	AAG
gi|514486632|gb|KE346360.1|	3659624	3659636	ACC	12	-	4	GTG
gi|514486632|gb|KE346360.1|	3659638	3659670	ATC	32	-	10	GAT
gi|514486632|gb|KE346360.1|	3659877	3659889	AAGTC	12	-	2	GACTT
gi|514486632|gb|KE346360.1|	3659965	3659977	AAATTC	12	-	2	TTTGAA
gi|514486632|gb|KE346360.1|	3659981	3659995	AAAGCC	14	-	2	CTTTGG
gi|514486632|gb|KE346360.1|	3660037	3660057	ACG	20	-	6	GTC
gi|514486632|gb|KE346360.1|	3660384	3660402	AGC	18	-	6	GCT
gi|514486632|gb|KE346360.1|	3660683	3660730	A	47	-	47	T
gi|514486632|gb|KE346360.1|	3660751	3660766	A	15	-	15	T
gi|514486632|gb|KE346360.1|	3660973	3660987	AC	14	+	7	CA
gi|514486632|gb|KE346360.1|	3661589	3661612	ACT	23	+	7	CTA
gi|514486632|gb|KE346360.1|	3661619	3661631	ACACC	12	+	2	CACCA
gi|514486632|gb|KE346360.1|	3662072	3662084	AGCTGC	12	+	2	CAGCTG
gi|514486632|gb|KE346360.1|	3662301	3662318	AGC	17	+	5	GCA
gi|514486632|gb|KE346360.1|	3662698	3662710	AGATC	12	-	2	CTGAT
gi|514486632|gb|KE346360.1|	3662928	3662942	AACC	14	-	3	GGTT
gi|514486632|gb|KE346360.1|	3663662	3663674	AAC	12	-	4	TGT
gi|514486632|gb|KE346360.1|	3663678	3663690	AACATC	12	-	2	TGTTGA
gi|514486632|gb|KE346360.1|	3663938	3663950	A	12	-	12	T
gi|514486632|gb|KE346360.1|	3664007	3664019	AAAGTG	12	-	2	TTTCAC
gi|514486632|gb|KE346360.1|	3664400	3664426	ACG	26	+	8	GAC
gi|514486632|gb|KE346360.1|	3665741	3665755	AG	14	+	7	GA
gi|514486632|gb|KE346360.1|	3665794	3665808	AG	14	+	7	GA
gi|514486632|gb|KE346360.1|	3665827	3665842	AC	15	+	7	AC
gi|514486632|gb|KE346360.1|	3666735	3666748	ACAGAG	13	-	2	CTGTCT
gi|514486632|gb|KE346360.1|	3666932	3666945	AACG	13	-	3	CGTT
gi|514486632|gb|KE346360.1|	3667392	3667404	A	12	+	12	A
gi|514486632|gb|KE346360.1|	3667723	3667736	AACGC	13	+	2	ACGCA
gi|514486632|gb|KE346360.1|	3667793	3667806	AGGCGG	13	-	2	CCGCCT
gi|514486632|gb|KE346360.1|	3667874	3667888	ACCAGC	14	+	2	CACCAG
gi|514486632|gb|KE346360.1|	3667883	3667909	AGC	26	+	8	CAG
gi|514486632|gb|KE346360.1|	3668350	3668367	CCG	17	+	5	GCC
gi|514486632|gb|KE346360.1|	3669456	3669471	A	15	-	15	T
gi|514486632|gb|KE346360.1|	3669829	3669841	AACGTG	12	-	2	CGTTCA
gi|514486632|gb|KE346360.1|	3672602	3672614	AAGCG	12	+	2	CGAAG
gi|514486632|gb|KE346360.1|	3672910	3672924	AACAGC	14	+	2	CAGCAA
gi|514486632|gb|KE346360.1|	3674232	3674259	A	27	+	27	A
gi|514486632|gb|KE346360.1|	3674291	3674309	A	18	+	18	A
gi|514486632|gb|KE346360.1|	3675020	3675039	ACGAG	19	-	3	TCTCG
gi|514486632|gb|KE346360.1|	3675289	3675302	AG	13	+	6	AG
gi|514486632|gb|KE346360.1|	3675303	3675320	AG	17	+	8	AG
gi|514486632|gb|KE346360.1|	3675502	3675524	A	22	-	22	T
gi|514486632|gb|KE346360.1|	3675937	3675966	AGC	29	-	9	TGC
gi|514486632|gb|KE346360.1|	3678052	3678065	AAC	13	+	4	CAA
gi|514486632|gb|KE346360.1|	3678243	3678256	ATGCCC	13	+	2	GCCCAT
gi|514486632|gb|KE346360.1|	3678274	3678287	ACGAGG	13	-	2	TCGTCC
gi|514486632|gb|KE346360.1|	3678681	3678694	ACGATG	13	-	2	ATCGTC
gi|514486632|gb|KE346360.1|	3678699	3678729	ATC	30	+	10	ATC
gi|514486632|gb|KE346360.1|	3678735	3678750	ACAGCG	15	-	2	GTCGCT
gi|514486632|gb|KE346360.1|	3679002	3679014	AC	12	-	6	TG
gi|514486632|gb|KE346360.1|	3679094	3679106	ACACC	12	+	2	CACAC
gi|514486632|gb|KE346360.1|	3679171	3679196	A	25	-	25	T
gi|514486632|gb|KE346360.1|	3679239	3679254	AG	15	-	7	CT
gi|514486632|gb|KE346360.1|	3679255	3679329	AG	74	-	37	CT
gi|514486632|gb|KE346360.1|	3679529	3679550	AGC	21	+	7	CAG
gi|514486632|gb|KE346360.1|	3679986	3679999	ACTCCT	13	+	2	CTACTC
gi|514486632|gb|KE346360.1|	3680000	3680018	ACT	18	+	6	ACT
gi|514486632|gb|KE346360.1|	3680106	3680118	ACGCTG	12	+	2	GACGCT
gi|514486632|gb|KE346360.1|	3680537	3680554	AAAACC	17	-	2	TTTTGG
gi|514486632|gb|KE346360.1|	3682810	3682825	AACCCC	15	-	2	GGGTTG
gi|514486632|gb|KE346360.1|	3682890	3682903	ACTC	13	+	3	CACT
gi|514486632|gb|KE346360.1|	3683114	3683127	AGAGCG	13	+	2	CGAGAG
gi|514486632|gb|KE346360.1|	3683490	3683503	A	13	-	13	T
gi|514486632|gb|KE346360.1|	3683544	3683556	AC	12	-	6	TG
gi|514486632|gb|KE346360.1|	3683868	3683881	ACACTC	13	+	2	CTCACA
gi|514486632|gb|KE346360.1|	3684026	3684038	AAAGAG	12	-	2	TTCTCT
gi|514486632|gb|KE346360.1|	3684045	3684058	AG	13	-	6	TC
gi|514486632|gb|KE346360.1|	3684070	3684087	AACTCC	17	+	2	TCCAAC
gi|514486632|gb|KE346360.1|	3684118	3684130	AACATG	12	-	2	TTCATG
gi|514486632|gb|KE346360.1|	3684288	3684307	AGC	19	-	6	GCT
gi|514486632|gb|KE346360.1|	3684457	3684469	ACTGCC	12	-	2	GTGGCA
gi|514486632|gb|KE346360.1|	3684536	3684551	AGG	15	-	5	CTC
gi|514486632|gb|KE346360.1|	3684567	3684585	ACTGGC	18	+	3	ACTGGC
gi|514486632|gb|KE346360.1|	3684586	3684601	ACTGGC	15	+	2	CTGGCA
gi|514486632|gb|KE346360.1|	3685017	3685033	AAAAAC	16	-	2	GTTTTT
gi|514486632|gb|KE346360.1|	3686560	3686572	ATGCC	12	+	2	GCCAT
gi|514486632|gb|KE346360.1|	3686598	3686612	A	14	-	14	T
gi|514486632|gb|KE346360.1|	3687557	3687573	AAC	16	-	5	GTT
gi|514486632|gb|KE346360.1|	3688590	3688602	AGCGCG	12	-	2	GCTCGC
gi|514486632|gb|KE346360.1|	3689019	3689033	ACGGGG	14	-	2	CGTCCC
gi|514486632|gb|KE346360.1|	3689891	3689903	AGCGGC	12	+	2	AGCGGC
gi|514486632|gb|KE346360.1|	3690012	3690026	AGC	14	+	4	GCA
gi|514486632|gb|KE346360.1|	3690281	3690293	AGCGCC	12	+	2	GCCAGC
gi|514486632|gb|KE346360.1|	3690407	3690431	AGC	24	-	8	CTG
gi|514486632|gb|KE346360.1|	3690455	3690467	ATGCCC	12	+	2	GCCCAT
gi|514486632|gb|KE346360.1|	3690812	3690828	AGC	16	-	5	GCT
gi|514486632|gb|KE346360.1|	3690829	3690843	AGCCAT	14	+	2	CCATAG
gi|514486632|gb|KE346360.1|	3690909	3690932	A	23	+	23	A
gi|514486632|gb|KE346360.1|	3691160	3691175	AAAC	15	+	3	ACAA
gi|514486632|gb|KE346360.1|	3691184	3691200	AG	16	-	8	CT
gi|514486632|gb|KE346360.1|	3691450	3691465	ACTCC	15	-	3	GGAGT
gi|514486632|gb|KE346360.1|	3693212	3693224	AAGCGG	12	-	2	CTTCCG
gi|514486632|gb|KE346360.1|	3693819	3693832	AAGTGG	13	-	2	TTCCAC
gi|514486632|gb|KE346360.1|	3693858	3693872	AAAAC	14	-	2	GTTTT
gi|514486632|gb|KE346360.1|	3694115	3694128	ATCC	13	+	3	TCCA
gi|514486632|gb|KE346360.1|	3696263	3696275	A	12	-	12	T
gi|514486632|gb|KE346360.1|	3697883	3697895	AACGCC	12	-	2	TGGCGT
gi|514486632|gb|KE346360.1|	3698347	3698387	A	40	+	40	A
gi|514486632|gb|KE346360.1|	3698403	3698419	AAAG	16	-	4	CTTT
gi|514486632|gb|KE346360.1|	3698471	3698487	AATGC	16	+	3	CAATG
gi|514486632|gb|KE346360.1|	3698489	3698506	AAC	17	-	5	TGT
gi|514486632|gb|KE346360.1|	3698515	3698528	AATCTC	13	+	2	CTCAAT
gi|514486632|gb|KE346360.1|	3698938	3698951	A	13	+	13	A
gi|514486632|gb|KE346360.1|	3699606	3699619	ACCGCC	13	+	2	CCGCCA
gi|514486632|gb|KE346360.1|	3699625	3699637	ACGAGG	12	-	2	GTCCTC
gi|514486632|gb|KE346360.1|	3700062	3700074	ACAGCC	12	+	2	GCCACA
gi|514486632|gb|KE346360.1|	3701586	3701602	AAACC	16	-	3	GGTTT
gi|514486632|gb|KE346360.1|	3701602	3701615	AAACC	13	-	2	TTGGT
gi|514486632|gb|KE346360.1|	3701632	3701645	AACACC	13	+	2	CACCAA
gi|514486632|gb|KE346360.1|	3702018	3702033	AGC	15	+	5	AGC
gi|514486632|gb|KE346360.1|	3702849	3702863	AG	14	+	7	GA
gi|514486632|gb|KE346360.1|	3703396	3703413	A	17	-	17	T
gi|514486632|gb|KE346360.1|	3703877	3703890	AATGAC	13	+	2	CAATGA
gi|514486632|gb|KE346360.1|	3704117	3704129	AAGGCC	12	-	2	TGGCCT
gi|514486632|gb|KE346360.1|	3704625	3704637	AGCCGC	12	-	2	CTGCGG
gi|514486632|gb|KE346360.1|	3704703	3704715	ACACTG	12	-	2	TGTCAG
gi|514486632|gb|KE346360.1|	3704886	3704901	ACG	15	+	5	CGA
gi|514486632|gb|KE346360.1|	3705120	3705137	AAGCGC	17	-	2	GCTTGC
gi|514486632|gb|KE346360.1|	3705172	3705184	ACCCAG	12	+	2	CCAGAC
gi|514486632|gb|KE346360.1|	3705361	3705373	AAGAGG	12	+	2	GAAGAG
gi|514486632|gb|KE346360.1|	3705416	3705428	AAGGCG	12	+	2	GCGAAG
gi|514486632|gb|KE346360.1|	3705464	3705481	A	17	+	17	A
gi|514486632|gb|KE346360.1|	3705705	3705724	A	19	+	19	A
gi|514486632|gb|KE346360.1|	3705930	3705949	ATC	19	+	6	CAT
gi|514486632|gb|KE346360.1|	3706007	3706021	ACGAGG	14	-	2	TCCTCG
gi|514486632|gb|KE346360.1|	3706208	3706225	ATC	17	+	5	TCA
gi|514486632|gb|KE346360.1|	3706246	3706270	ACGATG	24	-	4	ATCGTC
gi|514486632|gb|KE346360.1|	3706371	3706384	ACCTGC	13	-	2	CAGGTG
gi|514486632|gb|KE346360.1|	3706387	3706415	AAGGGC	28	-	4	CTTGCC
gi|514486632|gb|KE346360.1|	3706523	3706540	ACG	17	-	5	TCG
gi|514486632|gb|KE346360.1|	3707529	3707543	AATCAC	14	-	2	ATTGTG
gi|514486632|gb|KE346360.1|	3707538	3707550	ACCATC	12	-	2	GTGATG
gi|514486632|gb|KE346360.1|	3707633	3707646	ACACCC	13	+	2	CCCACA
gi|514486632|gb|KE346360.1|	3708041	3708056	ACC	15	-	5	GGT
gi|514486632|gb|KE346360.1|	3708134	3708162	AG	28	+	14	AG
gi|514486632|gb|KE346360.1|	3708329	3708343	AAAAT	14	+	2	AAAAT
gi|514486632|gb|KE346360.1|	3709207	3709219	AAAAAC	12	+	2	CAAAAA
gi|514486632|gb|KE346360.1|	3709808	3709820	ACG	12	-	4	CGT
gi|514486632|gb|KE346360.1|	3710920	3710932	AATGC	12	+	2	GCAAT
gi|514486632|gb|KE346360.1|	3711064	3711079	AATGAG	15	-	2	ATTCTC
gi|514486632|gb|KE346360.1|	3711081	3711110	ATC	29	-	9	GAT
gi|514486632|gb|KE346360.1|	3711410	3711422	ACGGCG	12	+	2	CGACGG
gi|514486632|gb|KE346360.1|	3711440	3711453	ACGGCG	13	+	2	CGACGG
gi|514486632|gb|KE346360.1|	3711455	3711467	ACGAGC	12	+	2	CGAGCA
gi|514486632|gb|KE346360.1|	3711497	3711509	ACGAGG	12	+	2	GACGAG
gi|514486632|gb|KE346360.1|	3711904	3711919	AAAAC	15	-	3	TTTGT
gi|514486632|gb|KE346360.1|	3711918	3711939	AAAAC	21	-	4	TGTTT
gi|514486632|gb|KE346360.1|	3712028	3712040	ACTCTG	12	+	2	TGACTC
gi|514486632|gb|KE346360.1|	3712089	3712109	AC	20	+	10	AC
gi|514486632|gb|KE346360.1|	3712110	3712123	AC	13	+	6	CA
gi|514486632|gb|KE346360.1|	3712791	3712804	AAG	13	-	4	TCT
gi|514486632|gb|KE346360.1|	3713487	3713501	ACCGGC	14	+	2	CCGGCA
gi|514486632|gb|KE346360.1|	3714318	3714330	AACAGC	12	-	2	TGTTGC
gi|514486632|gb|KE346360.1|	3714497	3714509	ATCATG	12	+	2	TGATCA
gi|514486632|gb|KE346360.1|	3714907	3714921	AATGGC	14	-	2	CATTGC
gi|514486632|gb|KE346360.1|	3717027	3717042	AAGATG	15	-	2	TCATCT
gi|514486632|gb|KE346360.1|	3718094	3718106	AAATGC	12	-	2	CATTTG
gi|514486632|gb|KE346360.1|	3718735	3718757	ACGATG	22	-	3	CATCGT
gi|514486632|gb|KE346360.1|	3718752	3718767	ATC	15	+	5	TCA
gi|514486632|gb|KE346360.1|	3719275	3719289	CCG	14	-	4	GCG
gi|514486632|gb|KE346360.1|	3719377	3719389	ACACGT	12	-	2	ACGTGT
gi|514486632|gb|KE346360.1|	3719921	3719935	A	14	-	14	T
gi|514486632|gb|KE346360.1|	3720346	3720359	AGCTGC	13	+	2	CTGCAG
gi|514486632|gb|KE346360.1|	3721054	3721066	AAG	12	-	4	CTT
gi|514486632|gb|KE346360.1|	3721789	3721801	ACATGG	12	+	2	GACATG
gi|514486632|gb|KE346360.1|	3722587	3722604	ACGATG	17	-	2	TCATCG
gi|514486632|gb|KE346360.1|	3722796	3722808	AAGCTG	12	+	2	TGAAGC
gi|514486632|gb|KE346360.1|	3723066	3723081	ACG	15	+	5	CGA
gi|514486632|gb|KE346360.1|	3723079	3723102	ATC	23	-	7	GAT
gi|514486632|gb|KE346360.1|	3724763	3724775	AGCGCC	12	-	2	GGCGCT
gi|514486632|gb|KE346360.1|	3724817	3724829	AAGAGC	12	-	2	CTCTTG
gi|514486632|gb|KE346360.1|	3726584	3726603	CCG	19	+	6	GCC
gi|514486632|gb|KE346360.1|	3727226	3727245	AACAGC	19	-	3	GCTGTT
gi|514486632|gb|KE346360.1|	3727593	3727605	AAAAC	12	-	2	GTTTT
gi|514486632|gb|KE346360.1|	3728114	3728129	AAG	15	+	5	GAA
gi|514486632|gb|KE346360.1|	3728165	3728192	A	27	+	27	A
gi|514486632|gb|KE346360.1|	3728395	3728415	A	20	-	20	T
gi|514486632|gb|KE346360.1|	3728638	3728651	ATCCGC	13	-	2	GCGGAT
gi|514486632|gb|KE346360.1|	3728745	3728763	A	18	+	18	A
gi|514486632|gb|KE346360.1|	3728921	3728933	AGCAGG	12	+	2	AGCAGG
gi|514486632|gb|KE346360.1|	3728951	3728966	A	15	+	15	A
gi|514486632|gb|KE346360.1|	3728968	3728991	A	23	+	23	A
gi|514486632|gb|KE346360.1|	3729643	3729656	AGGGGG	13	+	2	GAGGGG
gi|514486632|gb|KE346360.1|	3730643	3730655	AAAGC	12	-	2	TGCTT
gi|514486632|gb|KE346360.1|	3730746	3730758	ATCCCC	12	+	2	CCCCAT
gi|514486632|gb|KE346360.1|	3731262	3731274	ACAGT	12	+	2	GTACA
gi|514486632|gb|KE346360.1|	3731472	3731487	AGC	15	-	5	CTG
gi|514486632|gb|KE346360.1|	3731482	3731498	AACAGC	16	-	2	TGCTGT
gi|514486632|gb|KE346360.1|	3731861	3731873	AAAACC	12	-	2	TTTTGG
gi|514486632|gb|KE346360.1|	3732023	3732035	ACC	12	-	4	GGT
gi|514486632|gb|KE346360.1|	3732033	3732045	ACAGT	12	-	2	GTACT
gi|514486632|gb|KE346360.1|	3733056	3733068	AGAGCG	12	-	2	CTCGCT
gi|514486632|gb|KE346360.1|	3733131	3733144	AGCCTC	13	+	2	CTCAGC
gi|514486632|gb|KE346360.1|	3733993	3734005	AAAAAC	12	-	2	TTGTTT
gi|514486632|gb|KE346360.1|	3734106	3734129	AAAAC	23	+	4	AAACA
gi|514486632|gb|KE346360.1|	3734290	3734305	AC	15	-	7	TG
gi|514486632|gb|KE346360.1|	3734433	3734446	AG	13	+	6	GA
gi|514486632|gb|KE346360.1|	3734469	3734482	AC	13	-	6	TG
gi|514486632|gb|KE346360.1|	3734686	3734700	AGGGG	14	+	2	GGGGA
gi|514486632|gb|KE346360.1|	3734794	3734806	AAT	12	+	4	AAT
gi|514486632|gb|KE346360.1|	3734868	3734881	CCG	13	-	4	GCG
gi|514486632|gb|KE346360.1|	3735087	3735099	ACTCC	12	+	2	CACTC
gi|514486632|gb|KE346360.1|	3735107	3735119	AACGC	12	+	2	CAACG
gi|514486632|gb|KE346360.1|	3735124	3735143	ACAG	19	+	4	CAGA
gi|514486632|gb|KE346360.1|	3735141	3735153	AAGGC	12	+	2	AGGCA
gi|514486632|gb|KE346360.1|	3735346	3735419	AG	73	+	36	AG
gi|514486632|gb|KE346360.1|	3735438	3735477	AG	39	+	19	AG
gi|514486632|gb|KE346360.1|	3735478	3735490	AG	12	+	6	AG
gi|514486632|gb|KE346360.1|	3735557	3735569	ACTCTC	12	+	2	CTCACT
gi|514486632|gb|KE346360.1|	3735706	3735720	AATGAG	14	+	2	AATGAG
gi|514486632|gb|KE346360.1|	3736363	3736384	AGC	21	+	7	CAG
gi|514486632|gb|KE346360.1|	3736903	3736919	CCG	16	+	5	CCG
gi|514486632|gb|KE346360.1|	3736917	3736932	AGC	15	-	5	GCT
gi|514486632|gb|KE346360.1|	3738165	3738180	AAAAAC	15	+	2	AACAAA
gi|514486632|gb|KE346360.1|	3738401	3738413	CCGCG	12	-	2	GCGCG
gi|514486632|gb|KE346360.1|	3739083	3739096	ACGAGC	13	+	2	AGCACG
gi|514486632|gb|KE346360.1|	3740610	3740624	AACACG	14	+	2	CACGAA
gi|514486632|gb|KE346360.1|	3740953	3740965	ACTC	12	-	3	AGTG
gi|514486632|gb|KE346360.1|	3740966	3740992	ACTC	26	-	6	AGTG
gi|514486632|gb|KE346360.1|	3741072	3741085	AAGGC	13	+	2	CAAGG
gi|514486632|gb|KE346360.1|	3741253	3741267	A	14	+	14	A
gi|514486632|gb|KE346360.1|	3741271	3741283	AATGT	12	+	2	ATGTA
gi|514486632|gb|KE346360.1|	3741612	3741628	AAC	16	-	5	TGT
gi|514486632|gb|KE346360.1|	3741743	3741838	AC	95	+	47	CA
gi|514486632|gb|KE346360.1|	3741839	3741874	AC	35	+	17	CA
gi|514486632|gb|KE346360.1|	3742263	3742275	AATCGG	12	+	2	TCGGAA
gi|514486632|gb|KE346360.1|	3743259	3743277	AAC	18	-	6	TTG
gi|514486632|gb|KE346360.1|	3743597	3743610	ACG	13	-	4	TCG
gi|514486632|gb|KE346360.1|	3743611	3743628	ACGACT	17	-	2	GTCGTA
gi|514486632|gb|KE346360.1|	3743773	3743785	AATG	12	+	3	ATGA
gi|514486632|gb|KE346360.1|	3743789	3743801	AATG	12	+	3	ATGA
gi|514486632|gb|KE346360.1|	3744241	3744259	AGG	18	-	6	CTC
gi|514486632|gb|KE346360.1|	3744505	3744523	ACTC	18	-	4	GAGT
gi|514486632|gb|KE346360.1|	3744590	3744607	AACAAT	17	-	2	TTGTTA
gi|514486632|gb|KE346360.1|	3748149	3748161	AACGTC	12	-	2	ACGTTG
gi|514486632|gb|KE346360.1|	3749163	3749178	AC	15	+	7	CA
gi|514486632|gb|KE346360.1|	3749664	3749676	AGCGGC	12	+	2	GCAGCG
gi|514486632|gb|KE346360.1|	3749999	3750012	AGGCCG	13	+	2	GCCGAG
gi|514486632|gb|KE346360.1|	3750484	3750498	AAAAAG	14	+	2	AAAGAA
gi|514486632|gb|KE346360.1|	3750515	3750527	A	12	+	12	A
gi|514486632|gb|KE346360.1|	3750552	3750569	A	17	+	17	A
gi|514486632|gb|KE346360.1|	3750607	3750621	A	14	-	14	T
gi|514486632|gb|KE346360.1|	3750901	3750913	ACACCG	12	+	2	CACCGA
gi|514486632|gb|KE346360.1|	3751007	3751022	A	15	+	15	A
gi|514486632|gb|KE346360.1|	3751055	3751077	AC	22	+	11	CA
gi|514486632|gb|KE346360.1|	3751237	3751249	A	12	+	12	A
gi|514486632|gb|KE346360.1|	3751247	3751264	AAT	17	+	5	AAT
gi|514486632|gb|KE346360.1|	3751398	3751413	ACGATG	15	+	2	CGATGA
gi|514486632|gb|KE346360.1|	3752092	3752115	AGCATC	23	-	3	TGCTGA
gi|514486632|gb|KE346360.1|	3752116	3752128	AGCATC	12	-	2	TGCTGA
gi|514486632|gb|KE346360.1|	3752300	3752312	CCG	12	+	4	CGC
gi|514486632|gb|KE346360.1|	3753023	3753038	ACG	15	-	5	TCG
gi|514486632|gb|KE346360.1|	3753054	3753067	AAGCTG	13	+	2	GCTGAA
gi|514486632|gb|KE346360.1|	3753306	3753319	AAAAAC	13	+	2	AAACAA
gi|514486632|gb|KE346360.1|	3753759	3753774	A	15	+	15	A
gi|514486632|gb|KE346360.1|	3753975	3753988	AAATAC	13	+	2	AAATAC
gi|514486632|gb|KE346360.1|	3754001	3754022	AAT	21	+	7	ATA
gi|514486632|gb|KE346360.1|	3754821	3754835	A	14	-	14	T
gi|514486632|gb|KE346360.1|	3755031	3755043	AAAAT	12	+	2	AATAA
gi|514486632|gb|KE346360.1|	3755044	3755056	AAAT	12	+	3	TAAA
gi|514486632|gb|KE346360.1|	3755077	3755100	AAAAT	23	+	4	AAAAT
gi|514486632|gb|KE346360.1|	3755097	3755112	AAAAAT	15	+	2	AAATAA
gi|514486632|gb|KE346360.1|	3755131	3755143	AAAAT	12	+	2	AAAAT
gi|514486632|gb|KE346360.1|	3755143	3755156	A	13	-	13	T
gi|514486632|gb|KE346360.1|	3755205	3755223	A	18	+	18	A
gi|514486632|gb|KE346360.1|	3760369	3760381	ACTGGG	12	-	2	CCCAGT
gi|514486632|gb|KE346360.1|	3760376	3760389	AACTGG	13	-	2	CCAGTT
gi|514486632|gb|KE346360.1|	3760438	3760451	AGGGGG	13	-	2	CCCCCT
gi|514486632|gb|KE346360.1|	3760448	3760464	ACTC	16	+	4	CTCA
gi|514486632|gb|KE346360.1|	3762256	3762273	CCG	17	-	5	CGG
gi|514486632|gb|KE346360.1|	3763084	3763097	AAAAAC	13	-	2	TTTTGT
gi|514486632|gb|KE346360.1|	3763123	3763135	AAC	12	-	4	GTT
gi|514486632|gb|KE346360.1|	3763240	3763252	AAGGGG	12	-	2	TCCCCT
gi|514486632|gb|KE346360.1|	3763418	3763432	AAGCAC	14	-	2	GTGCTT
gi|514486632|gb|KE346360.1|	3763909	3763923	AATGAC	14	+	2	TGACAA
gi|514486632|gb|KE346360.1|	3764410	3764422	AGC	12	+	4	AGC
gi|514486632|gb|KE346360.1|	3765293	3765306	AAAGTC	13	-	2	GACTTT
gi|514486632|gb|KE346360.1|	3765744	3765758	AGCTGC	14	+	2	CTGCAG
gi|514486632|gb|KE346360.1|	3766628	3766641	A	13	+	13	A
gi|514486632|gb|KE346360.1|	3768651	3768663	AAAAAC	12	-	2	TTTTTG
gi|514486632|gb|KE346360.1|	3769731	3769768	AC	37	+	18	CA
gi|514486632|gb|KE346360.1|	3770991	3771004	AAAG	13	+	3	AAAG
gi|514486632|gb|KE346360.1|	3771015	3771028	AAG	13	+	4	AGA
gi|514486632|gb|KE346360.1|	3771186	3771209	AAAC	23	+	5	AAAC
gi|514486632|gb|KE346360.1|	3771230	3771242	AAAAAC	12	+	2	CAAAAA
gi|514486632|gb|KE346360.1|	3771951	3771963	AACCCT	12	+	2	CCCTAA
gi|514486632|gb|KE346360.1|	3771982	3771997	AATCC	15	+	3	ATCCA
gi|514486632|gb|KE346360.1|	3772082	3772101	AG	19	-	9	TC
gi|514486632|gb|KE346360.1|	3772180	3772232	A	52	-	52	T
gi|514486632|gb|KE346360.1|	3772548	3772573	AGC	25	+	8	CAG
gi|514486632|gb|KE346360.1|	3772615	3772628	AGGCGC	13	+	2	CGCAGG
gi|514486632|gb|KE346360.1|	3772729	3772741	ATC	12	+	4	CAT
gi|514486632|gb|KE346360.1|	3772856	3772878	AG	22	-	11	CT
gi|514486632|gb|KE346360.1|	3772879	3772895	AG	16	-	8	TC
gi|514486632|gb|KE346360.1|	3773179	3773194	AATGGC	15	+	2	TGGCAA
gi|514486632|gb|KE346360.1|	3773204	3773218	AGC	14	+	4	AGC
gi|514486632|gb|KE346360.1|	3773366	3773381	AACTC	15	+	3	ACTCA
gi|514486632|gb|KE346360.1|	3774425	3774438	ACT	13	-	4	TAG
gi|514486632|gb|KE346360.1|	3774433	3774449	ACGACT	16	-	2	GTAGTC
gi|514486632|gb|KE346360.1|	3774600	3774614	ACAGT	14	+	2	TACAG
gi|514486632|gb|KE346360.1|	3774710	3774725	AATAGG	15	-	2	TTCCTA
gi|514486632|gb|KE346360.1|	3774765	3774783	AATG	18	-	4	TTCA
gi|514486632|gb|KE346360.1|	3774831	3774844	ACG	13	+	4	CGA
gi|514486632|gb|KE346360.1|	3774856	3774879	ACTGGC	23	-	3	TGCCAG
gi|514486632|gb|KE346360.1|	3775019	3775031	CCG	12	-	4	GCG
gi|514486632|gb|KE346360.1|	3775056	3775072	ATCCGC	16	+	2	CATCCG
gi|514486632|gb|KE346360.1|	3775067	3775079	AGATGC	12	-	2	GCATCT
gi|514486632|gb|KE346360.1|	3775081	3775097	AGATGC	16	-	2	ATCTGC
gi|514486632|gb|KE346360.1|	3775099	3775111	AGATGC	12	-	2	ATCTGC
gi|514486632|gb|KE346360.1|	3775512	3775531	AGC	19	-	6	CTG
gi|514486632|gb|KE346360.1|	3775927	3775939	AGCGGC	12	+	2	GGCAGC
gi|514486632|gb|KE346360.1|	3775934	3775970	AGC	36	+	12	GCA
gi|514486632|gb|KE346360.1|	3777440	3777511	AC	71	-	35	GT
gi|514486632|gb|KE346360.1|	3778125	3778139	AAC	14	-	4	TGT
gi|514486632|gb|KE346360.1|	3778148	3778177	AAC	29	-	9	GTT
gi|514486632|gb|KE346360.1|	3778329	3778342	AAGGAC	13	-	2	GTCCTT
gi|514486632|gb|KE346360.1|	3778572	3778586	AAGAGG	14	-	2	TCCTCT
gi|514486632|gb|KE346360.1|	3778596	3778613	ACG	17	-	5	TCG
gi|514486632|gb|KE346360.1|	3778612	3778624	AGC	12	-	4	CTG
gi|514486632|gb|KE346360.1|	3780089	3780103	AAAAAC	14	-	2	TTGTTT
gi|514486632|gb|KE346360.1|	3780288	3780300	AATGC	12	-	2	TGCAT
gi|514486632|gb|KE346360.1|	3780433	3780445	AAAAAG	12	-	2	TTTCTT
gi|514486632|gb|KE346360.1|	3780863	3780882	AGCCTG	19	-	3	CAGGCT
gi|514486632|gb|KE346360.1|	3780877	3780898	AGCCCG	21	-	3	GGCTCG
gi|514486632|gb|KE346360.1|	3781540	3781554	AGG	14	+	4	GGA
gi|514486632|gb|KE346360.1|	3781822	3781834	A	12	-	12	T
gi|514486632|gb|KE346360.1|	3782006	3782023	ACCAGC	17	+	2	GCACCA
gi|514486632|gb|KE346360.1|	3782243	3782257	ACTCTG	14	+	2	ACTCTG
gi|514486632|gb|KE346360.1|	3782271	3782287	AAC	16	-	5	TTG
gi|514486632|gb|KE346360.1|	3782391	3782403	AAC	12	+	4	ACA
gi|514486632|gb|KE346360.1|	3782425	3782438	ATC	13	+	4	CAT
gi|514486632|gb|KE346360.1|	3782436	3782448	ACG	12	-	4	TCG
gi|514486632|gb|KE346360.1|	3782789	3782805	AACC	16	-	4	TTGG
gi|514486632|gb|KE346360.1|	3782958	3782970	ATCGCG	12	+	2	CGATCG
gi|514486632|gb|KE346360.1|	3783473	3783493	AG	20	+	10	AG
gi|514486632|gb|KE346360.1|	3783599	3783612	AAAAAC	13	-	2	TTGTTT
gi|514486632|gb|KE346360.1|	3783742	3783769	AACTCG	27	-	4	TCGAGT
gi|514486632|gb|KE346360.1|	3783857	3783870	ACG	13	+	4	CGA
gi|514486632|gb|KE346360.1|	3784145	3784160	ACG	15	+	5	CGA
gi|514486632|gb|KE346360.1|	3784524	3784537	ATCGCC	13	+	2	CATCGC
gi|514486632|gb|KE346360.1|	3784904	3784916	AACGCG	12	+	2	ACGCGA
gi|514486632|gb|KE346360.1|	3785540	3785562	AC	22	-	11	TG
gi|514486632|gb|KE346360.1|	3785678	3785691	A	13	+	13	A
gi|514486632|gb|KE346360.1|	3786002	3786015	AAACAC	13	-	2	TTGTGT
gi|514486632|gb|KE346360.1|	3786111	3786123	AGC	12	-	4	CTG
gi|514486632|gb|KE346360.1|	3786352	3786364	ACACTG	12	+	2	ACACTG
gi|514486632|gb|KE346360.1|	3786635	3786647	ACGCCG	12	-	2	GTCGGC
gi|514486632|gb|KE346360.1|	3786997	3787027	AAGG	30	+	7	GAAG
gi|514486632|gb|KE346360.1|	3787360	3787374	A	14	+	14	A
gi|514486632|gb|KE346360.1|	3787488	3787503	A	15	+	15	A
gi|514486632|gb|KE346360.1|	3788012	3788145	AG	133	-	66	CT
gi|514486632|gb|KE346360.1|	3788348	3788361	ACATCG	13	+	2	TCGACA
gi|514486632|gb|KE346360.1|	3788971	3788984	AAAAAG	13	-	2	CTTTTT
gi|514486632|gb|KE346360.1|	3789196	3789208	AAAAGC	12	+	2	AGCAAA
gi|514486632|gb|KE346360.1|	3790919	3790931	AC	12	+	6	CA
gi|514486632|gb|KE346360.1|	3791397	3791453	AAAAAC	56	+	9	AACAAA
gi|514486632|gb|KE346360.1|	3791452	3791468	AAAC	16	+	4	AAAC
gi|514486632|gb|KE346360.1|	3792808	3792820	ACGGCT	12	-	2	AGCCGT
gi|514486632|gb|KE346360.1|	3792909	3792923	AACGCC	14	+	2	CCAACG
gi|514486632|gb|KE346360.1|	3793152	3793166	AAAAC	14	-	2	GTTTT
gi|514486632|gb|KE346360.1|	3794039	3794051	AAAAAG	12	-	2	TTTCTT
gi|514486632|gb|KE346360.1|	3794185	3794200	AGC	15	+	5	AGC
gi|514486632|gb|KE346360.1|	3794260	3794274	A	14	+	14	A
gi|514486632|gb|KE346360.1|	3794270	3794284	AAAAC	14	+	2	AAAAC
gi|514486271|gb|KE346361.1|	828	840	ACCCCG	12	+	2	CCCCGA
gi|514486271|gb|KE346361.1|	2650	2663	ACTCGG	13	+	2	CGGACT
gi|514486271|gb|KE346361.1|	3217	3231	ACG	14	+	4	CGA
gi|514486271|gb|KE346361.1|	4312	4324	AGCATG	12	+	2	TGAGCA
gi|514486271|gb|KE346361.1|	4968	5306	AAC	338	+	112	AAC
gi|514486271|gb|KE346361.1|	6413	6426	AATCGG	13	+	2	AATCGG
gi|514486271|gb|KE346361.1|	7745	7828	AC	83	+	41	AC
gi|514486271|gb|KE346361.1|	9026	9038	AAAACC	12	-	2	TTTTGG
gi|514486271|gb|KE346361.1|	9274	9286	AAGGAC	12	-	2	TGTCCT
gi|514486271|gb|KE346361.1|	9989	10008	AAAAG	19	-	3	TTTTC
gi|514486271|gb|KE346361.1|	10134	10160	AGG	26	-	8	CTC
gi|514486271|gb|KE346361.1|	10280	10321	AG	41	-	20	CT
gi|514486271|gb|KE346361.1|	10322	10335	ACTCTC	13	+	2	CACTCT
gi|514486271|gb|KE346361.1|	10408	10423	AGCCTG	15	+	2	CCTGAG
gi|514486271|gb|KE346361.1|	10792	10804	ACAGT	12	+	2	GTACA
gi|514486271|gb|KE346361.1|	13545	13592	AC	47	+	23	AC
gi|514486271|gb|KE346361.1|	13593	13662	AC	69	+	34	AC
gi|514486271|gb|KE346361.1|	16004	16030	A	26	-	26	T
gi|514486271|gb|KE346361.1|	16072	16087	AACGC	15	+	3	CAACG
gi|514486271|gb|KE346361.1|	16239	16252	ATC	13	-	4	TGA
gi|514486271|gb|KE346361.1|	16300	16314	ACCAGC	14	+	2	CACCAG
gi|514486271|gb|KE346361.1|	16456	16472	ACGAGG	16	-	2	CCTCGT
gi|514486271|gb|KE346361.1|	16524	16537	ACTGGC	13	+	2	CACTGG
gi|514486271|gb|KE346361.1|	16871	16883	ATGCC	12	-	2	ATGGC
gi|514486271|gb|KE346361.1|	17094	17107	A	13	-	13	T
gi|514486271|gb|KE346361.1|	17781	17795	ATCGCC	14	+	2	CGCCAT
gi|514486271|gb|KE346361.1|	17801	17856	AGG	55	-	18	CCT
gi|514486271|gb|KE346361.1|	19893	19905	AAAAC	12	-	2	GTTTT
gi|514486271|gb|KE346361.1|	19939	19954	AAAC	15	-	3	TTTG
gi|514486271|gb|KE346361.1|	19951	19970	A	19	-	19	T
gi|514486271|gb|KE346361.1|	20024	20040	AAAAC	16	-	3	TTGTT
gi|514486271|gb|KE346361.1|	21083	21233	AAAC	150	-	37	TTTG
gi|514486271|gb|KE346361.1|	21248	21319	AAAC	71	-	17	TTGT
gi|514486271|gb|KE346361.1|	21703	21725	AAAC	22	-	5	GTTT
gi|514486271|gb|KE346361.1|	21727	21739	C	12	-	12	G
gi|514486271|gb|KE346361.1|	21774	21790	ACAG	16	-	4	CTGT
gi|514486271|gb|KE346361.1|	22101	22128	AAGTC	27	-	5	CTTGA
gi|514486271|gb|KE346361.1|	22878	22983	AAC	105	-	35	GTT
gi|514486271|gb|KE346361.1|	23475	23488	AGATGC	13	+	2	ATGCAG
gi|514486271|gb|KE346361.1|	23709	23721	ACCATG	12	-	2	TGGTCA
gi|514486271|gb|KE346361.1|	24593	24606	A	13	+	13	A
gi|514486271|gb|KE346361.1|	24625	24646	A	21	+	21	A
gi|514486271|gb|KE346361.1|	24762	24782	A	20	+	20	A
gi|514486271|gb|KE346361.1|	25441	25453	AATATT	12	+	2	AATATT
gi|514486271|gb|KE346361.1|	26238	26257	AG	19	-	9	TC
gi|514486271|gb|KE346361.1|	26267	26286	AG	19	-	9	TC
gi|514486271|gb|KE346361.1|	26319	26331	AAAAG	12	-	2	TTCTT
gi|514486271|gb|KE346361.1|	26508	26601	AG	93	-	46	TC
gi|514486271|gb|KE346361.1|	26728	26745	AACTCC	17	+	2	ACTCCA
gi|514486271|gb|KE346361.1|	26892	26904	AC	12	+	6	AC
gi|514486271|gb|KE346361.1|	28578	28591	AAAAC	13	+	2	AAAAC
gi|514486271|gb|KE346361.1|	28585	28604	AAAC	19	+	4	AACA
gi|514486271|gb|KE346361.1|	29006	29027	ATC	21	-	7	TGA
gi|514486271|gb|KE346361.1|	29186	29206	AGCCAT	20	-	3	CTATGG
gi|514486271|gb|KE346361.1|	29201	29218	ACAGCC	17	-	2	TGGCTG
gi|514486271|gb|KE346361.1|	29422	29442	AAC	20	+	6	AAC
gi|514486271|gb|KE346361.1|	29443	29456	A	13	+	13	A
gi|514486271|gb|KE346361.1|	29560	29574	ACTC	14	-	3	AGTG
gi|514486271|gb|KE346361.1|	29650	29668	AAGTAG	18	+	3	AGAAGT
gi|514486271|gb|KE346361.1|	29729	29754	AG	25	+	12	GA
gi|514486271|gb|KE346361.1|	29900	29919	AAG	19	-	6	CTT
gi|514486271|gb|KE346361.1|	29920	29936	AAG	16	-	5	TCT
gi|514486271|gb|KE346361.1|	30324	30337	ACTGGG	13	+	2	GGACTG
gi|514486271|gb|KE346361.1|	30600	30623	ACAGAG	23	+	3	AGAGAC
gi|514486271|gb|KE346361.1|	30926	30938	AAGAG	12	-	2	CTTCT
gi|514486271|gb|KE346361.1|	33324	33336	AGC	12	+	4	GCA
gi|514486271|gb|KE346361.1|	33511	33523	ATCC	12	+	3	TCCA
gi|514486271|gb|KE346361.1|	33563	33575	AAACAC	12	-	2	TTGTGT
gi|514486271|gb|KE346361.1|	33570	33627	AC	57	-	28	TG
gi|514486271|gb|KE346361.1|	33893	33905	A	12	+	12	A
gi|514486271|gb|KE346361.1|	34326	34341	ATC	15	-	5	TGA
gi|514486271|gb|KE346361.1|	35004	35036	AAAC	32	-	8	TGTT
gi|514486271|gb|KE346361.1|	36395	36407	ACGTAG	12	+	2	GACGTA
gi|514486271|gb|KE346361.1|	36687	36699	AGCCG	12	+	2	GCCGA
gi|514486271|gb|KE346361.1|	36882	36895	ACC	13	-	4	GTG
gi|514486271|gb|KE346361.1|	37996	38009	ACG	13	+	4	ACG
gi|514486271|gb|KE346361.1|	38010	38022	ACG	12	+	4	GAC
gi|514486271|gb|KE346361.1|	38079	38097	AGGATC	18	-	3	GATCCT
gi|514486271|gb|KE346361.1|	38099	38115	AGGATC	16	-	2	TCCTGA
gi|514486271|gb|KE346361.1|	38117	38133	AGGATC	16	-	2	TCCTGA
gi|514486271|gb|KE346361.1|	38141	38158	ACCAGG	17	-	2	TCCTGG
gi|514486271|gb|KE346361.1|	38622	38638	A	16	+	16	A
gi|514486271|gb|KE346361.1|	38656	38674	AG	18	-	9	TC
gi|514486271|gb|KE346361.1|	38987	39002	AATAG	15	+	3	GAATA
gi|514486271|gb|KE346361.1|	39126	39139	ACAGC	13	+	2	CACAG
gi|514486271|gb|KE346361.1|	39357	39370	AAG	13	-	4	CTT
gi|514486271|gb|KE346361.1|	39587	39608	ATC	21	-	7	ATG
gi|514486271|gb|KE346361.1|	39624	39640	ATC	16	+	5	ATC
gi|514486271|gb|KE346361.1|	39683	39695	ACTGCC	12	+	2	CACTGC
gi|514486271|gb|KE346361.1|	39992	40004	AAACTC	12	+	2	TCAAAC
gi|514486271|gb|KE346361.1|	40294	40307	A	13	-	13	T
gi|514486271|gb|KE346361.1|	41111	41127	AC	16	-	8	TG
gi|514486271|gb|KE346361.1|	42132	42148	AAAAAG	16	-	2	TTTTCT
gi|514486271|gb|KE346361.1|	42384	42405	AG	21	+	10	GA
gi|514486271|gb|KE346361.1|	42497	42513	ACTC	16	-	4	GAGT
gi|514486271|gb|KE346361.1|	42591	42614	AG	23	-	11	CT
gi|514486271|gb|KE346361.1|	42619	42637	AG	18	-	9	CT
gi|514486271|gb|KE346361.1|	42634	42649	AAGCAG	15	-	2	TCTGCT
gi|514486271|gb|KE346361.1|	42680	42693	ACTC	13	+	3	TCAC
gi|514486271|gb|KE346361.1|	43271	43284	A	13	-	13	T
gi|514486271|gb|KE346361.1|	43286	43299	CCCCG	13	-	2	GGGGC
gi|514486271|gb|KE346361.1|	43527	43540	AAGCAG	13	-	2	TGCTTC
gi|514486271|gb|KE346361.1|	43963	43978	AAAAC	15	-	3	TTTTG
gi|514486271|gb|KE346361.1|	44021	44037	A	16	-	16	T
gi|514486271|gb|KE346361.1|	44361	44373	AAAAAC	12	-	2	GTTTTT
gi|514486271|gb|KE346361.1|	44618	44639	AAG	21	-	7	TCT
gi|514486271|gb|KE346361.1|	44778	44800	AGCCTC	22	+	3	CAGCCT
gi|514486271|gb|KE346361.1|	45056	45068	AACG	12	-	3	TTCG
gi|514486271|gb|KE346361.1|	45762	45775	AG	13	-	6	CT
gi|514486271|gb|KE346361.1|	48333	48348	AGC	15	-	5	GCT
gi|514486271|gb|KE346361.1|	48479	48495	AGC	16	+	5	GCA
gi|514486271|gb|KE346361.1|	48579	48592	ATC	13	+	4	TCA
gi|514486271|gb|KE346361.1|	48874	48889	AGGG	15	+	3	GAGG
gi|514486271|gb|KE346361.1|	48898	48921	A	23	+	23	A
gi|514486271|gb|KE346361.1|	49475	49491	A	16	-	16	T
gi|514486271|gb|KE346361.1|	49488	49500	AAAC	12	-	3	TTTG
gi|514486271|gb|KE346361.1|	49859	49873	A	14	-	14	T
gi|514486271|gb|KE346361.1|	50188	50200	A	12	+	12	A
gi|514486271|gb|KE346361.1|	50213	50229	A	16	+	16	A
gi|514486271|gb|KE346361.1|	50404	50419	A	15	+	15	A
gi|514486271|gb|KE346361.1|	50626	50641	A	15	+	15	A
gi|514486271|gb|KE346361.1|	51041	51060	AG	19	+	9	GA
gi|514486271|gb|KE346361.1|	51445	51467	A	22	+	22	A
gi|514486271|gb|KE346361.1|	51504	51516	AAAAT	12	+	2	AATAA
gi|514486271|gb|KE346361.1|	51583	51596	AAGG	13	+	3	GAAG
gi|514486271|gb|KE346361.1|	51616	51629	AGC	13	+	4	CAG
gi|514486271|gb|KE346361.1|	51928	51944	AAAAAT	16	+	2	AATAAA
gi|514486271|gb|KE346361.1|	52007	52019	AATGTC	12	-	2	TGACAT
gi|514486271|gb|KE346361.1|	52128	52140	AAAAT	12	-	2	TTTTA
gi|514486271|gb|KE346361.1|	52141	52154	AAAAT	13	-	2	TTTAT
gi|514486271|gb|KE346361.1|	52603	52621	A	18	-	18	T
gi|514486271|gb|KE346361.1|	52815	52836	A	21	+	21	A
gi|514486271|gb|KE346361.1|	53939	53952	AGC	13	-	4	GCT
gi|514486271|gb|KE346361.1|	53950	53965	AAC	15	-	5	TGT
gi|514486271|gb|KE346361.1|	53986	54000	AGC	14	-	4	TGC
gi|514486271|gb|KE346361.1|	56670	56683	AGATGG	13	+	2	ATGGAG
gi|514486271|gb|KE346361.1|	56976	56988	ACTGGC	12	+	2	GGCACT
gi|514486271|gb|KE346361.1|	57101	57113	AGATGC	12	+	2	GATGCA
gi|514486271|gb|KE346361.1|	57254	57266	AGC	12	+	4	AGC
gi|514486271|gb|KE346361.1|	58448	58472	AAC	24	+	8	CAA
gi|514486271|gb|KE346361.1|	59216	59228	AGGGGG	12	-	2	TCCCCC
gi|514486271|gb|KE346361.1|	59282	59305	A	23	-	23	T
gi|514486271|gb|KE346361.1|	59510	59538	AGC	28	-	9	GCT
gi|514486271|gb|KE346361.1|	60413	60428	ACGGAG	15	+	2	GACGGA
gi|514486271|gb|KE346361.1|	60918	60931	AAGGAG	13	+	2	GAAGGA
gi|514486271|gb|KE346361.1|	62117	62129	AAAAC	12	+	2	AAACA
gi|514486271|gb|KE346361.1|	63520	63533	AAACAG	13	-	2	TTTCTG
gi|514486271|gb|KE346361.1|	65863	65875	AAAC	12	+	3	CAAA
gi|514486271|gb|KE346361.1|	67124	67136	AAATGG	12	+	2	ATGGAA
gi|514486271|gb|KE346361.1|	67193	67207	AAC	14	+	4	ACA
gi|514486271|gb|KE346361.1|	67291	67303	AAAAGG	12	+	2	GAAAAG
gi|514486271|gb|KE346361.1|	67391	67411	A	20	+	20	A
gi|514486271|gb|KE346361.1|	67628	67640	AAAAG	12	+	2	AAGAA
gi|514486271|gb|KE346361.1|	67826	67838	AACAGC	12	-	2	GCTGTT
gi|514486271|gb|KE346361.1|	69561	69577	AAGAGG	16	+	2	GAGGAA
gi|514486271|gb|KE346361.1|	70129	70144	A	15	+	15	A
gi|514486271|gb|KE346361.1|	70208	70234	ACG	26	+	8	GAC
gi|514486271|gb|KE346361.1|	70336	70353	ACGCTG	17	+	2	TGACGC
gi|514486271|gb|KE346361.1|	70668	70692	A	24	-	24	T
gi|514486271|gb|KE346361.1|	71077	71092	A	15	+	15	A
gi|514486271|gb|KE346361.1|	71088	71102	AAAAG	14	+	2	AAAAG
gi|514486271|gb|KE346361.1|	71237	71250	AAAAAC	13	+	2	ACAAAA
gi|514486271|gb|KE346361.1|	71269	71281	A	12	+	12	A
gi|514486271|gb|KE346361.1|	71377	71401	AAGGG	24	+	4	AGGGA
gi|514486271|gb|KE346361.1|	71540	71553	A	13	+	13	A
gi|514486271|gb|KE346361.1|	71609	71626	A	17	+	17	A
gi|514486271|gb|KE346361.1|	71695	71728	AAACG	33	+	6	GAAAC
gi|514486271|gb|KE346361.1|	72175	72188	AATGCT	13	+	2	AATGCT
gi|514486271|gb|KE346361.1|	72197	72213	AGC	16	+	5	CAG
gi|514486271|gb|KE346361.1|	72436	72450	AGCGGC	14	-	2	CCGCTG
gi|514486271|gb|KE346361.1|	72660	72686	AGC	26	+	8	AGC
gi|514486271|gb|KE346361.1|	72774	72791	ATC	17	-	5	GAT
gi|514486271|gb|KE346361.1|	73071	73083	AATGAG	12	-	2	TCATTC
gi|514486271|gb|KE346361.1|	73135	73147	AACTGG	12	-	2	CAGTTC
gi|514486271|gb|KE346361.1|	73304	73322	ACAGGC	18	+	3	GCACAG
gi|514486271|gb|KE346361.1|	73432	73444	AGC	12	-	4	TGC
gi|514486271|gb|KE346361.1|	73993	74011	AAAC	18	-	4	TTTG
gi|514486271|gb|KE346361.1|	74453	74465	ACCGGC	12	-	2	GCCGGT
gi|514486271|gb|KE346361.1|	75223	75237	AAAAAC	14	-	2	TTTTGT
gi|514486271|gb|KE346361.1|	75234	75246	AAAAC	12	-	2	TTTGT
gi|514486271|gb|KE346361.1|	75251	75278	AC	27	-	13	TG
gi|514486271|gb|KE346361.1|	75277	75292	A	15	-	15	T
gi|514486271|gb|KE346361.1|	75544	75556	AAGGAG	12	+	2	GAAGGA
gi|514486271|gb|KE346361.1|	75570	75582	AAAAC	12	+	2	AAAAC
gi|514486271|gb|KE346361.1|	75672	75687	AGGGCG	15	+	2	GGCGAG
gi|514486271|gb|KE346361.1|	77579	77596	AAAC	17	+	4	AACA
gi|514486271|gb|KE346361.1|	77591	77611	AAC	20	+	6	AAC
gi|514486271|gb|KE346361.1|	77609	77622	A	13	+	13	A
gi|514486271|gb|KE346361.1|	78318	78335	AAAAAT	17	+	2	AAAAAT
gi|514486271|gb|KE346361.1|	78537	78559	A	22	+	22	A
gi|514486271|gb|KE346361.1|	78919	78932	AGCGCG	13	+	2	GAGCGC
gi|514486271|gb|KE346361.1|	79091	79104	ACGATG	13	+	2	GACGAT
gi|514486271|gb|KE346361.1|	79149	79161	AAAG	12	+	3	AAAG
gi|514486271|gb|KE346361.1|	79162	79185	A	23	+	23	A
gi|514486271|gb|KE346361.1|	79342	79361	ACTC	19	+	4	CTCA
gi|514486271|gb|KE346361.1|	79649	79662	ACGGCG	13	+	2	CGGCGA
gi|514486271|gb|KE346361.1|	79767	79779	ACCCCG	12	-	2	CGGGGT
gi|514486271|gb|KE346361.1|	80352	80364	ACGCCC	12	-	2	TGGGCG
gi|514486271|gb|KE346361.1|	80758	80781	AGC	23	+	7	CAG
gi|514486271|gb|KE346361.1|	81478	81499	AGAGGC	21	-	3	GCCTCT
gi|514486271|gb|KE346361.1|	81500	81529	AGAGGC	29	-	4	CTGCCT
gi|514486271|gb|KE346361.1|	81565	81577	AGAGCG	12	-	2	CGCTCT
gi|514486271|gb|KE346361.1|	82254	82266	ACG	12	+	4	CGA
gi|514486271|gb|KE346361.1|	82622	82635	ACGCGC	13	-	2	GCGTGC
gi|514486271|gb|KE346361.1|	82665	82677	ATCCGC	12	-	2	GGATGC
gi|514486271|gb|KE346361.1|	82742	82754	AAC	12	+	4	ACA
gi|514486271|gb|KE346361.1|	82763	82775	AAC	12	+	4	ACA
gi|514486271|gb|KE346361.1|	83812	83826	ATC	14	-	4	TGA
gi|514486271|gb|KE346361.1|	83824	83839	AAC	15	-	5	TGT
gi|514486271|gb|KE346361.1|	84233	84245	ACTC	12	-	3	GTGA
gi|514486271|gb|KE346361.1|	84626	84639	AGCGCG	13	-	2	GCGCTC
gi|514486271|gb|KE346361.1|	85262	85274	ACTGCG	12	+	2	GCGACT
gi|514486271|gb|KE346361.1|	85427	85439	AAACAT	12	+	2	CATAAA
gi|514486271|gb|KE346361.1|	85796	85810	AGGCGC	14	-	2	GCGCCT
gi|514486271|gb|KE346361.1|	86136	86148	ACAGAG	12	+	2	AGACAG
gi|514486271|gb|KE346361.1|	86185	86197	AACACC	12	+	2	AACACC
gi|514486271|gb|KE346361.1|	86338	86351	AAAAAG	13	+	2	AAAGAA
gi|514486271|gb|KE346361.1|	87312	87325	AG	13	-	6	CT
gi|514486271|gb|KE346361.1|	88292	88305	AGCTGC	13	+	2	GCAGCT
gi|514486271|gb|KE346361.1|	89661	89674	CCGCG	13	-	2	GCGGC
gi|514486271|gb|KE346361.1|	89943	89957	AGC	14	+	4	GCA
gi|514486271|gb|KE346361.1|	90120	90136	AGGCCG	16	-	2	GCCTCG
gi|514486271|gb|KE346361.1|	91022	91035	ACTGG	13	-	2	GTCCA
gi|514486271|gb|KE346361.1|	91313	91326	ACGAGG	13	+	2	GGACGA
gi|514486271|gb|KE346361.1|	91385	91425	ATC	40	+	13	CAT
gi|514486271|gb|KE346361.1|	91608	91626	AAC	18	+	6	CAA
gi|514486271|gb|KE346361.1|	91667	91680	AAAACC	13	+	2	CCAAAA
gi|514486271|gb|KE346361.1|	91680	91692	AAAAAC	12	+	2	ACAAAA
gi|514486271|gb|KE346361.1|	91686	91698	AAAAC	12	+	2	ACAAA
gi|514486271|gb|KE346361.1|	91806	91819	AAGCTC	13	+	2	CTCAAG
gi|514486271|gb|KE346361.1|	91888	91907	AAAC	19	-	4	GTTT
gi|514486271|gb|KE346361.1|	91913	91925	AAACC	12	-	2	TTTGG
gi|514486271|gb|KE346361.1|	92195	92211	AC	16	+	8	CA
gi|514486271|gb|KE346361.1|	92229	92241	AGATGG	12	-	2	CATCTC
gi|514486271|gb|KE346361.1|	92360	92379	ACCCT	19	+	3	CCCTA
gi|514486271|gb|KE346361.1|	92687	92704	A	17	+	17	A
gi|514486271|gb|KE346361.1|	92854	92879	A	25	+	25	A
gi|514486271|gb|KE346361.1|	93083	93107	A	24	+	24	A
gi|514486271|gb|KE346361.1|	93312	93324	AAGCTC	12	-	2	TTGAGC
gi|514486271|gb|KE346361.1|	93457	93470	A	13	+	13	A
gi|514486271|gb|KE346361.1|	93516	93528	AAC	12	-	4	TTG
gi|514486271|gb|KE346361.1|	94439	94452	ACG	13	-	4	CGT
gi|514486271|gb|KE346361.1|	94474	94488	ATC	14	+	4	TCA
gi|514486271|gb|KE346361.1|	94486	94503	ACG	17	-	5	TCG
gi|514486271|gb|KE346361.1|	95571	95584	ACCGCC	13	-	2	GGCGGT
gi|514486271|gb|KE346361.1|	95896	95921	ACGGCG	25	-	4	CGTCGC
gi|514486271|gb|KE346361.1|	96033	96047	AC	14	-	7	TG
gi|514486271|gb|KE346361.1|	96073	96085	ACAGTC	12	-	2	ACTGTG
gi|514486271|gb|KE346361.1|	96089	96103	AAGCTC	14	-	2	GCTTGA
gi|514486271|gb|KE346361.1|	96137	96152	AGC	15	-	5	GCT
gi|514486271|gb|KE346361.1|	96670	96682	AAATAG	12	+	2	AATAGA
gi|514486271|gb|KE346361.1|	97098	97110	AAGTG	12	+	2	AAGTG
gi|514486271|gb|KE346361.1|	97179	97210	A	31	-	31	T
gi|514486271|gb|KE346361.1|	97517	97536	AGC	19	+	6	AGC
gi|514486271|gb|KE346361.1|	97596	97608	AAGGAC	12	+	2	GGACAA
gi|514486271|gb|KE346361.1|	97721	97733	AATCC	12	+	2	CAATC
gi|514486271|gb|KE346361.1|	97831	97843	AAGGCC	12	+	2	CAAGGC
gi|514486271|gb|KE346361.1|	98260	98274	AAAAAG	14	-	2	TTTCTT
gi|514486271|gb|KE346361.1|	98664	98680	A	16	-	16	T
gi|514486271|gb|KE346361.1|	98681	98695	A	14	-	14	T
gi|514486271|gb|KE346361.1|	98692	98707	AAAC	15	-	3	TTTG
gi|514486271|gb|KE346361.1|	98814	98826	ATCGGC	12	-	2	GATGCC
gi|514486271|gb|KE346361.1|	98982	98994	ACACGC	12	-	2	GTGTGC
gi|514486271|gb|KE346361.1|	99020	99032	AAC	12	-	4	TTG
gi|514486271|gb|KE346361.1|	100676	100688	ACGATG	12	-	2	TCATCG
gi|514486271|gb|KE346361.1|	101161	101174	AAAAAG	13	-	2	TTTTTC
gi|514486271|gb|KE346361.1|	101702	101714	AAACGT	12	-	2	GTTTAC
gi|514486271|gb|KE346361.1|	101753	101765	AGCTGC	12	+	2	AGCTGC
gi|514486271|gb|KE346361.1|	101770	101798	AGC	28	-	9	CTG
gi|514486271|gb|KE346361.1|	101805	101820	ACTGCT	15	+	2	GCTACT
gi|514486271|gb|KE346361.1|	102758	102770	AGAGGC	12	-	2	CCTCTG
gi|514486271|gb|KE346361.1|	102771	102785	AGAGGC	14	-	2	CTCTGC
gi|514486271|gb|KE346361.1|	103202	103216	AAGGC	14	+	2	AAGGC
gi|514486271|gb|KE346361.1|	103338	103352	AACTG	14	-	2	TCAGT
gi|514486271|gb|KE346361.1|	103376	103390	AAAACG	14	-	2	TTTTCG
gi|514486271|gb|KE346361.1|	103406	103429	A	23	-	23	T
gi|514486271|gb|KE346361.1|	103465	103485	A	20	-	20	T
gi|514486271|gb|KE346361.1|	103509	103526	AAG	17	-	5	TTC
gi|514486271|gb|KE346361.1|	103897	103909	ACGCGG	12	-	2	CGCGTC
gi|514486271|gb|KE346361.1|	104244	104258	AGCCTC	14	-	2	GAGGCT
gi|514486271|gb|KE346361.1|	104290	104302	AAATGC	12	-	2	TTTGCA
gi|514486271|gb|KE346361.1|	104353	104367	AAAAGC	14	+	2	AAGCAA
gi|514486271|gb|KE346361.1|	104443	104460	ATCC	17	-	4	TGGA
gi|514486271|gb|KE346361.1|	104660	104677	AG	17	-	8	CT
gi|514486271|gb|KE346361.1|	105095	105145	AG	50	-	25	CT
gi|514486271|gb|KE346361.1|	105198	105210	AGAGCC	12	+	2	CCAGAG
gi|514486271|gb|KE346361.1|	105228	105240	AG	12	+	6	AG
gi|514486271|gb|KE346361.1|	105249	105262	ACTCTC	13	-	2	GAGTGA
gi|514486271|gb|KE346361.1|	105334	105349	AAGGG	15	-	3	CCCTT
gi|514486271|gb|KE346361.1|	105411	105437	AAC	26	-	8	TTG
gi|514486271|gb|KE346361.1|	105438	105456	AAAC	18	-	4	GTTT
gi|514486271|gb|KE346361.1|	105536	105553	ACAGC	17	+	3	AGCAC
gi|514486271|gb|KE346361.1|	105815	105828	ACCAGC	13	-	2	CTGGTG
gi|514486271|gb|KE346361.1|	105829	105843	ACCAGC	14	-	2	GGTGCT
gi|514486271|gb|KE346361.1|	106033	106045	AGC	12	+	4	GCA
gi|514486271|gb|KE346361.1|	106047	106065	AGCGGC	18	+	3	GGCAGC
gi|514486271|gb|KE346361.1|	106171	106194	AGC	23	+	7	CAG
gi|514486271|gb|KE346361.1|	106189	106206	AACAGC	17	+	2	CAGCAA
gi|514486271|gb|KE346361.1|	106217	106242	AGC	25	+	8	CAG
gi|514486271|gb|KE346361.1|	106471	106485	AGC	14	+	4	GCA
gi|514486271|gb|KE346361.1|	106524	106548	AGCATC	24	+	4	GCATCA
gi|514486271|gb|KE346361.1|	106721	106735	CCG	14	-	4	CGG
gi|514486271|gb|KE346361.1|	106991	107003	AGC	12	-	4	CTG
gi|514486271|gb|KE346361.1|	107011	107034	ACC	23	-	7	GGT
gi|514486271|gb|KE346361.1|	108196	108208	AACTTC	12	+	2	CAACTT
gi|514486271|gb|KE346361.1|	108526	108539	AAAAC	13	-	2	GTTTT
gi|514486271|gb|KE346361.1|	108551	108563	AAAAAC	12	-	2	TTTTTG
gi|514486271|gb|KE346361.1|	108961	108996	AAAC	35	-	8	TGTT
gi|514486271|gb|KE346361.1|	109743	109758	AAAC	15	+	3	ACAA
gi|514486271|gb|KE346361.1|	109811	109824	AAC	13	+	4	ACA
gi|514486271|gb|KE346361.1|	110005	110018	AAGCC	13	+	2	CCAAG
gi|514486271|gb|KE346361.1|	110497	110535	AAC	38	+	12	ACA
gi|514486271|gb|KE346361.1|	110757	110771	AATGCC	14	+	2	GCCAAT
gi|514486271|gb|KE346361.1|	111985	112001	AAAAAC	16	+	2	AAAAAC
gi|514486271|gb|KE346361.1|	112957	112970	ACGAGG	13	+	2	GACGAG
gi|514486271|gb|KE346361.1|	113121	113148	A	27	+	27	A
gi|514486271|gb|KE346361.1|	113186	113202	A	16	-	16	T
gi|514486271|gb|KE346361.1|	113824	113837	ACTCTC	13	+	2	CTCACT
gi|514486271|gb|KE346361.1|	115143	115156	AAAC	13	-	3	TGTT
gi|514486271|gb|KE346361.1|	115154	115166	AAAC	12	-	3	TTTG
gi|514486271|gb|KE346361.1|	115170	115182	AAAAC	12	-	2	TTTGT
gi|514486271|gb|KE346361.1|	115195	115210	AAAC	15	-	3	TTTG
gi|514486271|gb|KE346361.1|	115687	115699	AAAC	12	-	3	TTTG
gi|514486271|gb|KE346361.1|	115704	115718	AAAC	14	-	3	TTTG
gi|514486271|gb|KE346361.1|	116277	116307	AG	30	+	15	GA
gi|514486271|gb|KE346361.1|	116378	116390	ATCGCC	12	-	2	TGGCGA
gi|514486271|gb|KE346361.1|	117792	117805	AACTTG	13	+	2	GAACTT
gi|514486271|gb|KE346361.1|	117936	117949	AAATC	13	+	2	AAATC
gi|514486271|gb|KE346361.1|	118300	118313	AATTAC	13	+	2	ACAATT
gi|514486271|gb|KE346361.1|	120896	120909	AAGCAC	13	+	2	AAGCAC
gi|514486271|gb|KE346361.1|	121144	121156	CCG	12	+	4	CGC
gi|514486271|gb|KE346361.1|	121642	121655	AAAAAG	13	-	2	TTTCTT
gi|514486271|gb|KE346361.1|	121656	121671	A	15	-	15	T
gi|514486271|gb|KE346361.1|	122039	122053	AAACGC	14	-	2	GCGTTT
gi|514486271|gb|KE346361.1|	124891	124910	A	19	-	19	T
gi|514486271|gb|KE346361.1|	124962	124974	ACTC	12	+	3	CACT
gi|514486271|gb|KE346361.1|	125547	125561	A	14	-	14	T
gi|514486271|gb|KE346361.1|	126316	126328	AAAC	12	-	3	TTTG
gi|514486271|gb|KE346361.1|	127308	127323	A	15	+	15	A
gi|514486271|gb|KE346361.1|	127624	127636	AAAAC	12	+	2	AAAAC
gi|514486271|gb|KE346361.1|	128063	128076	AGC	13	+	4	GCA
gi|514486271|gb|KE346361.1|	129622	129634	ACGATG	12	-	2	ATCGTC
gi|514486271|gb|KE346361.1|	129993	130005	AGGGGC	12	+	2	GGGCAG
gi|514486271|gb|KE346361.1|	130064	130080	ACCTGC	16	-	2	GCAGGT
gi|514486271|gb|KE346361.1|	130117	130131	AGCCGC	14	+	2	CGCAGC
gi|514486271|gb|KE346361.1|	130466	130478	AAC	12	-	4	TTG
gi|514486271|gb|KE346361.1|	130485	130502	AGC	17	-	5	TGC
gi|514486271|gb|KE346361.1|	130525	130538	AACAGC	13	-	2	GTTGCT
gi|514486271|gb|KE346361.1|	130533	130559	AGC	26	-	8	TGC
gi|514486271|gb|KE346361.1|	130554	130571	AACAGC	17	-	2	TGCTGT
gi|514486271|gb|KE346361.1|	130569	130585	AACAGC	16	-	2	TGCTGT
gi|514486271|gb|KE346361.1|	131051	131065	AGCAGG	14	+	2	AGCAGG
gi|514486271|gb|KE346361.1|	131563	131578	AGGCGC	15	+	2	CAGGCG
gi|514486271|gb|KE346361.1|	131618	131645	AGC	27	-	9	CTG
gi|514486271|gb|KE346361.1|	131805	131819	AACAGC	14	-	2	TGTTGC
gi|514486271|gb|KE346361.1|	131829	131844	AACAGC	15	-	2	TGCTGT
gi|514486271|gb|KE346361.1|	132086	132100	AAT	14	-	4	TTA
gi|514486271|gb|KE346361.1|	132518	132530	AATGCT	12	-	2	AGCATT
gi|514486271|gb|KE346361.1|	134812	134827	AAT	15	-	5	ATT
gi|514486271|gb|KE346361.1|	134837	134850	A	13	-	13	T
gi|514486271|gb|KE346361.1|	134872	134897	A	25	-	25	T
gi|514486271|gb|KE346361.1|	134971	134991	AG	20	-	10	TC
gi|514486271|gb|KE346361.1|	135010	135022	C	12	+	12	C
gi|514486271|gb|KE346361.1|	135125	135138	AAATGC	13	-	2	TTGCAT
gi|514486271|gb|KE346361.1|	135255	135276	ATC	21	+	7	TCA
gi|514486271|gb|KE346361.1|	135354	135366	AAAAAG	12	-	2	TTTTTC
gi|514486271|gb|KE346361.1|	135434	135446	AAGGC	12	-	2	TTGCC
gi|514486271|gb|KE346361.1|	135527	135539	A	12	-	12	T
gi|514486271|gb|KE346361.1|	135722	135746	A	24	+	24	A
gi|514486271|gb|KE346361.1|	135800	135812	ATCC	12	-	3	TGGA
gi|514486271|gb|KE346361.1|	135908	135921	AACTG	13	+	2	CTGAA
gi|514486271|gb|KE346361.1|	135962	135977	ACC	15	+	5	CAC
gi|514486271|gb|KE346361.1|	136650	136700	AG	50	-	25	CT
gi|514486271|gb|KE346361.1|	139430	139447	AAAAC	17	-	3	TTTTG
gi|514486271|gb|KE346361.1|	139445	139457	AATCAC	12	-	2	TTGTGA
gi|514486271|gb|KE346361.1|	139508	139520	AATGCC	12	-	2	GCATTG
gi|514486271|gb|KE346361.1|	139532	139546	AGCGCG	14	-	2	TCGCGC
gi|514486271|gb|KE346361.1|	140591	140616	AGC	25	-	8	TGC
gi|514486271|gb|KE346361.1|	140983	140995	AAAGAC	12	+	2	CAAAGA
gi|514486271|gb|KE346361.1|	142225	142246	A	21	-	21	T
gi|514486271|gb|KE346361.1|	142472	142484	AAAAAC	12	-	2	TTGTTT
gi|514486271|gb|KE346361.1|	142478	142491	AAAC	13	-	3	TTGT
gi|514486271|gb|KE346361.1|	142623	142648	A	25	+	25	A
gi|514486271|gb|KE346361.1|	142750	142762	AAAAG	12	-	2	TTTTC
gi|514486271|gb|KE346361.1|	143025	143062	A	37	-	37	T
gi|514486271|gb|KE346361.1|	143406	143421	AATG	15	+	3	TGAA
gi|514486271|gb|KE346361.1|	143427	143450	AG	23	+	11	GA
gi|514486271|gb|KE346361.1|	143848	143861	AAGGG	13	-	2	CCCTT
gi|514486271|gb|KE346361.1|	143855	143867	AAGGGG	12	-	2	CTTCCC
gi|514486271|gb|KE346361.1|	143969	143989	A	20	-	20	T
gi|514486271|gb|KE346361.1|	143992	144006	AAAAAC	14	-	2	TTTTTG
gi|514486271|gb|KE346361.1|	144111	144126	AC	15	-	7	GT
gi|514486271|gb|KE346361.1|	144270	144286	AG	16	-	8	CT
gi|514486271|gb|KE346361.1|	144594	144610	AAC	16	+	5	CAA
gi|514486271|gb|KE346361.1|	144605	144622	AACGAC	17	+	2	ACAACG
gi|514486271|gb|KE346361.1|	144686	144703	AGCGGC	17	-	2	GCTGCC
gi|514486271|gb|KE346361.1|	144698	144715	AGC	17	-	5	GCT
gi|514486271|gb|KE346361.1|	144744	144757	AGCGGC	13	-	2	CTGCCG
gi|514486271|gb|KE346361.1|	145131	145143	AAC	12	-	4	TTG
gi|514486271|gb|KE346361.1|	145768	145781	ACCGTC	13	+	2	GTCACC
gi|514486271|gb|KE346361.1|	145822	145835	AAACCC	13	-	2	GGGTTT
gi|514486271|gb|KE346361.1|	146336	146348	ACTGCC	12	+	2	CTGCCA
gi|514486271|gb|KE346361.1|	146385	146397	AGCGC	12	-	2	GCTGC
gi|514486271|gb|KE346361.1|	146551	146565	AGC	14	+	4	CAG
gi|514486271|gb|KE346361.1|	146578	146590	AAGCTG	12	-	2	CAGCTT
gi|514486271|gb|KE346361.1|	146958	146978	AC	20	-	10	GT
gi|514486271|gb|KE346361.1|	147195	147214	AAAAAC	19	+	3	ACAAAA
gi|514486271|gb|KE346361.1|	148073	148086	AAGGAC	13	-	2	GTCCTT
gi|514486271|gb|KE346361.1|	148162	148174	AAGAGC	12	-	2	TCTTGC
gi|514486271|gb|KE346361.1|	148493	148505	AGC	12	+	4	AGC
gi|514486271|gb|KE346361.1|	148875	148889	CCG	14	-	4	GCG
gi|514486271|gb|KE346361.1|	149731	149748	ACCCCT	17	-	2	GGGGTA
gi|514486271|gb|KE346361.1|	149756	149768	ACATGC	12	-	2	GTGCAT
gi|514486271|gb|KE346361.1|	150016	150028	ACTCTG	12	+	2	TGACTC
gi|514486271|gb|KE346361.1|	150053	150066	ACCC	13	+	3	CCAC
gi|514486271|gb|KE346361.1|	150069	150088	ACC	19	+	6	CAC
gi|514486271|gb|KE346361.1|	150086	150106	CCG	20	+	6	CCG
gi|514486271|gb|KE346361.1|	150163	150187	A	24	-	24	T
gi|514486271|gb|KE346361.1|	150321	150372	AAAAT	51	+	10	AATAA
gi|514486271|gb|KE346361.1|	150461	150478	ACC	17	+	5	ACC
gi|514486271|gb|KE346361.1|	150735	150747	AATTAC	12	+	2	TTACAA
gi|514486271|gb|KE346361.1|	150790	150802	AAAGCG	12	+	2	AAAGCG
gi|514486271|gb|KE346361.1|	150823	150835	A	12	-	12	T
gi|514486271|gb|KE346361.1|	151072	151084	ACG	12	-	4	TCG
gi|514486271|gb|KE346361.1|	151082	151096	CCG	14	-	4	CGG
gi|514486271|gb|KE346361.1|	151669	151688	ACG	19	+	6	GAC
gi|514486271|gb|KE346361.1|	151857	151869	AACTAC	12	-	2	GTTGTA
gi|514486271|gb|KE346361.1|	152252	152265	AGCTGC	13	+	2	CTGCAG
gi|514486271|gb|KE346361.1|	152413	152436	ACGCCG	23	-	3	GCGTCG
gi|514486271|gb|KE346361.1|	153064	153092	ACG	28	-	9	GTC
gi|514486271|gb|KE346361.1|	153276	153288	AAAGCG	12	-	2	TTCGCT
gi|514486271|gb|KE346361.1|	153545	153573	AGC	28	+	9	GCA
gi|514486271|gb|KE346361.1|	154294	154306	ACCTCC	12	-	2	GGTGGA
gi|514486271|gb|KE346361.1|	154798	154810	ACGATG	12	-	2	ATCGTC
gi|514486271|gb|KE346361.1|	154849	154867	ACC	18	-	6	GGT
gi|514486271|gb|KE346361.1|	155467	155480	ACGCAG	13	+	2	CGCAGA
gi|514486271|gb|KE346361.1|	155776	155788	ACAGAG	12	+	2	GACAGA
gi|514486271|gb|KE346361.1|	156065	156078	AGATCG	13	+	2	TCGAGA
gi|514486271|gb|KE346361.1|	156500	156512	AAAAAC	12	-	2	TTTTTG
gi|514486271|gb|KE346361.1|	156514	156529	A	15	-	15	T
gi|514486271|gb|KE346361.1|	156740	156752	AAGTGC	12	+	2	TGCAAG
gi|514486271|gb|KE346361.1|	156789	156803	ACTGCG	14	-	2	GTCGCA
gi|514486271|gb|KE346361.1|	156875	156896	A	21	-	21	T
gi|514486271|gb|KE346361.1|	156905	156917	AAATTG	12	+	2	ATTGAA
gi|514486271|gb|KE346361.1|	157255	157268	A	13	+	13	A
gi|514486271|gb|KE346361.1|	157348	157360	AAC	12	+	4	CAA
gi|514486271|gb|KE346361.1|	158486	158499	AAAAAC	13	-	2	TTGTTT
gi|514486271|gb|KE346361.1|	158815	158827	ACCAGC	12	-	2	CTGGTG
gi|514486271|gb|KE346361.1|	159519	159532	AAGCGC	13	-	2	CTTGCG
gi|514486271|gb|KE346361.1|	159854	159866	AACGAC	12	-	2	TGTCGT
gi|514486271|gb|KE346361.1|	160444	160460	AAC	16	-	5	TGT
gi|514486271|gb|KE346361.1|	160678	160693	AAC	15	-	5	TTG
gi|514486271|gb|KE346361.1|	160845	160857	AAAGG	12	+	2	GGAAA
gi|514486271|gb|KE346361.1|	160851	160863	AAAGGG	12	+	2	GAAAGG
gi|514486271|gb|KE346361.1|	160948	160971	A	23	+	23	A
gi|514486271|gb|KE346361.1|	161130	161143	A	13	+	13	A
gi|514486271|gb|KE346361.1|	161179	161193	A	14	+	14	A
gi|514486271|gb|KE346361.1|	161234	161268	AAAAT	34	+	6	AAAAT
gi|514486271|gb|KE346361.1|	161348	161364	AC	16	+	8	CA
gi|514486271|gb|KE346361.1|	161368	161380	ACGCGC	12	+	2	CGCACG
gi|514486271|gb|KE346361.1|	161421	161436	A	15	+	15	A
gi|514486271|gb|KE346361.1|	162071	162083	AATATC	12	+	2	ATCAAT
gi|514486271|gb|KE346361.1|	162211	162223	ACGGCG	12	-	2	CGCCGT
gi|514486271|gb|KE346361.1|	162308	162323	ATC	15	-	5	ATG
gi|514486271|gb|KE346361.1|	162705	162718	AGC	13	+	4	AGC
gi|514486271|gb|KE346361.1|	163218	163230	ACGGGC	12	+	2	CACGGG
gi|514486271|gb|KE346361.1|	164535	164555	ACG	20	-	6	TCG
gi|514486271|gb|KE346361.1|	164653	164665	AATGCC	12	+	2	CAATGC
gi|514486271|gb|KE346361.1|	165552	165565	AC	13	+	6	AC
gi|514486271|gb|KE346361.1|	166416	166429	AGC	13	+	4	GCA
gi|514486271|gb|KE346361.1|	166424	166438	AGCAGG	14	+	2	AGCAGG
gi|514486271|gb|KE346361.1|	166453	166470	ACAGAG	17	+	2	CAGAGA
gi|514486271|gb|KE346361.1|	166665	166693	AAG	28	+	9	AAG
gi|514486271|gb|KE346361.1|	166688	166707	AAGACG	19	+	3	GAAGAC
gi|514486271|gb|KE346361.1|	166709	166721	AAGG	12	+	3	GAAG
gi|514486271|gb|KE346361.1|	166821	166833	AAATCC	12	-	2	TTGGAT
gi|514486271|gb|KE346361.1|	167213	167226	ACGAGG	13	+	2	GACGAG
gi|514486271|gb|KE346361.1|	168304	168316	AAAAAC	12	+	2	AAAACA
gi|514486271|gb|KE346361.1|	168752	168765	AGGCGG	13	+	2	GGCGGA
gi|514486271|gb|KE346361.1|	169016	169034	ACCCCC	18	+	3	ACCCCC
gi|514486271|gb|KE346361.1|	169091	169136	A	45	+	45	A
gi|514486271|gb|KE346361.1|	169373	169397	A	24	+	24	A
gi|514486271|gb|KE346361.1|	169552	169573	A	21	+	21	A
gi|514486271|gb|KE346361.1|	169753	169770	A	17	+	17	A
gi|514486271|gb|KE346361.1|	169818	169891	A	73	+	73	A
gi|514486271|gb|KE346361.1|	169896	169910	AAG	14	-	4	TTC
gi|514486271|gb|KE346361.1|	169974	169986	AAC	12	-	4	TTG
gi|514486271|gb|KE346361.1|	170217	170229	AACCC	12	-	2	GGGTT
gi|514486271|gb|KE346361.1|	170463	170489	AC	26	+	13	AC
gi|514486271|gb|KE346361.1|	170771	170791	ACACGC	20	-	3	GTGTGC
gi|514486271|gb|KE346361.1|	172526	172544	A	18	-	18	T
gi|514486271|gb|KE346361.1|	172560	172591	A	31	-	31	T
gi|514486271|gb|KE346361.1|	172731	172744	AGC	13	+	4	GCA
gi|514486271|gb|KE346361.1|	172752	172764	AATCCC	12	-	2	GGATTG
gi|514486271|gb|KE346361.1|	173177	173191	AAG	14	+	4	GAA
gi|514486271|gb|KE346361.1|	173192	173207	AAG	15	+	5	GAA
gi|514486271|gb|KE346361.1|	173208	173221	AAG	13	+	4	GAA
gi|514486271|gb|KE346361.1|	174344	174356	AAGTAC	12	+	2	ACAAGT
gi|514486271|gb|KE346361.1|	176771	176784	AAC	13	+	4	CAA
gi|514486271|gb|KE346361.1|	176913	176925	ACCCCC	12	-	2	TGGGGG
gi|514486271|gb|KE346361.1|	176988	177013	AAC	25	+	8	ACA
gi|514486271|gb|KE346361.1|	177277	177293	AAAC	16	+	4	AAAC
gi|514486271|gb|KE346361.1|	177290	177303	AACC	13	+	3	AACC
gi|514486271|gb|KE346361.1|	177564	177581	AAC	17	+	5	AAC
gi|514486271|gb|KE346361.1|	177582	177781	AC	199	+	99	AC
gi|514486271|gb|KE346361.1|	177778	177794	AAAAC	16	+	3	ACAAA
gi|514486271|gb|KE346361.1|	178061	178075	AAAAAC	14	+	2	AAAAAC
gi|514486271|gb|KE346361.1|	178079	178096	AAAC	17	+	4	ACAA
gi|514486271|gb|KE346361.1|	178098	178110	AAAAAC	12	+	2	AAACAA
gi|514486271|gb|KE346361.1|	178943	178966	A	23	+	23	A
gi|514486271|gb|KE346361.1|	179195	179207	AAAAAC	12	+	2	ACAAAA
gi|514486271|gb|KE346361.1|	180119	180139	AAAAC	20	+	4	CAAAA
gi|514486271|gb|KE346361.1|	180145	180158	A	13	+	13	A
gi|514486271|gb|KE346361.1|	180669	180681	AAC	12	+	4	ACA
gi|514486271|gb|KE346361.1|	181230	181243	ACGCCG	13	-	2	GTCGGC
gi|514486271|gb|KE346361.1|	181459	181499	A	40	-	40	T
gi|514486271|gb|KE346361.1|	181550	181563	A	13	+	13	A
gi|514486271|gb|KE346361.1|	181665	181679	AGG	14	+	4	GAG
gi|514486271|gb|KE346361.1|	182104	182116	AACTG	12	+	2	GAACT
gi|514486271|gb|KE346361.1|	182508	182521	ACAGC	13	+	2	CACAG
gi|514486271|gb|KE346361.1|	183612	183627	ACCCTC	15	+	2	CACCCT
gi|514486271|gb|KE346361.1|	183983	183995	ACGGCC	12	+	2	CGGCCA
gi|514486271|gb|KE346361.1|	184457	184469	AGCGCG	12	+	2	AGCGCG
gi|514486271|gb|KE346361.1|	185099	185113	AAGGAC	14	-	2	TCCTTG
gi|514486271|gb|KE346361.1|	185240	185254	ACATGG	14	-	2	TCCATG
gi|514486271|gb|KE346361.1|	185567	185590	AGC	23	-	7	TGC
gi|514486271|gb|KE346361.1|	186541	186567	AGC	26	-	8	GCT
gi|514486271|gb|KE346361.1|	186665	186682	AGC	17	+	5	GCA
gi|514486271|gb|KE346361.1|	187107	187119	AGAGGC	12	+	2	AGAGGC
gi|514486271|gb|KE346361.1|	188607	188620	AACCAC	13	-	2	TGGTTG
gi|514486271|gb|KE346361.1|	188624	188636	ACC	12	-	4	GTG
gi|514486271|gb|KE346361.1|	189760	189772	AAAAAC	12	-	2	GTTTTT
gi|514486271|gb|KE346361.1|	189864	189891	A	27	+	27	A
gi|514486271|gb|KE346361.1|	190027	190041	AGG	14	+	4	GAG
gi|514486271|gb|KE346361.1|	190293	190323	A	30	-	30	T
gi|514486271|gb|KE346361.1|	190500	190526	A	26	-	26	T
gi|514486271|gb|KE346361.1|	191888	191903	AAGGGG	15	+	2	GGGGAA
gi|514486271|gb|KE346361.1|	193465	193479	AAC	14	+	4	AAC
gi|514486271|gb|KE346361.1|	193485	193498	AAC	13	+	4	CAA
gi|514486271|gb|KE346361.1|	194640	194653	AC	13	+	6	CA
gi|514486271|gb|KE346361.1|	194919	194935	ATC	16	-	5	GAT
gi|514486271|gb|KE346361.1|	195100	195114	ATC	14	+	4	ATC
gi|514486271|gb|KE346361.1|	195175	195187	ACTCGC	12	-	2	TGCGAG
gi|514486271|gb|KE346361.1|	195586	195608	A	22	-	22	T
gi|514486271|gb|KE346361.1|	195816	195828	A	12	-	12	T
gi|514486271|gb|KE346361.1|	195833	195845	AAAAAG	12	-	2	CTTTTT
gi|514486271|gb|KE346361.1|	195844	195857	AAAGAG	13	-	2	TTTCTC
gi|514486271|gb|KE346361.1|	196100	196112	ACATCT	12	+	2	TCTACA
gi|514486271|gb|KE346361.1|	196225	196256	A	31	-	31	T
gi|514486271|gb|KE346361.1|	196407	196419	AAT	12	-	4	ATT
gi|514486271|gb|KE346361.1|	196451	196464	AAAAC	13	-	2	TTTTG
gi|514486271|gb|KE346361.1|	196759	196771	AAT	12	-	4	ATT
gi|514486271|gb|KE346361.1|	196815	196830	A	15	-	15	T
gi|514486271|gb|KE346361.1|	197001	197014	A	13	+	13	A
gi|514486271|gb|KE346361.1|	197061	197075	AAAC	14	+	3	AACA
gi|514486271|gb|KE346361.1|	197113	197125	A	12	+	12	A
gi|514486271|gb|KE346361.1|	197209	197223	AACC	14	-	3	TGGT
gi|514486271|gb|KE346361.1|	197386	197398	AACCAC	12	+	2	CCACAA
gi|514486271|gb|KE346361.1|	197486	197498	AAACAG	12	+	2	AGAAAC
gi|514486271|gb|KE346361.1|	197718	197731	ACGAGT	13	+	2	CGAGTA
gi|514486271|gb|KE346361.1|	197875	197887	ACCTC	12	+	2	CCTCA
gi|514486271|gb|KE346361.1|	201395	201409	AAAAGC	14	-	2	TTGCTT
gi|514486271|gb|KE346361.1|	201405	201431	A	26	-	26	T
gi|514486271|gb|KE346361.1|	201483	201505	ACCG	22	-	5	GTCG
gi|514486271|gb|KE346361.1|	201593	201616	A	23	-	23	T
gi|514486271|gb|KE346361.1|	201737	201752	AAAAC	15	+	3	ACAAA
gi|514486271|gb|KE346361.1|	201790	201804	AAAAT	14	+	2	AAAAT
gi|514486271|gb|KE346361.1|	202270	202282	AAACTC	12	-	2	GTTTGA
gi|514486271|gb|KE346361.1|	202605	202628	A	23	+	23	A
gi|514486271|gb|KE346361.1|	202629	202642	A	13	+	13	A
gi|514486271|gb|KE346361.1|	203001	203015	AAAGAG	14	-	2	TTTCTC
gi|514486271|gb|KE346361.1|	203023	203038	AG	15	-	7	CT
gi|514486271|gb|KE346361.1|	203113	203125	AACCGC	12	+	2	CAACCG
gi|514486271|gb|KE346361.1|	203691	203703	AACAGC	12	+	2	CAGCAA
gi|514486271|gb|KE346361.1|	203734	203746	A	12	-	12	T
gi|514486271|gb|KE346361.1|	204450	204477	A	27	-	27	T
gi|514486271|gb|KE346361.1|	204559	204572	AAG	13	-	4	CTT
gi|514486271|gb|KE346361.1|	204766	204783	A	17	-	17	T
gi|514486271|gb|KE346361.1|	204815	204827	A	12	-	12	T
gi|514486271|gb|KE346361.1|	204835	204849	AAAAG	14	-	2	TTTTC
gi|514486271|gb|KE346361.1|	205232	205245	A	13	-	13	T
gi|514486271|gb|KE346361.1|	205456	205480	A	24	-	24	T
gi|514486271|gb|KE346361.1|	205747	205759	A	12	-	12	T
gi|514486271|gb|KE346361.1|	205792	205804	A	12	-	12	T
gi|514486271|gb|KE346361.1|	206261	206280	A	19	+	19	A
gi|514486271|gb|KE346361.1|	206331	206343	A	12	-	12	T
gi|514486271|gb|KE346361.1|	207255	207276	A	21	-	21	T
gi|514486271|gb|KE346361.1|	207279	207293	AAAAC	14	-	2	TTGTT
gi|514486271|gb|KE346361.1|	207325	207340	AAGC	15	-	3	TTGC
gi|514486271|gb|KE346361.1|	207396	207408	AAG	12	-	4	TTC
gi|514486271|gb|KE346361.1|	207483	207507	A	24	-	24	T
gi|514486271|gb|KE346361.1|	207647	207664	CCG	17	+	5	CCG
gi|514486271|gb|KE346361.1|	207736	207757	AGC	21	-	7	GCT
gi|514486271|gb|KE346361.1|	207901	207929	ACTGGC	28	-	4	GCCAGT
gi|514486271|gb|KE346361.1|	208751	208772	AGC	21	-	7	CTG
gi|514486271|gb|KE346361.1|	208773	208789	AGC	16	-	5	TGC
gi|514486271|gb|KE346361.1|	208787	208801	ACT	14	+	4	CTA
gi|514486271|gb|KE346361.1|	209427	209441	AGC	14	+	4	CAG
gi|514486271|gb|KE346361.1|	210062	210076	ACGCGG	14	-	2	TCCGCG
gi|514486271|gb|KE346361.1|	213301	213313	AACCAC	12	-	2	GGTTGT
gi|514486271|gb|KE346361.1|	213565	213577	A	12	+	12	A
gi|514486271|gb|KE346361.1|	213592	213677	AC	85	+	42	AC
gi|514486271|gb|KE346361.1|	213857	213870	AACCAG	13	+	2	CCAGAA
gi|514486271|gb|KE346361.1|	213973	213987	ACACGC	14	-	2	GCGTGT
gi|514486271|gb|KE346361.1|	214200	214218	AGC	18	+	6	GCA
gi|514486271|gb|KE346361.1|	214323	214335	ATCGCC	12	+	2	GCCATC
gi|514486271|gb|KE346361.1|	214858	214872	A	14	-	14	T
gi|514486271|gb|KE346361.1|	214874	214887	ACAGTC	13	+	2	CACAGT
gi|514486271|gb|KE346361.1|	214906	214918	AAAAAT	12	+	2	TAAAAA
gi|514486271|gb|KE346361.1|	214913	214925	A	12	+	12	A
gi|514486271|gb|KE346361.1|	216174	216186	ACGCTG	12	-	2	CAGCGT
gi|514486271|gb|KE346361.1|	216830	216843	AAC	13	+	4	CAA
gi|514486271|gb|KE346361.1|	217306	217320	AAAC	14	+	3	AACA
gi|514486271|gb|KE346361.1|	217468	217488	A	20	+	20	A
gi|514486271|gb|KE346361.1|	217523	217535	AAAGTC	12	+	2	TCAAAG
gi|514486271|gb|KE346361.1|	217685	217697	AACGCC	12	-	2	TTGGCG
gi|514486271|gb|KE346361.1|	218649	218661	AGCTCG	12	+	2	GCTCGA
gi|514486271|gb|KE346361.1|	218978	218997	AGC	19	+	6	GCA
gi|514486271|gb|KE346361.1|	219145	219157	ACTCGC	12	-	2	AGTGCG
gi|514486271|gb|KE346361.1|	219152	219165	ACGC	13	-	3	GTGC
gi|514486271|gb|KE346361.1|	219194	219208	AAG	14	+	4	AAG
gi|514486271|gb|KE346361.1|	219203	219220	AACAAG	17	+	2	AAGAAC
gi|514486271|gb|KE346361.1|	219215	219235	AAG	20	+	6	AAG
gi|514486271|gb|KE346361.1|	219248	219292	A	44	-	44	T
gi|514486271|gb|KE346361.1|	219330	219359	A	29	-	29	T
gi|514486271|gb|KE346361.1|	219500	219520	A	20	+	20	A
gi|514486271|gb|KE346361.1|	219772	219785	AAAAAC	13	+	2	AAACAA
gi|514486271|gb|KE346361.1|	221762	221776	AG	14	-	7	TC
gi|514486271|gb|KE346361.1|	222371	222383	ACTGCG	12	-	2	CAGTCG
gi|514486271|gb|KE346361.1|	223184	223200	AAG	16	-	5	TTC
gi|514486271|gb|KE346361.1|	223898	223910	A	12	-	12	T
gi|514486271|gb|KE346361.1|	224121	224135	ACG	14	+	4	GAC
gi|514486271|gb|KE346361.1|	224313	224326	ACGATG	13	-	2	CGTCAT
gi|514486271|gb|KE346361.1|	224928	224940	AAAAGC	12	+	2	AGCAAA
gi|514486271|gb|KE346361.1|	225779	225794	AAAAAG	15	-	2	TTTCTT
gi|514486271|gb|KE346361.1|	226402	226416	AAAAC	14	-	2	TTTTG
gi|514486271|gb|KE346361.1|	227580	227592	AGCGGC	12	+	2	GCAGCG
gi|514486271|gb|KE346361.1|	228119	228131	ACAGC	12	-	2	GTGCT
gi|514486271|gb|KE346361.1|	229746	229758	ATCCCC	12	+	2	ATCCCC
gi|514486271|gb|KE346361.1|	233921	233936	ACTC	15	-	3	GTGA
gi|514486271|gb|KE346361.1|	233943	233956	ACACTC	13	-	2	GTGAGT
gi|514486271|gb|KE346361.1|	233950	233974	ACTC	24	-	6	TGAG
gi|514486271|gb|KE346361.1|	233968	233980	ACTCTC	12	-	2	AGTGAG
gi|514486271|gb|KE346361.1|	234451	234482	CCG	31	-	10	GCG
gi|514486271|gb|KE346361.1|	234679	234698	AGC	19	-	6	CTG
gi|514486271|gb|KE346361.1|	234949	234961	AC	12	-	6	TG
gi|514486271|gb|KE346361.1|	235122	235151	ATC	29	+	9	CAT
gi|514486271|gb|KE346361.1|	235152	235180	ATC	28	+	9	CAT
gi|514486271|gb|KE346361.1|	236426	236439	AAGCAC	13	-	2	TGTGCT
gi|514486271|gb|KE346361.1|	236852	236952	AC	100	+	50	AC
gi|514486271|gb|KE346361.1|	237347	237359	ACTGCC	12	+	2	CTGCCA
gi|514486271|gb|KE346361.1|	237373	237387	ACG	14	-	4	GTC
gi|514486271|gb|KE346361.1|	237646	237659	ACGGCG	13	+	2	GACGGC
gi|514486271|gb|KE346361.1|	237828	237843	AACAGC	15	-	2	GCTGTT
gi|514486271|gb|KE346361.1|	238133	238146	AAAAGC	13	-	2	TGCTTT
gi|514486271|gb|KE346361.1|	238280	238298	A	18	+	18	A
gi|514486271|gb|KE346361.1|	238644	238668	AAGCC	24	+	4	AAGCC
gi|514486271|gb|KE346361.1|	239049	239066	ATC	17	-	5	ATG
gi|514486271|gb|KE346361.1|	239289	239301	ATCGCC	12	+	2	ATCGCC
gi|514486271|gb|KE346361.1|	241328	241341	A	13	-	13	T
gi|514486271|gb|KE346361.1|	241469	241481	AAC	12	+	4	AAC
gi|514486271|gb|KE346361.1|	241827	241850	ACACTC	23	-	3	GTGTGA
gi|514486271|gb|KE346361.1|	241915	241927	AGCCC	12	+	2	CCAGC
gi|514486271|gb|KE346361.1|	242186	242199	ACGTCG	13	+	2	CGACGT
gi|514486271|gb|KE346361.1|	242676	242688	AGGGGG	12	+	2	GGGAGG
gi|514486271|gb|KE346361.1|	242717	242731	AAAC	14	-	3	GTTT
gi|514486271|gb|KE346361.1|	242938	242950	AAGCCG	12	+	2	AGCCGA
gi|514486271|gb|KE346361.1|	243046	243061	AAAC	15	-	3	TTTG
gi|514486271|gb|KE346361.1|	243313	243331	A	18	-	18	T
gi|514486271|gb|KE346361.1|	243332	243346	AAG	14	-	4	CTT
gi|514486271|gb|KE346361.1|	243413	243425	AACACC	12	-	2	GTGTTG
gi|514486271|gb|KE346361.1|	243483	243495	AACAGC	12	+	2	GCAACA
gi|514486271|gb|KE346361.1|	243516	243533	AAGTCG	17	-	2	TCGACT
gi|514486271|gb|KE346361.1|	244057	244069	AGCATC	12	-	2	ATGCTG
gi|514486271|gb|KE346361.1|	244687	244712	AAGCAG	25	-	4	CTGCTT
gi|514486271|gb|KE346361.1|	244867	244879	AAGCTC	12	+	2	AGCTCA
gi|514486271|gb|KE346361.1|	244913	244925	ACGGGC	12	-	2	CCGTGC
gi|514486271|gb|KE346361.1|	245315	245327	AACAGC	12	-	2	TGTTGC
gi|514486271|gb|KE346361.1|	245543	245555	ACCCGC	12	+	2	CGCACC
gi|514486271|gb|KE346361.1|	245958	245970	AAGGCC	12	+	2	GCCAAG
gi|514486271|gb|KE346361.1|	246027	246041	AGC	14	-	4	GCT
gi|514486271|gb|KE346361.1|	246277	246290	AGCGGC	13	-	2	CTGCCG
gi|514486271|gb|KE346361.1|	246587	246605	AAAAAT	18	-	3	ATTTTT
gi|514486271|gb|KE346361.1|	247314	247326	AAGATC	12	-	2	TTGATC
gi|514486271|gb|KE346361.1|	247953	247966	AAAGAC	13	+	2	AGACAA
gi|514486271|gb|KE346361.1|	248015	248031	AGC	16	+	5	AGC
gi|514486271|gb|KE346361.1|	248935	248947	AACCCC	12	+	2	ACCCCA
gi|514486271|gb|KE346361.1|	249215	249229	AGGCGG	14	+	2	CGGAGG
gi|514486271|gb|KE346361.1|	249224	249236	AAGGCG	12	+	2	AGGCGA
gi|514486271|gb|KE346361.1|	249386	249404	ACG	18	+	6	CGA
gi|514486271|gb|KE346361.1|	250437	250451	ACC	14	-	4	TGG
gi|514486271|gb|KE346361.1|	250452	250464	ACC	12	-	4	TGG
gi|514486271|gb|KE346361.1|	252252	252264	ACGCTG	12	+	2	CTGACG
gi|514486271|gb|KE346361.1|	253647	253663	AAAAC	16	-	3	GTTTT
gi|514486271|gb|KE346361.1|	254472	254484	A	12	-	12	T
gi|514486271|gb|KE346361.1|	254933	254945	AAGCAG	12	+	2	AGCAGA
gi|514486271|gb|KE346361.1|	255963	255976	A	13	+	13	A
gi|514486271|gb|KE346361.1|	256022	256035	AAACAC	13	+	2	CACAAA
gi|514486271|gb|KE346361.1|	257202	257214	AGCTGC	12	+	2	TGCAGC
gi|514486271|gb|KE346361.1|	257696	257708	AAAGTT	12	+	2	AAAGTT
gi|514486271|gb|KE346361.1|	260627	260642	AAAACC	15	-	2	GTTTTG
gi|514486271|gb|KE346361.1|	261016	261028	A	12	+	12	A
gi|514486271|gb|KE346361.1|	262220	262242	AAC	22	+	7	CAA
gi|514486271|gb|KE346361.1|	262480	262504	AAG	24	-	8	TTC
gi|514486271|gb|KE346361.1|	262677	262690	A	13	+	13	A
gi|514486271|gb|KE346361.1|	262686	262700	AAAAT	14	+	2	AAAAT
gi|514486271|gb|KE346361.1|	263116	263128	ACC	12	+	4	CAC
gi|514486271|gb|KE346361.1|	263615	263628	AATTCC	13	-	2	TTGGAA
gi|514486271|gb|KE346361.1|	263785	263798	AAAGGC	13	-	2	GCCTTT
gi|514486271|gb|KE346361.1|	264013	264026	ATCGGC	13	+	2	CGGCAT
gi|514486271|gb|KE346361.1|	264472	264489	A	17	-	17	T
gi|514486271|gb|KE346361.1|	264732	264744	AC	12	-	6	TG
gi|514486271|gb|KE346361.1|	265130	265142	C	12	+	12	C
gi|514486271|gb|KE346361.1|	265403	265415	AAAAAG	12	+	2	GAAAAA
gi|514486271|gb|KE346361.1|	265555	265568	ACCGCG	13	+	2	GACCGC
gi|514486271|gb|KE346361.1|	266205	266218	ACACG	13	+	2	CGACA
gi|514486271|gb|KE346361.1|	266608	266627	AAG	19	-	6	CTT
gi|514486271|gb|KE346361.1|	266628	266641	AAG	13	-	4	TCT
gi|514486271|gb|KE346361.1|	266760	266773	AAAAG	13	-	2	TCTTT
gi|514486271|gb|KE346361.1|	266855	266868	AAAAC	13	-	2	TGTTT
gi|514486271|gb|KE346361.1|	267655	267668	ACACTG	13	+	2	GACACT
gi|514486271|gb|KE346361.1|	267738	267750	A	12	-	12	T
gi|514486271|gb|KE346361.1|	267759	267774	A	15	-	15	T
gi|514486271|gb|KE346361.1|	267798	267813	AAAAT	15	-	3	ATTTT
gi|514486271|gb|KE346361.1|	267807	267820	AAAAAT	13	-	2	TATTTT
gi|514486271|gb|KE346361.1|	267828	267853	A	25	-	25	T
gi|514486271|gb|KE346361.1|	267931	267944	ACGC	13	-	3	CGTG
gi|514486271|gb|KE346361.1|	268415	268431	AGC	16	+	5	CAG
gi|514486271|gb|KE346361.1|	268757	268792	A	35	+	35	A
gi|514486271|gb|KE346361.1|	269019	269038	A	19	+	19	A
gi|514486271|gb|KE346361.1|	269061	269079	AGCG	18	-	4	CTCG
gi|514486271|gb|KE346361.1|	269211	269228	A	17	-	17	T
gi|514486271|gb|KE346361.1|	269230	269242	A	12	-	12	T
gi|514486271|gb|KE346361.1|	269297	269313	AAAAAG	16	-	2	TTTTCT
gi|514486271|gb|KE346361.1|	269813	269826	A	13	-	13	T
gi|514486271|gb|KE346361.1|	270147	270167	A	20	+	20	A
gi|514486271|gb|KE346361.1|	270178	270190	AAC	12	-	4	TGT
gi|514486271|gb|KE346361.1|	270647	270659	ACGGCC	12	+	2	CACGGC
gi|514486271|gb|KE346361.1|	271101	271128	A	27	-	27	T
gi|514486271|gb|KE346361.1|	271146	271173	A	27	-	27	T
gi|514486271|gb|KE346361.1|	271307	271319	ATCCGC	12	+	2	TCCGCA
gi|514486271|gb|KE346361.1|	271948	271966	A	18	-	18	T
gi|514486271|gb|KE346361.1|	272896	272940	AGC	44	-	14	TGC
gi|514486271|gb|KE346361.1|	272938	272952	AAC	14	-	4	TGT
gi|514486271|gb|KE346361.1|	272950	272982	AGC	32	-	10	TGC
gi|514486271|gb|KE346361.1|	273584	273599	AAAC	15	-	3	TTTG
gi|514486271|gb|KE346361.1|	273847	273859	A	12	+	12	A
gi|514486271|gb|KE346361.1|	274164	274178	A	14	+	14	A
gi|514486271|gb|KE346361.1|	274209	274238	A	29	+	29	A
gi|514486271|gb|KE346361.1|	274423	274437	AG	14	-	7	CT
gi|514486271|gb|KE346361.1|	274454	274475	ACC	21	+	7	CCA
gi|514486271|gb|KE346361.1|	275834	275852	AGCAGG	18	-	3	CCTGCT
gi|514486271|gb|KE346361.1|	276182	276201	AAG	19	-	6	TCT
gi|514486271|gb|KE346361.1|	277616	277629	AAAAC	13	+	2	CAAAA
gi|514486271|gb|KE346361.1|	278211	278225	AACGAC	14	+	2	ACGACA
gi|514486271|gb|KE346361.1|	278226	278241	ACG	15	+	5	ACG
gi|514486271|gb|KE346361.1|	278239	278252	CCG	13	-	4	CGG
gi|514486271|gb|KE346361.1|	278715	278740	AAAAAC	25	+	4	AAACAA
gi|514486271|gb|KE346361.1|	280567	280582	ACG	15	-	5	TCG
gi|514486271|gb|KE346361.1|	281049	281063	AGCCCC	14	+	2	GCCCCA
gi|514486271|gb|KE346361.1|	281316	281334	ACG	18	-	6	CGT
gi|514486271|gb|KE346361.1|	281398	281410	AAAC	12	+	3	AAAC
gi|514486271|gb|KE346361.1|	282063	282079	A	16	-	16	T
gi|514486271|gb|KE346361.1|	282096	282127	ACTGC	31	-	6	TGCAG
gi|514486271|gb|KE346361.1|	282389	282401	AATCAC	12	+	2	CACAAT
gi|514486271|gb|KE346361.1|	282413	282443	A	30	+	30	A
gi|514486271|gb|KE346361.1|	282533	282549	AC	16	-	8	GT
gi|514486271|gb|KE346361.1|	283182	283198	AAAAAT	16	+	2	AAAAAT
gi|514486271|gb|KE346361.1|	283262	283289	AAC	27	+	9	CAA
gi|514486271|gb|KE346361.1|	284409	284435	ACC	26	+	8	CCA
gi|514486271|gb|KE346361.1|	284732	284747	ACTGCC	15	-	2	GGCAGT
gi|514486271|gb|KE346361.1|	285025	285039	ACCACG	14	+	2	CACGAC
gi|514486271|gb|KE346361.1|	285034	285054	ACCATG	20	+	3	GACCAT
gi|514486271|gb|KE346361.1|	285058	285072	AGG	14	+	4	GAG
gi|514486271|gb|KE346361.1|	285110	285122	A	12	+	12	A
gi|514486271|gb|KE346361.1|	285277	285289	ACTCG	12	+	2	TCGAC
gi|514486271|gb|KE346361.1|	285966	285983	ACCACG	17	+	2	CACGAC
gi|514486271|gb|KE346361.1|	288248	288260	AGGGGG	12	-	2	CCCCCT
gi|514486271|gb|KE346361.1|	288299	288312	AATGC	13	+	2	ATGCA
gi|514486271|gb|KE346361.1|	288696	288708	AAACTC	12	-	2	TGAGTT
gi|514486271|gb|KE346361.1|	288893	288906	A	13	+	13	A
gi|514486271|gb|KE346361.1|	289002	289014	AAAAAT	12	-	2	ATTTTT
gi|514486271|gb|KE346361.1|	289252	289271	AG	19	-	9	TC
gi|514486271|gb|KE346361.1|	289424	289436	A	12	-	12	T
gi|514486271|gb|KE346361.1|	289624	289648	A	24	+	24	A
gi|514486271|gb|KE346361.1|	289659	289677	A	18	+	18	A
gi|514486271|gb|KE346361.1|	290582	290596	AAACAC	14	-	2	TGTTTG
gi|514486271|gb|KE346361.1|	291652	291664	AGC	12	+	4	GCA
gi|514486271|gb|KE346361.1|	292100	292112	AAGCTC	12	-	2	TTGAGC
gi|514486271|gb|KE346361.1|	292609	292626	AGCTGC	17	+	2	GCTGCA
gi|514486271|gb|KE346361.1|	293143	293158	AC	15	-	7	TG
gi|514486271|gb|KE346361.1|	293554	293573	AGC	19	+	6	GCA
gi|514486271|gb|KE346361.1|	293664	293691	AGC	27	+	9	CAG
gi|514486271|gb|KE346361.1|	293698	293710	AGCATC	12	+	2	TCAGCA
gi|514486271|gb|KE346361.1|	293722	293736	AGCATC	14	+	2	TCAGCA
gi|514486271|gb|KE346361.1|	294087	294105	A	18	-	18	T
gi|514486271|gb|KE346361.1|	294153	294165	A	12	+	12	A
gi|514486271|gb|KE346361.1|	295360	295373	ACATCC	13	-	2	TGGATG
gi|514486271|gb|KE346361.1|	295502	295515	AGG	13	-	4	TCC
gi|514486271|gb|KE346361.1|	295528	295540	AAGAG	12	-	2	TTCTC
gi|514486271|gb|KE346361.1|	296114	296126	ACAGGG	12	-	2	CCCTGT
gi|514486271|gb|KE346361.1|	296505	296531	AGC	26	+	8	GCA
gi|514486271|gb|KE346361.1|	296711	296724	AAAAC	13	-	2	TTTTG
gi|514486271|gb|KE346361.1|	297535	297549	ACG	14	-	4	CGT
gi|514486271|gb|KE346361.1|	297555	297567	AGC	12	+	4	AGC
gi|514486271|gb|KE346361.1|	297700	297722	AGC	22	-	7	CTG
gi|514486271|gb|KE346361.1|	297773	297786	ACC	13	+	4	CCA
gi|514486271|gb|KE346361.1|	297909	297932	A	23	+	23	A
gi|514486271|gb|KE346361.1|	297941	297953	AAAAT	12	+	2	AAAAT
gi|514486271|gb|KE346361.1|	299228	299241	AAATG	13	-	2	TTTCA
gi|514486271|gb|KE346361.1|	300371	300388	ACC	17	-	5	GTG
gi|514486271|gb|KE346361.1|	300811	300823	AAAGC	12	-	2	TTTGC
gi|514486271|gb|KE346361.1|	300947	300959	AGATCC	12	+	2	CCAGAT
gi|514486271|gb|KE346361.1|	301319	301344	AAAC	25	-	6	TGTT
gi|514486271|gb|KE346361.1|	302232	302244	AGGCGC	12	-	2	TGCGCC
gi|514486271|gb|KE346361.1|	302472	302484	AAAACC	12	-	2	GTTTTG
gi|514486271|gb|KE346361.1|	303882	303896	AAC	14	-	4	TGT
gi|514486271|gb|KE346361.1|	304241	304253	ACCGTC	12	-	2	GACGGT
gi|514486271|gb|KE346361.1|	304724	304736	AGGC	12	+	3	GCAG
gi|514486271|gb|KE346361.1|	304737	304754	AGGC	17	+	4	CAGG
gi|514486271|gb|KE346361.1|	307442	307454	AAAG	12	+	3	AAGA
gi|514486271|gb|KE346361.1|	307455	307506	A	51	+	51	A
gi|514486271|gb|KE346361.1|	307507	307522	AAG	15	+	5	GAA
gi|514486271|gb|KE346361.1|	307837	307852	A	15	+	15	A
gi|514486271|gb|KE346361.1|	307890	307902	A	12	+	12	A
gi|514486271|gb|KE346361.1|	308073	308090	A	17	+	17	A
gi|514486271|gb|KE346361.1|	308184	308201	AAAGAG	17	+	2	AGAGAA
gi|514486271|gb|KE346361.1|	308204	308220	AG	16	+	8	AG
gi|514486271|gb|KE346361.1|	308816	308833	AAC	17	-	5	TTG
gi|514486271|gb|KE346361.1|	308828	308841	AAAC	13	-	3	TTGT
gi|514486271|gb|KE346361.1|	308893	308905	AAC	12	+	4	CAA
gi|514486271|gb|KE346361.1|	309421	309433	AAGGAG	12	+	2	AGAAGG
gi|514486271|gb|KE346361.1|	309500	309523	A	23	+	23	A
gi|514486271|gb|KE346361.1|	309532	309544	AAAAC	12	+	2	AAAAC
gi|514486271|gb|KE346361.1|	309875	309889	AAAC	14	-	3	TTTG
gi|514486271|gb|KE346361.1|	309974	309990	AG	16	-	8	TC
gi|514486271|gb|KE346361.1|	310117	310130	A	13	+	13	A
gi|514486271|gb|KE346361.1|	310131	310145	A	14	+	14	A
gi|514486271|gb|KE346361.1|	310391	310412	A	21	+	21	A
gi|514486271|gb|KE346361.1|	310671	310683	AAAAAC	12	+	2	AAAAAC
gi|514486271|gb|KE346361.1|	310860	310872	AAATTC	12	-	2	GAATTT
gi|514486271|gb|KE346361.1|	311435	311447	AAC	12	+	4	AAC
gi|514486271|gb|KE346361.1|	311769	311785	AAAAAC	16	-	2	TTTTTG
gi|514486271|gb|KE346361.1|	311830	311844	AACCGC	14	-	2	TTGCGG
gi|514486271|gb|KE346361.1|	312006	312024	A	18	+	18	A
gi|514486271|gb|KE346361.1|	312068	312088	AAAAAC	20	-	3	TTGTTT
gi|514486271|gb|KE346361.1|	312122	312135	AAGGAG	13	-	2	TCCTTC
gi|514486271|gb|KE346361.1|	312587	312600	AATGGC	13	-	2	TTGCCA
gi|514486271|gb|KE346361.1|	314235	314248	A	13	-	13	T
gi|514486271|gb|KE346361.1|	316592	316604	ACGAGG	12	-	2	CCTCGT
gi|514486271|gb|KE346361.1|	317464	317476	ATCGCC	12	+	2	ATCGCC
gi|514486271|gb|KE346361.1|	317528	317545	AGGG	17	-	4	CCTC
gi|514486271|gb|KE346361.1|	317737	317799	AC	62	-	31	TG
gi|514486271|gb|KE346361.1|	318413	318426	AATGAC	13	-	2	TTGTCA
gi|514486271|gb|KE346361.1|	318456	318481	A	25	+	25	A
gi|514486271|gb|KE346361.1|	318700	318728	AC	28	-	14	TG
gi|514486271|gb|KE346361.1|	318802	318820	CCG	18	-	6	GCG
gi|514486271|gb|KE346361.1|	318837	318853	AG	16	+	8	AG
gi|514486271|gb|KE346361.1|	319339	319351	CCG	12	+	4	GCC
gi|514486271|gb|KE346361.1|	319690	319707	AAC	17	-	5	TGT
gi|514486271|gb|KE346361.1|	319708	319722	AAC	14	-	4	TGT
gi|514486271|gb|KE346361.1|	319717	319734	AACAGC	17	-	2	TGTTGC
gi|514486271|gb|KE346361.1|	321404	321416	A	12	+	12	A
gi|514486271|gb|KE346361.1|	321417	321431	AAAGTC	14	+	2	AGTCAA
gi|514486271|gb|KE346361.1|	321493	321505	AAAC	12	+	3	CAAA
gi|514486271|gb|KE346361.1|	321528	321540	AAAC	12	+	3	AAAC
gi|514486271|gb|KE346361.1|	322542	322555	AAACG	13	+	2	AAACG
gi|514486271|gb|KE346361.1|	322560	322580	A	20	+	20	A
gi|514486271|gb|KE346361.1|	322579	322600	AG	21	+	10	AG
gi|514486271|gb|KE346361.1|	322687	322701	AGG	14	+	4	GGA
gi|514486271|gb|KE346361.1|	322699	322712	C	13	-	13	G
gi|514486271|gb|KE346361.1|	322738	322771	A	33	+	33	A
gi|514486271|gb|KE346361.1|	322796	322808	ACACAG	12	+	2	ACAGAC
gi|514486271|gb|KE346361.1|	322929	322941	AAAAAC	12	+	2	AAACAA
gi|514486271|gb|KE346361.1|	323314	323331	AAC	17	+	5	AAC
gi|514486271|gb|KE346361.1|	323482	323495	AAAACT	13	-	2	TTTAGT
gi|514486271|gb|KE346361.1|	323498	323512	AAAAC	14	-	2	TTTTG
gi|514486271|gb|KE346361.1|	323691	323706	AAAATT	15	+	2	AATTAA
gi|514486271|gb|KE346361.1|	323765	323777	AAAAAC	12	-	2	TTGTTT
gi|514486271|gb|KE346361.1|	324036	324048	AAAAC	12	+	2	CAAAA
gi|514486271|gb|KE346361.1|	324104	324120	A	16	+	16	A
gi|514486271|gb|KE346361.1|	324125	324137	AAAAAG	12	+	2	GAAAAA
gi|514486271|gb|KE346361.1|	324304	324319	A	15	+	15	A
gi|514486271|gb|KE346361.1|	324511	324525	AAAAC	14	+	2	AAAAC
gi|514486271|gb|KE346361.1|	324519	324536	AAAAAC	17	+	2	ACAAAA
gi|514486271|gb|KE346361.1|	324540	324553	A	13	+	13	A
gi|514486271|gb|KE346361.1|	324777	324793	AGCTCG	16	+	2	CGAGCT
gi|514486271|gb|KE346361.1|	324830	324843	ACATGC	13	-	2	ATGTGC
gi|514486271|gb|KE346361.1|	325049	325065	AC	16	+	8	CA
gi|514486271|gb|KE346361.1|	325060	325077	ACACAT	17	+	2	ACACAT
gi|514486271|gb|KE346361.1|	325116	325130	A	14	+	14	A
gi|514486271|gb|KE346361.1|	325497	325510	AAAAAC	13	+	2	ACAAAA
gi|514486271|gb|KE346361.1|	325505	325518	A	13	+	13	A
gi|514486271|gb|KE346361.1|	325564	325576	AAAAAG	12	+	2	AAAAAG
gi|514486271|gb|KE346361.1|	325903	325915	AC	12	-	6	TG
gi|514486271|gb|KE346361.1|	326078	326092	AACG	14	+	3	AACG
gi|514486271|gb|KE346361.1|	326090	326114	A	24	+	24	A
gi|514486271|gb|KE346361.1|	326132	326197	A	65	+	65	A
gi|514486271|gb|KE346361.1|	326586	326598	ACCTCT	12	+	2	TACCTC
gi|514486271|gb|KE346361.1|	327451	327465	AGGGG	14	+	2	GGGGA
gi|514486271|gb|KE346361.1|	327881	327897	A	16	+	16	A
gi|514486271|gb|KE346361.1|	330291	330303	AAACAC	12	+	2	CAAACA
gi|514486271|gb|KE346361.1|	330485	330497	ACCCCC	12	-	2	GGGGGT
gi|514486271|gb|KE346361.1|	331246	331258	ACGCGG	12	-	2	CGCGTC
gi|514486271|gb|KE346361.1|	331437	331449	AACTGC	12	-	2	AGTTGC
gi|514486271|gb|KE346361.1|	331609	331623	ACCTGC	14	-	2	GCAGGT
gi|514486271|gb|KE346361.1|	331784	331798	AGCAGG	14	+	2	GAGCAG
gi|514486271|gb|KE346361.1|	332250	332263	ACGTGC	13	+	2	TGCACG
gi|514486271|gb|KE346361.1|	332942	332957	AGCATG	15	+	2	AGCATG
gi|514486271|gb|KE346361.1|	333567	333579	ACTGGC	12	+	2	ACTGGC
gi|514486271|gb|KE346361.1|	333739	333784	A	45	-	45	T
gi|514486271|gb|KE346361.1|	333973	333989	A	16	+	16	A
gi|514486271|gb|KE346361.1|	334323	334336	ACC	13	+	4	ACC
gi|514486271|gb|KE346361.1|	334468	334495	A	27	+	27	A
gi|514486271|gb|KE346361.1|	334498	334510	AAAAAG	12	+	2	GAAAAA
gi|514486271|gb|KE346361.1|	334511	334529	AAAAAG	18	+	3	GAAAAA
gi|514486271|gb|KE346361.1|	334724	334738	AAAAT	14	+	2	AAAAT
gi|514486271|gb|KE346361.1|	334732	334745	AAAAAT	13	+	2	ATAAAA
gi|514486271|gb|KE346361.1|	335167	335181	A	14	-	14	T
gi|514486271|gb|KE346361.1|	335198	335210	AAAAAT	12	-	2	TTTTTA
gi|514486271|gb|KE346361.1|	335689	335701	AAATGC	12	-	2	TGCATT
gi|514486271|gb|KE346361.1|	335750	335764	A	14	-	14	T
gi|514486271|gb|KE346361.1|	335798	335813	A	15	-	15	T
gi|514486271|gb|KE346361.1|	336003	336030	A	27	-	27	T
gi|514486271|gb|KE346361.1|	336062	336076	A	14	-	14	T
gi|514486271|gb|KE346361.1|	336255	336268	A	13	-	13	T
gi|514486271|gb|KE346361.1|	336273	336287	AAAAT	14	-	2	TTTTA
gi|514486271|gb|KE346361.1|	336348	336368	AAG	20	+	6	AAG
gi|514486271|gb|KE346361.1|	336404	336418	AAAAC	14	-	2	TTTTG
gi|514486271|gb|KE346361.1|	337314	337327	ACGTCC	13	+	2	CCACGT
gi|514486271|gb|KE346361.1|	338278	338291	ACTCGG	13	+	2	GGACTC
gi|514486271|gb|KE346361.1|	339285	339297	AATGGC	12	-	2	TTGCCA
gi|514486271|gb|KE346361.1|	339439	339451	ACAGTG	12	-	2	CACTGT
gi|514486271|gb|KE346361.1|	341291	341303	AAATAC	12	-	2	TTTGTA
gi|514486271|gb|KE346361.1|	341491	341503	AAAC	12	-	3	TGTT
gi|514486271|gb|KE346361.1|	341537	341550	AAAC	13	-	3	TTGT
gi|514486271|gb|KE346361.1|	341751	341778	A	27	-	27	T
gi|514486271|gb|KE346361.1|	342014	342027	ACACTG	13	-	2	TGTCAG
gi|514486271|gb|KE346361.1|	342081	342103	ATC	22	+	7	ATC
gi|514486271|gb|KE346361.1|	342098	342112	AGCATC	14	+	2	CATCAG
gi|514486271|gb|KE346361.1|	342119	342133	AGCATC	14	+	2	CATCAG
gi|514486271|gb|KE346361.1|	342166	342183	AATCCC	17	+	2	CAATCC
gi|514486271|gb|KE346361.1|	342205	342237	AGC	32	+	10	AGC
gi|514486271|gb|KE346361.1|	342271	342285	ATC	14	+	4	TCA
gi|514486271|gb|KE346361.1|	342280	342294	ACGATG	14	-	2	TCATCG
gi|514486271|gb|KE346361.1|	342560	342576	ACG	16	+	5	CGA
gi|514486271|gb|KE346361.1|	342614	342631	ACCACT	17	-	2	GTAGTG
gi|514486271|gb|KE346361.1|	342670	342683	AGCCTC	13	+	2	CCTCAG
gi|514486271|gb|KE346361.1|	342754	342768	AGGATG	14	-	2	TCCTCA
gi|514486271|gb|KE346361.1|	342764	342780	AGCATC	16	+	2	CATCAG
gi|514486271|gb|KE346361.1|	342902	342927	AGC	25	-	8	CTG
gi|514486271|gb|KE346361.1|	343215	343227	AAGCTC	12	+	2	TCAAGC
gi|514486271|gb|KE346361.1|	343504	343518	AGCATC	14	+	2	CATCAG
gi|514486271|gb|KE346361.1|	343543	343556	AACATC	13	+	2	CAACAT
gi|514486271|gb|KE346361.1|	343564	343576	AACATC	12	+	2	CAACAT
gi|514486271|gb|KE346361.1|	344029	344043	AGC	14	+	4	CAG
gi|514486271|gb|KE346361.1|	344052	344085	AGC	33	+	11	GCA
gi|514486271|gb|KE346361.1|	344083	344127	AAC	44	+	14	CAA
gi|514486271|gb|KE346361.1|	345083	345113	AGG	30	-	10	CTC
gi|514486271|gb|KE346361.1|	346215	346227	AGC	12	-	4	TGC
gi|514486271|gb|KE346361.1|	346628	346642	A	14	-	14	T
gi|514486271|gb|KE346361.1|	347677	347689	AAAACG	12	-	2	TTCGTT
gi|514486271|gb|KE346361.1|	348690	348705	AATCC	15	+	3	CAATC
gi|514486271|gb|KE346361.1|	348951	348964	AAGGAG	13	+	2	GAGAAG
gi|514486271|gb|KE346361.1|	349271	349283	AAACAC	12	-	2	TTGTGT
gi|514486271|gb|KE346361.1|	350621	350636	AAC	15	-	5	TTG
gi|514486271|gb|KE346361.1|	350902	350920	AGG	18	-	6	CTC
gi|514486271|gb|KE346361.1|	350919	350934	AGGG	15	-	3	CTCC
gi|514486271|gb|KE346361.1|	351242	351254	ATC	12	+	4	ATC
gi|514486271|gb|KE346361.1|	351266	351280	AGC	14	-	4	GCT
gi|514486271|gb|KE346361.1|	351339	351357	AAAGGC	18	-	3	CCTTTG
gi|514486271|gb|KE346361.1|	351352	351369	AAAGAC	17	-	2	CTTTGT
gi|514486271|gb|KE346361.1|	351740	351754	ACAGCG	14	-	2	CGCTGT
gi|514486271|gb|KE346361.1|	352074	352088	ACGAGG	14	+	2	GAGGAC
gi|514486271|gb|KE346361.1|	352554	352567	AGC	13	+	4	GCA
gi|514486271|gb|KE346361.1|	352628	352645	ACG	17	+	5	GAC
gi|514486271|gb|KE346361.1|	353232	353249	AGC	17	-	5	CTG
gi|514486271|gb|KE346361.1|	353266	353281	AGC	15	-	5	TGC
gi|514486271|gb|KE346361.1|	353360	353377	ACGAGG	17	+	2	GACGAG
gi|514486271|gb|KE346361.1|	353481	353494	AGCTGC	13	+	2	CTGCAG
gi|514486271|gb|KE346361.1|	353759	353782	ATC	23	-	7	GAT
gi|514486271|gb|KE346361.1|	353860	353880	AACTCC	20	+	3	CAACTC
gi|514486271|gb|KE346361.1|	354327	354345	A	18	-	18	T
gi|514486271|gb|KE346361.1|	354342	354354	AAAC	12	-	3	TTTG
gi|514486271|gb|KE346361.1|	354823	354835	ACGTGC	12	+	2	GTGCAC
gi|514486271|gb|KE346361.1|	356357	356369	A	12	-	12	T
gi|514486271|gb|KE346361.1|	356407	356426	ACACGC	19	+	3	CGCACA
gi|514486271|gb|KE346361.1|	360272	360288	AGCGGC	16	+	2	CGGCAG
gi|514486271|gb|KE346361.1|	360485	360497	AAGC	12	+	3	AAGC
gi|514486271|gb|KE346361.1|	360533	360545	AGGGG	12	+	2	GGGGA
gi|514486271|gb|KE346361.1|	360540	360552	AGG	12	+	4	GGA
gi|514486271|gb|KE346361.1|	360868	360882	A	14	-	14	T
gi|514486271|gb|KE346361.1|	360883	360919	AAG	36	-	12	CTT
gi|514486271|gb|KE346361.1|	361471	361483	ACG	12	-	4	GTC
gi|514486271|gb|KE346361.1|	361550	361567	A	17	+	17	A
gi|514486271|gb|KE346361.1|	361819	361850	AG	31	-	15	TC
gi|514486271|gb|KE346361.1|	362039	362055	AAGAGT	16	-	2	TACTCT
gi|514486271|gb|KE346361.1|	362732	362748	AAGAGT	16	-	2	TACTCT
gi|514486271|gb|KE346361.1|	362854	362866	AAGCAG	12	-	2	CTGCTT
gi|514486271|gb|KE346361.1|	363037	363049	AGGCCG	12	+	2	GCCGAG
gi|514486271|gb|KE346361.1|	363236	363250	ATC	14	-	4	ATG
gi|514486271|gb|KE346361.1|	363597	363610	AACAGC	13	+	2	CAGCAA
gi|514486271|gb|KE346361.1|	364024	364036	AAGGGT	12	+	2	GGTAAG
gi|514486271|gb|KE346361.1|	364144	364160	AACG	16	-	4	CGTT
gi|514486271|gb|KE346361.1|	365412	365429	ACC	17	+	5	CCA
gi|514486271|gb|KE346361.1|	366294	366306	ACGCTG	12	-	2	GTCAGC
gi|514486271|gb|KE346361.1|	366686	366703	ATC	17	-	5	GAT
gi|514486271|gb|KE346361.1|	366701	366730	ACG	29	+	9	GAC
gi|514486271|gb|KE346361.1|	366756	366768	AACGTC	12	+	2	CAACGT
gi|514486271|gb|KE346361.1|	367784	367796	AAGCAT	12	-	2	TGCTTA
gi|514486271|gb|KE346361.1|	368404	368422	A	18	-	18	T
gi|514486271|gb|KE346361.1|	368654	368667	ACCATC	13	-	2	GTGATG
gi|514486271|gb|KE346361.1|	368938	368969	A	31	-	31	T
gi|514486271|gb|KE346361.1|	369115	369127	A	12	-	12	T
gi|514486271|gb|KE346361.1|	369297	369309	AG	12	-	6	TC
gi|514486271|gb|KE346361.1|	369688	369700	ATCGGC	12	+	2	TCGGCA
gi|514486271|gb|KE346361.1|	369949	369965	AC	16	+	8	CA
gi|514486271|gb|KE346361.1|	370295	370307	AAGGCC	12	-	2	TTGGCC
gi|514486271|gb|KE346361.1|	370503	370523	ATCC	20	-	5	GATG
gi|514486271|gb|KE346361.1|	371127	371139	AAACG	12	+	2	AACGA
gi|514486271|gb|KE346361.1|	371507	371520	AGCGCG	13	+	2	CGAGCG
gi|514486271|gb|KE346361.1|	371652	371669	AAGGGC	17	-	2	CTTGCC
gi|514486271|gb|KE346361.1|	372234	372246	ACGGGC	12	+	2	CACGGG
gi|514486271|gb|KE346361.1|	372957	372981	AAACAC	24	-	4	TTTGTG
gi|514486271|gb|KE346361.1|	373246	373269	A	23	-	23	T
gi|514486271|gb|KE346361.1|	373768	373793	A	25	+	25	A
gi|514486271|gb|KE346361.1|	374945	374960	AGC	15	-	5	GCT
gi|514486271|gb|KE346361.1|	375638	375742	AAC	104	-	34	TTG
gi|514486271|gb|KE346361.1|	376245	376257	AAATC	12	-	2	TTGAT
gi|514486271|gb|KE346361.1|	376552	376564	C	12	+	12	C
gi|514486271|gb|KE346361.1|	376567	376585	ATC	18	-	6	TGA
gi|514486271|gb|KE346361.1|	376969	376994	A	25	+	25	A
gi|514486271|gb|KE346361.1|	378242	378258	AAAGAC	16	-	2	TGTCTT
gi|514486271|gb|KE346361.1|	378409	378432	AAAC	23	-	5	TTTG
gi|514486271|gb|KE346361.1|	378547	378560	ACAGCT	13	+	2	AGCTAC
gi|514486271|gb|KE346361.1|	379896	379908	AATGCC	12	+	2	ATGCCA
gi|514486271|gb|KE346361.1|	379903	379918	ACTGGC	15	-	2	TGCCAG
gi|514486271|gb|KE346361.1|	380795	380811	AGCC	16	+	4	AGCC
gi|514486271|gb|KE346361.1|	381082	381095	A	13	+	13	A
gi|514486271|gb|KE346361.1|	382306	382318	ACTC	12	-	3	TGAG
gi|514486271|gb|KE346361.1|	383349	383361	ACCT	12	-	3	GTAG
gi|514486271|gb|KE346361.1|	383623	383635	AGAGGC	12	-	2	CTCTGC
gi|514486271|gb|KE346361.1|	385498	385511	AAAC	13	+	3	ACAA
gi|514486271|gb|KE346361.1|	385508	385523	A	15	+	15	A
gi|514486271|gb|KE346361.1|	385615	385627	ACGCTC	12	-	2	TGAGCG
gi|514486271|gb|KE346361.1|	386290	386365	AGC	75	-	25	CTG
gi|514486271|gb|KE346361.1|	386914	386926	ATCCGC	12	-	2	TGCGGA
gi|514486271|gb|KE346361.1|	387187	387199	AGAGCG	12	+	2	AGCGAG
gi|514486271|gb|KE346361.1|	388296	388308	AAAAC	12	-	2	TTTTG
gi|514486271|gb|KE346361.1|	388767	388782	AAGCGG	15	-	2	GCTTCC
gi|514486271|gb|KE346361.1|	388878	388890	ACAGAG	12	-	2	TCTGTC
gi|514486271|gb|KE346361.1|	389090	389102	AGC	12	-	4	TGC
gi|514486271|gb|KE346361.1|	389442	389456	A	14	-	14	T
gi|514486271|gb|KE346361.1|	389745	389762	AAAAC	17	-	3	TTTTG
gi|514486271|gb|KE346361.1|	389833	389845	AGGATG	12	-	2	ATCCTC
gi|514486271|gb|KE346361.1|	391854	391866	ACAGGG	12	-	2	CTGTCC
gi|514486271|gb|KE346361.1|	392235	392247	ACCTCG	12	+	2	TCGACC
gi|514486271|gb|KE346361.1|	396105	396119	ACATGC	14	+	2	CATGCA
gi|514486271|gb|KE346361.1|	398464	398490	ACCAG	26	+	5	GACCA
gi|514486271|gb|KE346361.1|	398574	398586	AAGAG	12	+	2	AGAGA
gi|514486271|gb|KE346361.1|	399768	399780	A	12	-	12	T
gi|514486271|gb|KE346361.1|	399809	399823	A	14	-	14	T
gi|514486271|gb|KE346361.1|	399849	399863	AAAAAT	14	-	2	TTTATT
gi|514486271|gb|KE346361.1|	399859	399874	AAAAAT	15	-	2	TTTTAT
gi|514486271|gb|KE346361.1|	400021	400037	AAG	16	+	5	AGA
gi|514486271|gb|KE346361.1|	400551	400565	A	14	+	14	A
gi|514486271|gb|KE346361.1|	400566	400580	A	14	+	14	A
gi|514486271|gb|KE346361.1|	402228	402244	AACTTG	16	-	2	GTTCAA
gi|514486271|gb|KE346361.1|	402302	402314	AACTTG	12	-	2	TCAAGT
gi|514486271|gb|KE346361.1|	403062	403074	AAG	12	+	4	AAG
gi|514486271|gb|KE346361.1|	403095	403107	AAG	12	+	4	AAG
gi|514486271|gb|KE346361.1|	404311	404324	A	13	-	13	T
gi|514486271|gb|KE346361.1|	404376	404395	AGAGC	19	+	3	CAGAG
gi|514486271|gb|KE346361.1|	404536	404564	A	28	-	28	T
gi|514486271|gb|KE346361.1|	404715	404732	AAAAAC	17	+	2	AAAAAC
gi|514486271|gb|KE346361.1|	404761	404802	A	41	+	41	A
gi|514486271|gb|KE346361.1|	405392	405408	AAC	16	-	5	TTG
gi|514486271|gb|KE346361.1|	405651	405667	AGG	16	-	5	CCT
gi|514486271|gb|KE346361.1|	405905	405918	ACCACT	13	-	2	TGGTAG
gi|514486271|gb|KE346361.1|	405925	405938	ACTGCT	13	-	2	GTAGCA
gi|514486271|gb|KE346361.1|	407455	407470	AAAAAG	15	-	2	TTTCTT
gi|514486271|gb|KE346361.1|	407820	407832	AAAAAC	12	+	2	ACAAAA
gi|514486271|gb|KE346361.1|	407869	407881	ATCGC	12	+	2	GCATC
gi|514486271|gb|KE346361.1|	408120	408135	ATCC	15	-	3	ATGG
gi|514486271|gb|KE346361.1|	408612	408624	ACGATG	12	-	2	GTCATC
gi|514486271|gb|KE346361.1|	408832	408844	AAC	12	+	4	CAA
gi|514486271|gb|KE346361.1|	409138	409150	AAAAGC	12	+	2	GCAAAA
gi|514486271|gb|KE346361.1|	409375	409401	ACGCCG	26	+	4	ACGCCG
gi|514486271|gb|KE346361.1|	409450	409467	AAAGGG	17	+	2	GGGAAA
gi|514486271|gb|KE346361.1|	409522	409534	AACCCC	12	-	2	TTGGGG
gi|514486271|gb|KE346361.1|	409768	409793	A	25	+	25	A
gi|514486271|gb|KE346361.1|	410004	410019	AC	15	+	7	CA
gi|514486271|gb|KE346361.1|	410102	410117	ACACGC	15	+	2	CACGCA
gi|514486271|gb|KE346361.1|	410692	410711	AAAAG	19	+	3	AAAAG
gi|514486271|gb|KE346361.1|	410707	410719	A	12	+	12	A
gi|514486271|gb|KE346361.1|	410967	410979	AATC	12	+	3	ATCA
gi|514486271|gb|KE346361.1|	411226	411238	A	12	+	12	A
gi|514486271|gb|KE346361.1|	411258	411272	A	14	+	14	A
gi|514486271|gb|KE346361.1|	411631	411643	AAGGCC	12	+	2	AGGCCA
gi|514486271|gb|KE346361.1|	412038	412052	A	14	-	14	T
gi|514486271|gb|KE346361.1|	413500	413515	A	15	+	15	A
gi|514486271|gb|KE346361.1|	414838	414864	AAAC	26	+	6	AAAC
gi|514486271|gb|KE346361.1|	415631	415655	A	24	+	24	A
gi|514486271|gb|KE346361.1|	415667	415680	A	13	+	13	A
gi|514486271|gb|KE346361.1|	415701	415717	A	16	+	16	A
gi|514486271|gb|KE346361.1|	416164	416178	AAGCC	14	-	2	GGCTT
gi|514486271|gb|KE346361.1|	416191	416211	AGC	20	+	6	GCA
gi|514486271|gb|KE346361.1|	416358	416370	AACAAG	12	+	2	AACAAG
gi|514486271|gb|KE346361.1|	416756	416781	AAC	25	+	8	AAC
gi|514486271|gb|KE346361.1|	417429	417441	AATCAC	12	+	2	CAATCA
gi|514486271|gb|KE346361.1|	418109	418122	AGC	13	+	4	GCA
gi|514486271|gb|KE346361.1|	419064	419084	AC	20	+	10	AC
gi|514486271|gb|KE346361.1|	419139	419163	AG	24	+	12	GA
gi|514486271|gb|KE346361.1|	419341	419353	AGC	12	-	4	CTG
gi|514486271|gb|KE346361.1|	419544	419568	AG	24	+	12	AG
gi|514486271|gb|KE346361.1|	419586	419673	AG	87	+	43	AG
gi|514486271|gb|KE346361.1|	420796	420812	AAAAC	16	-	3	GTTTT
gi|514486271|gb|KE346361.1|	421209	421224	A	15	+	15	A
gi|514486271|gb|KE346361.1|	421963	421985	A	22	+	22	A
gi|514486271|gb|KE346361.1|	422167	422186	AAAAGC	19	-	3	TTTTGC
gi|514486271|gb|KE346361.1|	422284	422297	AGCGGC	13	+	2	GCAGCG
gi|514486271|gb|KE346361.1|	422341	422374	A	33	+	33	A
gi|514486271|gb|KE346361.1|	424846	424860	AAGCGG	14	-	2	GCTTCC
gi|514486271|gb|KE346361.1|	427783	427795	AAAAC	12	-	2	TTTTG
gi|514486271|gb|KE346361.1|	428110	428122	ACGCTG	12	+	2	TGACGC
gi|514486271|gb|KE346361.1|	428661	428678	A	17	-	17	T
gi|514486271|gb|KE346361.1|	428803	428815	AAACG	12	+	2	AACGA
gi|514486271|gb|KE346361.1|	428825	428838	AAG	13	+	4	AAG
gi|514486271|gb|KE346361.1|	428845	428861	A	16	+	16	A
gi|514486271|gb|KE346361.1|	428956	428970	AACCAC	14	-	2	GTGGTT
gi|514486271|gb|KE346361.1|	430137	430151	AGCCTC	14	-	2	GCTGAG
gi|514486271|gb|KE346361.1|	430152	430165	AGCCTC	13	-	2	GAGGCT
gi|514486271|gb|KE346361.1|	430209	430232	AGG	23	+	7	GAG
gi|514486271|gb|KE346361.1|	430349	430361	AATTCC	12	-	2	ATTGGA
gi|514486271|gb|KE346361.1|	430629	430650	AGGCGC	21	+	3	CAGGCG
gi|514486271|gb|KE346361.1|	430755	430777	AGC	22	-	7	GCT
gi|514486271|gb|KE346361.1|	430898	430921	AGC	23	-	7	TGC
gi|514486271|gb|KE346361.1|	430931	430961	ACTGCC	30	+	5	CCACTG
gi|514486271|gb|KE346361.1|	431018	431031	AGCCGC	13	-	2	GGCTGC
gi|514486271|gb|KE346361.1|	431080	431095	ACG	15	+	5	CGA
gi|514486271|gb|KE346361.1|	431227	431245	A	18	-	18	T
gi|514486271|gb|KE346361.1|	431647	431662	AAC	15	+	5	AAC
gi|514486271|gb|KE346361.1|	431720	431733	A	13	+	13	A
gi|514486271|gb|KE346361.1|	432192	432205	AGGG	13	+	3	GGGA
gi|514486271|gb|KE346361.1|	432480	432492	AAAAC	12	+	2	AAAAC
gi|514486271|gb|KE346361.1|	433194	433206	AAAAC	12	+	2	AAAAC
gi|514486271|gb|KE346361.1|	433376	433399	A	23	+	23	A
gi|514486271|gb|KE346361.1|	433471	433484	AAAGAG	13	+	2	AAAGAG
gi|514486271|gb|KE346361.1|	433571	433583	AACC	12	+	3	CCAA
gi|514486271|gb|KE346361.1|	434008	434021	A	13	+	13	A
gi|514486271|gb|KE346361.1|	434035	434049	AAAAAG	14	+	2	AAAGAA
gi|514486271|gb|KE346361.1|	435100	435112	A	12	+	12	A
gi|514486271|gb|KE346361.1|	435815	435828	AAC	13	-	4	TGT
gi|514486271|gb|KE346361.1|	435834	435851	AG	17	+	8	AG
gi|514486271|gb|KE346361.1|	436866	436878	ACTGCG	12	+	2	TGCGAC
gi|514486271|gb|KE346361.1|	437558	437570	A	12	+	12	A
gi|514486271|gb|KE346361.1|	438490	438504	AAAAC	14	+	2	ACAAA
gi|514486271|gb|KE346361.1|	438797	438814	ACCCCC	17	-	2	GGGGGT
gi|514486271|gb|KE346361.1|	439675	439696	ACCGCC	21	-	3	GGCGGT
gi|514486271|gb|KE346361.1|	439896	439912	A	16	-	16	T
gi|514486271|gb|KE346361.1|	440327	440339	AAAGGC	12	+	2	GCAAAG
gi|514486271|gb|KE346361.1|	440827	440839	CCG	12	-	4	CGG
gi|514486271|gb|KE346361.1|	441080	441093	AGCGC	13	+	2	GCGCA
gi|514486271|gb|KE346361.1|	441852	441868	AAC	16	+	5	ACA
gi|514486271|gb|KE346361.1|	441966	441981	AAAGAG	15	+	2	AAGAGA
gi|514486271|gb|KE346361.1|	442587	442600	AAACAG	13	+	2	AGAAAC
gi|514486271|gb|KE346361.1|	442607	442619	AAAC	12	+	3	ACAA
gi|514486271|gb|KE346361.1|	442955	442968	A	13	+	13	A
gi|514486271|gb|KE346361.1|	443508	443532	ACG	24	+	8	ACG
gi|514486271|gb|KE346361.1|	443757	443771	AACTTG	14	-	2	TCAAGT
gi|514486271|gb|KE346361.1|	443820	443834	AAAAC	14	+	2	AACAA
gi|514486271|gb|KE346361.1|	444081	444093	AAAGGG	12	+	2	AGGGAA
gi|514486271|gb|KE346361.1|	444220	444236	AGCTC	16	-	3	CTGAG
gi|514486271|gb|KE346361.1|	445399	445415	A	16	-	16	T
gi|514486271|gb|KE346361.1|	445410	445424	AAAAAC	14	-	2	TTTTTG
gi|514486271|gb|KE346361.1|	445574	445586	AATCGC	12	+	2	TCGCAA
gi|514486271|gb|KE346361.1|	446023	446035	ACCGTC	12	-	2	CGGTGA
gi|514486271|gb|KE346361.1|	446146	446158	AAGATC	12	-	2	TCTTGA
gi|514486271|gb|KE346361.1|	446326	446346	AGAGCG	20	+	3	AGAGCG
gi|514486271|gb|KE346361.1|	446411	446429	AGAGG	18	-	3	CTCTC
gi|514486271|gb|KE346361.1|	446423	446435	AGG	12	-	4	CTC
gi|514486271|gb|KE346361.1|	446474	446486	AGAGCG	12	+	2	CGAGAG
gi|514486271|gb|KE346361.1|	446481	446493	AG	12	+	6	GA
gi|514486271|gb|KE346361.1|	446843	446855	AGCG	12	+	3	GAGC
gi|514486271|gb|KE346361.1|	447546	447560	AAAAAC	14	+	2	AAAAAC
gi|514486271|gb|KE346361.1|	447625	447640	AC	15	+	7	CA
gi|514486271|gb|KE346361.1|	448117	448134	AAAAAT	17	-	2	TTTTTA
gi|514486271|gb|KE346361.1|	448173	448191	A	18	-	18	T
gi|514486271|gb|KE346361.1|	448362	448382	A	20	-	20	T
gi|514486271|gb|KE346361.1|	448583	448608	A	25	+	25	A
gi|514486271|gb|KE346361.1|	448622	448652	A	30	-	30	T
gi|514486271|gb|KE346361.1|	448901	448914	AC	13	+	6	CA
gi|514486271|gb|KE346361.1|	449245	449261	AAAAAC	16	+	2	AAAAAC
gi|514486271|gb|KE346361.1|	449759	449771	AGAGCG	12	-	2	CTCGCT
gi|514486271|gb|KE346361.1|	449942	449960	ACC	18	+	6	ACC
gi|514486271|gb|KE346361.1|	449958	449971	AGG	13	-	4	CCT
gi|514486271|gb|KE346361.1|	450059	450071	AGC	12	+	4	GCA
gi|514486271|gb|KE346361.1|	450188	450200	AGCCGC	12	+	2	GCAGCC
gi|514486271|gb|KE346361.1|	450698	450710	AAC	12	+	4	ACA
gi|514486271|gb|KE346361.1|	450732	450765	AGC	33	+	11	CAG
gi|514486271|gb|KE346361.1|	450800	450819	AGC	19	+	6	GCA
gi|514486271|gb|KE346361.1|	450982	450994	CCCG	12	+	3	GCCC
gi|514486271|gb|KE346361.1|	452110	452122	ACCGAG	12	-	2	GTCTCG
gi|514486271|gb|KE346361.1|	453380	453417	AC	37	-	18	TG
gi|514486271|gb|KE346361.1|	454269	454283	AAG	14	-	4	CTT
gi|514486271|gb|KE346361.1|	454311	454323	AAAAGG	12	-	2	TTCCTT
gi|514486271|gb|KE346361.1|	454481	454501	AAC	20	-	6	TGT
gi|514486271|gb|KE346361.1|	454645	454658	AACCCC	13	-	2	TTGGGG
gi|514486271|gb|KE346361.1|	454807	454819	ACC	12	-	4	GTG
gi|514486271|gb|KE346361.1|	454826	454849	AAC	23	-	7	TGT
gi|514486271|gb|KE346361.1|	454847	454865	ACC	18	-	6	TGG
gi|514486271|gb|KE346361.1|	455014	455026	ACCATC	12	-	2	GTGATG
gi|514486271|gb|KE346361.1|	455036	455052	ACCAGC	16	-	2	TGGTGC
gi|514486271|gb|KE346361.1|	455047	455059	ACCAGG	12	-	2	CTGGTC
gi|514486271|gb|KE346361.1|	456094	456109	ACGATG	15	-	2	GTCATC
gi|514486271|gb|KE346361.1|	456763	456775	AAAC	12	+	3	CAAA
gi|514486271|gb|KE346361.1|	456964	456981	AAAAAC	17	+	2	AAAAAC
gi|514486271|gb|KE346361.1|	456986	457008	A	22	+	22	A
gi|514486271|gb|KE346361.1|	457005	457024	AAAC	19	+	4	AAAC
gi|514486271|gb|KE346361.1|	457021	457037	A	16	+	16	A
gi|514486271|gb|KE346361.1|	457335	457347	AAAGTC	12	+	2	AAAGTC
gi|514486271|gb|KE346361.1|	457456	457468	ACGAGC	12	-	2	CTCGTG
gi|514486271|gb|KE346361.1|	457479	457491	ATC	12	+	4	ATC
gi|514486271|gb|KE346361.1|	457908	457920	AACGAG	12	-	2	CTCGTT
gi|514486271|gb|KE346361.1|	458677	458691	CCCCG	14	-	2	GGGGC
gi|514486271|gb|KE346361.1|	458804	458818	AC	14	+	7	CA
gi|514486271|gb|KE346361.1|	459075	459087	AAAGTG	12	+	2	GAAAGT
gi|514486271|gb|KE346361.1|	459176	459188	AAAAAG	12	+	2	AGAAAA
gi|514486271|gb|KE346361.1|	459344	459356	AAAC	12	+	3	CAAA
gi|514486271|gb|KE346361.1|	460149	460164	A	15	+	15	A
gi|514486271|gb|KE346361.1|	460861	460880	AGCGGC	19	+	3	CAGCGG
gi|514486271|gb|KE346361.1|	461004	461017	AAGGAC	13	-	2	TCCTTG
gi|514486271|gb|KE346361.1|	461213	461225	AAGGCG	12	-	2	TTCGCC
gi|514486271|gb|KE346361.1|	461886	461898	AAAAAC	12	+	2	AAACAA
gi|514486271|gb|KE346361.1|	462107	462119	A	12	+	12	A
gi|514486271|gb|KE346361.1|	462393	462405	ACCACG	12	+	2	ACCACG
gi|514486271|gb|KE346361.1|	462454	462475	A	21	+	21	A
gi|514486271|gb|KE346361.1|	462671	462697	A	26	+	26	A
gi|514486271|gb|KE346361.1|	462732	462744	AAAAAG	12	+	2	AGAAAA
gi|514486271|gb|KE346361.1|	462901	462915	A	14	+	14	A
gi|514486271|gb|KE346361.1|	463123	463135	A	12	+	12	A
gi|514486271|gb|KE346361.1|	463552	463565	AGAGGG	13	+	2	GAGAGG
gi|514486271|gb|KE346361.1|	464099	464121	AAGG	22	+	5	AGGA
gi|514486271|gb|KE346361.1|	464232	464256	AG	24	+	12	AG
gi|514486271|gb|KE346361.1|	464386	464398	AAGGGC	12	+	2	CAAGGG
gi|514486271|gb|KE346361.1|	465012	465025	A	13	-	13	T
gi|514486271|gb|KE346361.1|	465483	465510	A	27	+	27	A
gi|514486271|gb|KE346361.1|	465670	465697	A	27	+	27	A
gi|514486271|gb|KE346361.1|	465788	465800	AATGCC	12	-	2	CATTGG
gi|514486271|gb|KE346361.1|	465888	465904	AAAAAT	16	-	2	TTTTTA
gi|514486271|gb|KE346361.1|	465915	465930	A	15	-	15	T
gi|514486271|gb|KE346361.1|	465932	465947	A	15	-	15	T
gi|514486271|gb|KE346361.1|	466151	466166	A	15	+	15	A
gi|514486271|gb|KE346361.1|	466167	466182	A	15	+	15	A
gi|514486271|gb|KE346361.1|	466374	466388	AAAAT	14	-	2	TTTTA
gi|514486271|gb|KE346361.1|	466404	466416	A	12	-	12	T
gi|514486271|gb|KE346361.1|	466628	466640	A	12	-	12	T
gi|514486271|gb|KE346361.1|	466933	466946	AACAAG	13	+	2	ACAAGA
gi|514486271|gb|KE346361.1|	466941	466954	AAAAG	13	+	2	AAGAA
gi|514486271|gb|KE346361.1|	468691	468703	A	12	+	12	A
gi|514486271|gb|KE346361.1|	468710	468727	A	17	-	17	T
gi|514486271|gb|KE346361.1|	468766	468778	AAAAAC	12	-	2	TGTTTT
gi|514486271|gb|KE346361.1|	469055	469067	AAGGGG	12	-	2	TTCCCC
gi|514486271|gb|KE346361.1|	470047	470063	AAAAAT	16	+	2	AAAATA
gi|514486271|gb|KE346361.1|	470297	470310	AGG	13	+	4	AGG
gi|514486271|gb|KE346361.1|	470322	470335	AGG	13	+	4	GGA
gi|514486271|gb|KE346361.1|	470518	470530	ACGAGG	12	-	2	CTCGTC
gi|514486271|gb|KE346361.1|	470652	470664	ACGCCG	12	-	2	CGGCGT
gi|514486271|gb|KE346361.1|	470983	470995	AAAAGT	12	+	2	AAAGTA
gi|514486271|gb|KE346361.1|	471364	471376	AGATG	12	-	2	ATCTC
gi|514486271|gb|KE346361.1|	471398	471413	AAAC	15	+	3	AAAC
gi|514486271|gb|KE346361.1|	471452	471464	AAC	12	+	4	CAA
gi|514486271|gb|KE346361.1|	471638	471651	A	13	+	13	A
gi|514486271|gb|KE346361.1|	471672	471693	A	21	-	21	T
gi|514486271|gb|KE346361.1|	471875	471939	AGC	64	-	21	GCT
gi|514486271|gb|KE346361.1|	472193	472206	AAC	13	-	4	GTT
gi|514486271|gb|KE346361.1|	472689	472705	AACAGC	16	-	2	GCTGTT
gi|514486271|gb|KE346361.1|	472700	472715	AGC	15	-	5	TGC
gi|514486271|gb|KE346361.1|	473044	473056	AAAG	12	+	3	AAAG
gi|514486271|gb|KE346361.1|	473123	473141	AC	18	-	9	TG
gi|514486271|gb|KE346361.1|	473215	473243	AAG	28	+	9	GAA
gi|514486271|gb|KE346361.1|	473268	473293	A	25	+	25	A
gi|514486271|gb|KE346361.1|	473431	473450	AACC	19	+	4	CCAA
gi|514486271|gb|KE346361.1|	473452	473492	A	40	+	40	A
gi|514486271|gb|KE346361.1|	473631	473668	AG	37	+	18	AG
gi|514486271|gb|KE346361.1|	474123	474136	ACATGT	13	+	2	CATGTA
gi|514486271|gb|KE346361.1|	474260	474272	AATCAC	12	+	2	CACAAT
gi|514486271|gb|KE346361.1|	474703	474716	AAG	13	-	4	TTC
gi|514486271|gb|KE346361.1|	474968	474980	A	12	-	12	T
gi|514486271|gb|KE346361.1|	475163	475188	A	25	+	25	A
gi|514486271|gb|KE346361.1|	475447	475459	AATCAG	12	-	2	TCTGAT
gi|514486271|gb|KE346361.1|	475516	475531	A	15	+	15	A
gi|514486271|gb|KE346361.1|	476366	476378	A	12	-	12	T
gi|514486271|gb|KE346361.1|	476519	476536	AC	17	+	8	AC
gi|514486271|gb|KE346361.1|	476531	476548	AAACAC	17	+	2	ACACAA
gi|514486271|gb|KE346361.1|	476753	476765	ACCCCC	12	+	2	CACCCC
gi|514486271|gb|KE346361.1|	477484	477498	A	14	-	14	T
gi|514486271|gb|KE346361.1|	477511	477526	A	15	-	15	T
gi|514486271|gb|KE346361.1|	478889	478921	A	32	+	32	A
gi|514486271|gb|KE346361.1|	478992	479004	ACATCT	12	-	2	TGTAGA
gi|514486271|gb|KE346361.1|	479367	479379	C	12	+	12	C
gi|514486271|gb|KE346361.1|	479585	479597	AGCGCG	12	+	2	CGAGCG
gi|514486271|gb|KE346361.1|	479852	479865	ACTGCT	13	-	2	AGTAGC
gi|514486271|gb|KE346361.1|	480465	480477	AGCATG	12	+	2	AGCATG
gi|514486271|gb|KE346361.1|	481765	481779	AGAGC	14	+	2	GAGCA
gi|514486271|gb|KE346361.1|	482034	482051	AAGCTC	17	+	2	CAAGCT
gi|514486271|gb|KE346361.1|	482469	482487	AC	18	+	9	CA
gi|514486271|gb|KE346361.1|	483049	483062	AGG	13	+	4	AGG
gi|514486271|gb|KE346361.1|	484022	484039	ACCCG	17	-	3	GGGTC
gi|514486271|gb|KE346361.1|	484117	484129	AACGC	12	-	2	GCGTT
gi|514486271|gb|KE346361.1|	484181	484193	ACGAGG	12	+	2	GACGAG
gi|514486271|gb|KE346361.1|	484431	484446	A	15	+	15	A
gi|514486271|gb|KE346361.1|	484667	484682	ACTCCG	15	+	2	TCCGAC
gi|514486271|gb|KE346361.1|	484742	484754	AGC	12	+	4	CAG
gi|514486271|gb|KE346361.1|	484755	484767	AGC	12	+	4	AGC
gi|514486271|gb|KE346361.1|	484810	484825	A	15	+	15	A
gi|514486271|gb|KE346361.1|	485001	485013	AAACG	12	+	2	AAACG
gi|514486271|gb|KE346361.1|	485020	485042	A	22	+	22	A
gi|514486271|gb|KE346361.1|	485263	485278	AAAAAT	15	+	2	AAATAA
gi|514486271|gb|KE346361.1|	485291	485314	A	23	-	23	T
gi|514486271|gb|KE346361.1|	485441	485453	A	12	-	12	T
gi|514486271|gb|KE346361.1|	485573	485585	AAAAAC	12	-	2	TTGTTT
gi|514486271|gb|KE346361.1|	486093	486106	AAGTGC	13	+	2	AGTGCA
gi|514486271|gb|KE346361.1|	486771	486783	AAC	12	+	4	CAA
gi|514486271|gb|KE346361.1|	486861	486875	AAC	14	+	4	CAA
gi|514486271|gb|KE346361.1|	486870	486885	AACAGC	15	+	2	CAACAG
gi|514486271|gb|KE346361.1|	487223	487238	AGC	15	+	5	GCA
gi|514486271|gb|KE346361.1|	487463	487479	ACC	16	+	5	CCA
gi|514486271|gb|KE346361.1|	489066	489079	ACATGG	13	-	2	CCATGT
gi|514486271|gb|KE346361.1|	489216	489228	ACGGGG	12	-	2	CGTCCC
gi|514486271|gb|KE346361.1|	489337	489352	AAAAAG	15	-	2	TTTTCT
gi|514486271|gb|KE346361.1|	489525	489539	AAAAAC	14	-	2	TTGTTT
gi|514486271|gb|KE346361.1|	489943	489957	AACC	14	-	3	TTGG
gi|514486271|gb|KE346361.1|	490366	490379	AAAC	13	-	3	GTTT
gi|514486271|gb|KE346361.1|	490417	490429	A	12	+	12	A
gi|514486271|gb|KE346361.1|	490707	490719	AAC	12	+	4	ACA
gi|514486271|gb|KE346361.1|	490804	490821	A	17	+	17	A
gi|514486271|gb|KE346361.1|	491011	491025	A	14	+	14	A
gi|514486271|gb|KE346361.1|	491167	491180	AAAC	13	-	3	GTTT
gi|514486271|gb|KE346361.1|	491191	491203	ACAG	12	-	3	CTGT
gi|514486271|gb|KE346361.1|	491334	491346	ACACGC	12	+	2	ACGCAC
gi|514486271|gb|KE346361.1|	491340	491352	ACGC	12	+	3	ACGC
gi|514486271|gb|KE346361.1|	491638	491650	AAAGAC	12	-	2	TGTCTT
gi|514486271|gb|KE346361.1|	492172	492188	AAAAAG	16	+	2	AAAAGA
gi|514486271|gb|KE346361.1|	493010	493023	AG	13	+	6	AG
gi|514486271|gb|KE346361.1|	493074	493094	A	20	+	20	A
gi|514486271|gb|KE346361.1|	493259	493274	C	15	-	15	G
gi|514486271|gb|KE346361.1|	493322	493334	A	12	+	12	A
gi|514486271|gb|KE346361.1|	493470	493483	AAACC	13	+	2	AAACC
gi|514486271|gb|KE346361.1|	493480	493511	A	31	+	31	A
gi|514486271|gb|KE346361.1|	493552	493570	A	18	-	18	T
gi|514486271|gb|KE346361.1|	493718	493738	A	20	+	20	A
gi|514486271|gb|KE346361.1|	493765	493777	AGCC	12	+	3	AGCC
gi|514486271|gb|KE346361.1|	493891	493904	AAG	13	+	4	AGA
gi|514486271|gb|KE346361.1|	493958	493971	AAAACG	13	+	2	AAAACG
gi|514486271|gb|KE346361.1|	494176	494190	AAGGG	14	-	2	TTCCC
gi|514486271|gb|KE346361.1|	494503	494515	AAAAAC	12	+	2	AAAAAC
gi|514486271|gb|KE346361.1|	494800	494813	ACC	13	-	4	GTG
gi|514486271|gb|KE346361.1|	495071	495085	AGCG	14	-	3	CTCG
gi|514486271|gb|KE346361.1|	495537	495554	ACTGAG	17	-	2	CTCAGT
gi|514486271|gb|KE346361.1|	495549	495562	AGCCTC	13	+	2	CTCAGC
gi|514486271|gb|KE346361.1|	495792	495805	AAC	13	+	4	CAA
gi|514486271|gb|KE346361.1|	496513	496542	ACC	29	+	9	CCA
gi|514486271|gb|KE346361.1|	496932	496948	AGC	16	-	5	GCT
gi|514486271|gb|KE346361.1|	497638	497650	AGC	12	-	4	CTG
gi|514486271|gb|KE346361.1|	498162	498185	AACAGC	23	+	3	CAGCAA
gi|514486271|gb|KE346361.1|	498502	498516	AAC	14	-	4	TTG
gi|514486271|gb|KE346361.1|	498623	498639	AAC	16	-	5	TTG
gi|514486271|gb|KE346361.1|	498655	498669	AACC	14	+	3	ACCA
gi|514486271|gb|KE346361.1|	498944	498956	AGGGGG	12	-	2	TCCCCC
gi|514486271|gb|KE346361.1|	498957	498973	AAGGG	16	-	3	TCCCT
gi|514486271|gb|KE346361.1|	499059	499076	AACTG	17	-	3	GTTCA
gi|514486271|gb|KE346361.1|	499677	499692	AGCATC	15	-	2	CTGATG
gi|514486271|gb|KE346361.1|	500182	500194	ACTCTC	12	+	2	CTCACT
gi|514486271|gb|KE346361.1|	500587	500599	AGGCCG	12	-	2	CGGCCT
gi|514486271|gb|KE346361.1|	501887	501899	AATGGC	12	+	2	AATGGC
gi|514486271|gb|KE346361.1|	502364	502377	AGG	13	-	4	CTC
gi|514486271|gb|KE346361.1|	502940	502955	AAAAGC	15	+	2	AAAGCA
gi|514486271|gb|KE346361.1|	503303	503315	AGAGCG	12	-	2	CGCTCT
gi|514486271|gb|KE346361.1|	503363	503379	ACAGAG	16	-	2	TCTCTG
gi|514486271|gb|KE346361.1|	503420	503434	ACCGAG	14	-	2	TCTCGG
gi|514486271|gb|KE346361.1|	503435	503448	AGATCG	13	-	2	CGATCT
gi|514486271|gb|KE346361.1|	503452	503464	ACCGAG	12	-	2	GTCTCG
gi|514486271|gb|KE346361.1|	503488	503500	ACCGCG	12	-	2	GTCGCG
gi|514486271|gb|KE346361.1|	503501	503515	ACCGAG	14	-	2	TCTCGG
gi|514486271|gb|KE346361.1|	503531	503546	ACTCGG	15	+	2	CTCGGA
gi|514486271|gb|KE346361.1|	503546	503562	AGC	16	-	5	CTG
gi|514486271|gb|KE346361.1|	503624	503641	AGAGCG	17	+	2	CGAGAG
gi|514486271|gb|KE346361.1|	504128	504140	ACCGAG	12	-	2	TCTCGG
gi|514486271|gb|KE346361.1|	504163	504177	AGCCGC	14	-	2	GCTGCG
gi|514486271|gb|KE346361.1|	504301	504313	AACAAG	12	-	2	TTCTTG
gi|514486271|gb|KE346361.1|	506044	506064	AGG	20	+	6	AGG
gi|514486271|gb|KE346361.1|	506096	506111	AAC	15	-	5	GTT
gi|514486271|gb|KE346361.1|	506113	506129	AAAC	16	-	4	TGTT
gi|514486271|gb|KE346361.1|	506877	506893	A	16	-	16	T
gi|514486271|gb|KE346361.1|	507361	507373	ATATCC	12	-	2	ATGGAT
gi|514486271|gb|KE346361.1|	507612	507626	AAAGCT	14	+	2	AGCTAA
gi|514486271|gb|KE346361.1|	507914	507932	ACCTGC	18	-	3	GGTGCA
gi|514486271|gb|KE346361.1|	509050	509077	AGCTC	27	-	5	GAGCT
gi|514486271|gb|KE346361.1|	509193	509210	AAAAAC	17	-	2	TTTTTG
gi|514486271|gb|KE346361.1|	509824	509836	ACCTGC	12	+	2	CTGCAC
gi|514486271|gb|KE346361.1|	511454	511470	AGC	16	+	5	GCA
gi|514486271|gb|KE346361.1|	512284	512296	AAGTCC	12	+	2	TCCAAG
gi|514486271|gb|KE346361.1|	513273	513290	AGC	17	-	5	TGC
gi|514486271|gb|KE346361.1|	513582	513594	ATCCGC	12	-	2	GGATGC
gi|514486271|gb|KE346361.1|	513954	513968	ACG	14	+	4	CGA
gi|514486271|gb|KE346361.1|	515446	515464	AGC	18	+	6	CAG
gi|514486271|gb|KE346361.1|	516898	516910	AAGGAG	12	+	2	AAGGAG
gi|514486271|gb|KE346361.1|	517864	517876	AATGGC	12	-	2	TTGCCA
gi|514486271|gb|KE346361.1|	519058	519070	AGC	12	-	4	GCT
gi|514486271|gb|KE346361.1|	519119	519135	AGC	16	-	5	CTG
gi|514486271|gb|KE346361.1|	519738	519751	AAAAAG	13	-	2	TTTTTC
gi|514486271|gb|KE346361.1|	519919	519932	AAAAAC	13	-	2	TTGTTT
gi|514486271|gb|KE346361.1|	520360	520372	AC	12	-	6	GT
gi|514486271|gb|KE346361.1|	520428	520441	AAAACG	13	-	2	TCGTTT
gi|514486271|gb|KE346361.1|	520459	520471	AAAC	12	+	3	CAAA
gi|514486271|gb|KE346361.1|	520648	520665	ACCAGC	17	-	2	TGCTGG
gi|514486271|gb|KE346361.1|	520660	520693	AGC	33	-	11	TGC
gi|514486271|gb|KE346361.1|	521268	521280	A	12	+	12	A
gi|514486271|gb|KE346361.1|	521306	521321	AACG	15	+	3	AACG
gi|514486271|gb|KE346361.1|	522786	522801	ACG	15	+	5	CGA
gi|514486271|gb|KE346361.1|	522893	522909	AGC	16	-	5	GCT
gi|514486271|gb|KE346361.1|	522927	522939	ACGCCG	12	+	2	CGACGC
gi|514486271|gb|KE346361.1|	523021	523037	ATC	16	-	5	GAT
gi|514486271|gb|KE346361.1|	523193	523206	AATGAG	13	+	2	AATGAG
gi|514486271|gb|KE346361.1|	523213	523227	A	14	+	14	A
gi|514486271|gb|KE346361.1|	523525	523538	ACTGAG	13	-	2	CAGTCT
gi|514486271|gb|KE346361.1|	523680	523694	ACG	14	+	4	GAC
gi|514486271|gb|KE346361.1|	523767	523780	AAGATC	13	+	2	AAGATC
gi|514486271|gb|KE346361.1|	523996	524008	ACGAGG	12	+	2	GGACGA
gi|514486271|gb|KE346361.1|	524028	524054	ACG	26	+	8	ACG
gi|514486271|gb|KE346361.1|	524345	524374	AGCCGG	29	-	4	GCTCCG
gi|514486271|gb|KE346361.1|	525045	525057	AAGG	12	-	3	CTTC
gi|514486271|gb|KE346361.1|	526593	526605	AC	12	+	6	CA
gi|514486271|gb|KE346361.1|	527571	527588	AGGATG	17	+	2	GAGGAT
gi|514486271|gb|KE346361.1|	528105	528118	AACG	13	+	3	GAAC
gi|514486271|gb|KE346361.1|	528398	528410	ACACG	12	+	2	CACGA
gi|514486271|gb|KE346361.1|	529850	529862	AAGTC	12	+	2	CAAGT
gi|514486271|gb|KE346361.1|	533045	533058	AGAGGG	13	-	2	CTCCCT
gi|514486271|gb|KE346361.1|	533055	533079	AGAGG	24	-	4	CTCCT
gi|514486271|gb|KE346361.1|	534126	534138	AGC	12	-	4	TGC
gi|514486271|gb|KE346361.1|	534221	534233	AGCCTC	12	-	2	TGAGGC
gi|514486271|gb|KE346361.1|	535673	535686	ATCGC	13	-	2	CGATG
gi|514486271|gb|KE346361.1|	535804	535817	A	13	+	13	A
gi|514486271|gb|KE346361.1|	537754	537774	AGC	20	-	6	CTG
gi|514486271|gb|KE346361.1|	537775	537793	CCG	18	-	6	GCG
gi|514486271|gb|KE346361.1|	537857	537869	AGC	12	-	4	GCT
gi|514486271|gb|KE346361.1|	539087	539099	AAC	12	-	4	TTG
gi|514486271|gb|KE346361.1|	539880	539892	AAGC	12	+	3	GCAA
gi|514486271|gb|KE346361.1|	540003	540017	AACAGC	14	-	2	GCTGTT
gi|514486271|gb|KE346361.1|	540474	540486	AAAACC	12	+	2	CAAAAC
gi|514486271|gb|KE346361.1|	540572	540584	AACACC	12	+	2	ACACCA
gi|514486271|gb|KE346361.1|	540987	540999	AAAAC	12	-	2	TTGTT
gi|514486271|gb|KE346361.1|	541200	541213	AGGCC	13	+	2	GGCCA
gi|514486271|gb|KE346361.1|	541426	541438	ACGAGC	12	+	2	AGCACG
gi|514486271|gb|KE346361.1|	541715	541728	ACACCC	13	+	2	CACACC
gi|514486271|gb|KE346361.1|	541749	541765	A	16	+	16	A
gi|514486271|gb|KE346361.1|	541905	541918	AAAAAC	13	+	2	AAAACA
gi|514486271|gb|KE346361.1|	543131	543156	A	25	-	25	T
gi|514486271|gb|KE346361.1|	543265	543277	A	12	-	12	T
gi|514486271|gb|KE346361.1|	543351	543368	A	17	-	17	T
gi|514486271|gb|KE346361.1|	543592	543611	A	19	-	19	T
gi|514486271|gb|KE346361.1|	543979	543991	ACCAGC	12	-	2	TGGTGC
gi|514486271|gb|KE346361.1|	544114	544134	AG	20	-	10	TC
gi|514486271|gb|KE346361.1|	544134	544157	AG	23	-	11	CT
gi|514486271|gb|KE346361.1|	544252	544264	AAATAC	12	-	2	ATTTGT
gi|514486271|gb|KE346361.1|	544364	544376	AACCTT	12	+	2	AACCTT
gi|514486271|gb|KE346361.1|	544423	544437	AAAAC	14	+	2	AAAAC
gi|514486271|gb|KE346361.1|	544958	544975	A	17	+	17	A
gi|514486271|gb|KE346361.1|	546982	547084	AAACGC	102	-	17	CGTTTG
gi|514486271|gb|KE346361.1|	547095	547107	AAAAGC	12	-	2	TTTTGC
gi|514486271|gb|KE346361.1|	547685	547697	AACGCC	12	-	2	TTGGCG
gi|514486271|gb|KE346361.1|	550486	550499	AAGCAG	13	-	2	TGCTTC
gi|514486271|gb|KE346361.1|	550813	550825	ACTCGC	12	+	2	CACTCG
gi|514486271|gb|KE346361.1|	550976	550994	AGC	18	-	6	TGC
gi|514486271|gb|KE346361.1|	551016	551028	ACC	12	+	4	CCA
gi|514486271|gb|KE346361.1|	551581	551595	AAAAG	14	-	2	TTTTC
gi|514486271|gb|KE346361.1|	551621	551638	AAC	17	-	5	TTG
gi|514486271|gb|KE346361.1|	552301	552314	AATCAC	13	-	2	TTGTGA
gi|514486271|gb|KE346361.1|	552545	552560	AAAAAC	15	-	2	TTTGTT
gi|514486271|gb|KE346361.1|	554295	554307	AAATGG	12	-	2	CCATTT
gi|514486271|gb|KE346361.1|	554354	554368	ACG	14	+	4	GAC
gi|514486271|gb|KE346361.1|	554493	554517	AAAC	24	+	6	CAAA
gi|514486271|gb|KE346361.1|	554705	554720	AAGAAT	15	-	2	TTATTC
gi|514486271|gb|KE346361.1|	555028	555043	ACC	15	-	5	GTG
gi|514486271|gb|KE346361.1|	555041	555053	AGC	12	-	4	TGC
gi|514486271|gb|KE346361.1|	555103	555116	ACTGAG	13	-	2	CTCAGT
gi|514486271|gb|KE346361.1|	555252	555264	ATCGCC	12	+	2	TCGCCA
gi|514486271|gb|KE346361.1|	555740	555764	A	24	-	24	T
gi|514486271|gb|KE346361.1|	556391	556408	ACGAGC	17	-	2	GCTCGT
gi|514486271|gb|KE346361.1|	556828	556841	AAAAC	13	-	2	TTGTT
gi|514486271|gb|KE346361.1|	556847	556866	AAAC	19	-	4	TTTG
gi|514486271|gb|KE346361.1|	558854	558870	AAAAAC	16	+	2	AAAAAC
gi|514486271|gb|KE346361.1|	558916	558929	ACTCTC	13	+	2	CTCTCA
gi|514486271|gb|KE346361.1|	559157	559173	A	16	+	16	A
gi|514486271|gb|KE346361.1|	559815	559827	ATGCCC	12	+	2	CCATGC
gi|514486271|gb|KE346361.1|	559908	559920	AGGGG	12	+	2	GGAGG
gi|514486271|gb|KE346361.1|	560353	560367	AACAAT	14	+	2	AACAAT
gi|514486271|gb|KE346361.1|	561042	561054	AGC	12	+	4	GCA
gi|514486271|gb|KE346361.1|	561105	561128	AGC	23	+	7	GCA
gi|514486271|gb|KE346361.1|	561321	561417	AG	96	+	48	GA
gi|514486271|gb|KE346361.1|	561426	561438	AAAAAG	12	+	2	AAAAAG
gi|514486271|gb|KE346361.1|	561973	561987	AAGG	14	-	3	TCCT
gi|514486271|gb|KE346361.1|	563389	563401	AAAAC	12	+	2	AACAA
gi|514486271|gb|KE346361.1|	565083	565204	AC	121	+	60	AC
gi|514486271|gb|KE346361.1|	565412	565424	A	12	+	12	A
gi|514486271|gb|KE346361.1|	565716	565731	AAAC	15	+	3	AAAC
gi|514486271|gb|KE346361.1|	567055	567067	AATAC	12	-	2	GTATT
gi|514486271|gb|KE346361.1|	567143	567164	A	21	-	21	T
gi|514486271|gb|KE346361.1|	568443	568456	AAGCAC	13	-	2	TGCTTG
gi|514486271|gb|KE346361.1|	569266	569279	AAAATC	13	-	2	TGATTT
gi|514486271|gb|KE346361.1|	569595	569609	AG	14	-	7	TC
gi|514486271|gb|KE346361.1|	569610	569624	AAAGAG	14	-	2	TTCTCT
gi|514486271|gb|KE346361.1|	569856	569871	AACTTC	15	+	2	TTCAAC
gi|514486271|gb|KE346361.1|	570011	570024	AACGG	13	-	2	TTCCG
gi|514486271|gb|KE346361.1|	570049	570062	A	13	-	13	T
gi|514486271|gb|KE346361.1|	570145	570169	AGGCG	24	-	4	CCTCG
gi|514486271|gb|KE346361.1|	570211	570229	AG	18	-	9	TC
gi|514486271|gb|KE346361.1|	570307	570320	AAAAAT	13	-	2	TTTTTA
gi|514486271|gb|KE346361.1|	570338	570357	AG	19	-	9	CT
gi|514486271|gb|KE346361.1|	570435	570450	ACTC	15	-	3	GAGT
gi|514486271|gb|KE346361.1|	570452	570464	ACTC	12	-	3	TGAG
gi|514486271|gb|KE346361.1|	572070	572082	AATGAC	12	-	2	CATTGT
gi|514486271|gb|KE346361.1|	572340	572352	AG	12	+	6	AG
gi|514486271|gb|KE346361.1|	572400	572416	A	16	+	16	A
gi|514486271|gb|KE346361.1|	572859	572871	AAAC	12	+	3	CAAA
gi|514486271|gb|KE346361.1|	572874	572886	A	12	+	12	A
gi|514486271|gb|KE346361.1|	574442	574455	A	13	+	13	A
gi|514486271|gb|KE346361.1|	575386	575399	A	13	+	13	A
gi|514486271|gb|KE346361.1|	575978	575990	ACAG	12	+	3	ACAG
gi|514486271|gb|KE346361.1|	576137	576150	AAAGCC	13	-	2	TGGCTT
gi|514486271|gb|KE346361.1|	576297	576309	AAAATG	12	+	2	TGAAAA
gi|514486271|gb|KE346361.1|	576681	576694	AGC	13	+	4	GCA
gi|514486271|gb|KE346361.1|	576781	576798	AGC	17	+	5	CAG
gi|514486271|gb|KE346361.1|	576914	576927	AGCATC	13	+	2	ATCAGC
gi|514486271|gb|KE346361.1|	577036	577063	AGC	27	+	9	CAG
gi|514486271|gb|KE346361.1|	577195	577218	AGC	23	+	7	CAG
gi|514486271|gb|KE346361.1|	577314	577330	AGC	16	+	5	GCA
gi|514486271|gb|KE346361.1|	577509	577521	AATCCG	12	-	2	CGGATT
gi|514486271|gb|KE346361.1|	577944	577956	ACCAGC	12	-	2	TGCTGG
gi|514486271|gb|KE346361.1|	577970	577992	AAC	22	+	7	ACA
gi|514486271|gb|KE346361.1|	578093	578106	AGCGCC	13	+	2	AGCGCC
gi|514486271|gb|KE346361.1|	578858	578870	AAATGG	12	-	2	TTTCCA
gi|514486271|gb|KE346361.1|	578877	578889	ACACGT	12	+	2	GTACAC
gi|514486271|gb|KE346361.1|	579574	579600	AAAC	26	+	6	AACA
gi|514486271|gb|KE346361.1|	579597	579609	A	12	+	12	A
gi|514486271|gb|KE346361.1|	580353	580372	AG	19	+	9	AG
gi|514486271|gb|KE346361.1|	580382	580395	A	13	+	13	A
gi|514486271|gb|KE346361.1|	580950	580964	AGAGCC	14	-	2	TCTGGC
gi|514486271|gb|KE346361.1|	581043	581056	ACGCAG	13	+	2	GACGCA
gi|514486271|gb|KE346361.1|	581441	581464	A	23	+	23	A
gi|514486271|gb|KE346361.1|	582025	582038	AACTGC	13	-	2	GCAGTT
gi|514486271|gb|KE346361.1|	582431	582446	A	15	-	15	T
gi|514486271|gb|KE346361.1|	583373	583385	AAAAC	12	+	2	AAACA
gi|514486271|gb|KE346361.1|	583379	583401	AAAC	22	+	5	AACA
gi|514486271|gb|KE346361.1|	583399	583470	AAAC	71	+	17	AAAC
gi|514486271|gb|KE346361.1|	585002	585021	ACTG	19	-	4	CAGT
gi|514486271|gb|KE346361.1|	585933	585946	ACGCGG	13	+	2	GGACGC
gi|514486271|gb|KE346361.1|	586116	586129	AATCTC	13	-	2	TGAGAT
gi|514486271|gb|KE346361.1|	586285	586298	ACTGAG	13	+	2	GACTGA
gi|514486271|gb|KE346361.1|	586427	586439	A	12	+	12	A
gi|514486271|gb|KE346361.1|	587298	587310	AGGGG	12	-	2	CCCTC
gi|514486271|gb|KE346361.1|	587931	587943	AGGGGG	12	-	2	CCCCCT
gi|514486271|gb|KE346361.1|	588279	588293	AGCGGC	14	+	2	GCAGCG
gi|514486271|gb|KE346361.1|	588408	588420	ACGCTG	12	+	2	ACGCTG
gi|514486271|gb|KE346361.1|	589929	589941	AAAAAC	12	+	2	AAAACA
gi|514486271|gb|KE346361.1|	589938	589953	AC	15	+	7	AC
gi|514486271|gb|KE346361.1|	590310	590322	AACAAG	12	+	2	CAAGAA
gi|514486271|gb|KE346361.1|	592730	592743	ACAGGC	13	-	2	CTGTGC
gi|514486271|gb|KE346361.1|	593485	593503	AGC	18	-	6	GCT
gi|514486271|gb|KE346361.1|	593982	593995	AAACC	13	-	2	TTGGT
gi|514486271|gb|KE346361.1|	594203	594223	AAC	20	-	6	TTG
gi|514486271|gb|KE346361.1|	598121	598133	ACCGCC	12	-	2	CGGTGG
gi|514486271|gb|KE346361.1|	599688	599703	ACC	15	+	5	CCA
gi|514486271|gb|KE346361.1|	600719	600731	ACACAG	12	+	2	GACACA
gi|514486271|gb|KE346361.1|	601775	601800	ATC	25	+	8	TCA
gi|514486271|gb|KE346361.1|	601801	601842	ATC	41	+	13	ATC
gi|514486271|gb|KE346361.1|	604916	604939	AG	23	+	11	GA
gi|514486271|gb|KE346361.1|	605063	605075	AC	12	-	6	TG
gi|514486271|gb|KE346361.1|	605073	605100	AACC	27	-	6	TGGT
gi|514486271|gb|KE346361.1|	605157	605170	AG	13	-	6	CT
gi|514486271|gb|KE346361.1|	605427	605439	AAAT	12	+	3	AAAT
gi|514486271|gb|KE346361.1|	605486	605500	AG	14	+	7	AG
gi|514486271|gb|KE346361.1|	605753	605778	ACTGAG	25	-	4	CAGTCT
gi|514486271|gb|KE346361.1|	605855	605869	AG	14	-	7	TC
gi|514486271|gb|KE346361.1|	606041	606055	AGC	14	+	4	CAG
gi|514486271|gb|KE346361.1|	606053	606067	AAC	14	+	4	CAA
gi|514486271|gb|KE346361.1|	606151	606165	AGGGCG	14	-	2	CCTCGC
gi|514486271|gb|KE346361.1|	606163	606175	ACTGGG	12	-	2	CCCAGT
gi|514486271|gb|KE346361.1|	606219	606236	AGAGCC	17	-	2	TCTGGC
gi|514486271|gb|KE346361.1|	606309	606321	ACC	12	+	4	CAC
gi|514486271|gb|KE346361.1|	606586	606598	ACG	12	-	4	TCG
gi|514486271|gb|KE346361.1|	606747	606760	ACCCC	13	-	2	TGGGG
gi|514486271|gb|KE346361.1|	607312	607324	ACCCTC	12	+	2	CCTCAC
gi|514486271|gb|KE346361.1|	607588	607601	ACATCG	13	-	2	CGATGT
gi|514486271|gb|KE346361.1|	608366	608390	A	24	-	24	T
gi|514486271|gb|KE346361.1|	609074	609086	AAC	12	-	4	GTT
gi|514486271|gb|KE346361.1|	609153	609165	A	12	+	12	A
gi|514486271|gb|KE346361.1|	610549	610561	AAAAAC	12	+	2	AAAAAC
gi|514486271|gb|KE346361.1|	610718	610730	A	12	+	12	A
gi|514486271|gb|KE346361.1|	610752	610764	AGAGG	12	-	2	CTCTC
gi|514486271|gb|KE346361.1|	611049	611069	A	20	+	20	A
gi|514486271|gb|KE346361.1|	611225	611244	A	19	+	19	A
gi|514486271|gb|KE346361.1|	611270	611288	A	18	-	18	T
gi|514486271|gb|KE346361.1|	611559	611572	A	13	+	13	A
gi|514486271|gb|KE346361.1|	612254	612266	AC	12	-	6	GT
gi|514486271|gb|KE346361.1|	613539	613551	A	12	-	12	T
gi|514486271|gb|KE346361.1|	613566	613579	A	13	-	13	T
gi|514486271|gb|KE346361.1|	613589	613602	A	13	-	13	T
gi|514486271|gb|KE346361.1|	613757	613773	A	16	+	16	A
gi|514486271|gb|KE346361.1|	613834	613848	AAAAG	14	-	2	CTTTT
gi|514486271|gb|KE346361.1|	613866	613884	A	18	-	18	T
gi|514486271|gb|KE346361.1|	614113	614126	C	13	+	13	C
gi|514486271|gb|KE346361.1|	614658	614671	AGG	13	-	4	CCT
gi|514486271|gb|KE346361.1|	614702	614718	AAC	16	+	5	CAA
gi|514486271|gb|KE346361.1|	616153	616168	AGC	15	+	5	GCA
gi|514486271|gb|KE346361.1|	616183	616195	AACAGC	12	+	2	GCAACA
gi|514486271|gb|KE346361.1|	616205	616218	AGC	13	+	4	CAG
gi|514486271|gb|KE346361.1|	617315	617327	AAGAT	12	-	2	TTATC
gi|514486271|gb|KE346361.1|	617371	617387	AC	16	-	8	GT
gi|514486271|gb|KE346361.1|	617795	617807	ACAG	12	+	3	ACAG
gi|514486271|gb|KE346361.1|	617836	617859	A	23	-	23	T
gi|514486271|gb|KE346361.1|	618014	618038	AAAAT	24	-	4	TTTTA
gi|514486271|gb|KE346361.1|	618037	618056	AAAAT	19	-	3	TTTTA
gi|514486271|gb|KE346361.1|	618054	618067	AAAAT	13	-	2	TTTTA
gi|514486271|gb|KE346361.1|	618117	618129	AGCCG	12	-	2	GGCTC
gi|514486271|gb|KE346361.1|	618260	618294	A	34	+	34	A
gi|514486271|gb|KE346361.1|	619084	619096	AACAAT	12	-	2	ATTGTT
gi|514486271|gb|KE346361.1|	619234	619246	AAAC	12	-	3	GTTT
gi|514486271|gb|KE346361.1|	619240	619254	AAAAAC	14	-	2	TTGTTT
gi|514486271|gb|KE346361.1|	619266	619295	AAAC	29	-	7	TTGT
gi|514486271|gb|KE346361.1|	620226	620238	AAGTAC	12	-	2	ACTTGT
gi|514486271|gb|KE346361.1|	620581	620610	A	29	-	29	T
gi|514486271|gb|KE346361.1|	621178	621201	A	23	+	23	A
gi|514486271|gb|KE346361.1|	621364	621384	AAT	20	-	6	TTA
gi|514486271|gb|KE346361.1|	621596	621616	A	20	+	20	A
gi|514486271|gb|KE346361.1|	621840	621853	A	13	-	13	T
gi|514486271|gb|KE346361.1|	621877	621891	AAAGAG	14	-	2	TCTTTC
gi|514486271|gb|KE346361.1|	622006	622027	AAAAAC	21	-	3	TTTTGT
gi|514486271|gb|KE346361.1|	622253	622269	ACTGCT	16	+	2	ACTGCT
gi|514486271|gb|KE346361.1|	622675	622687	AGCGGC	12	+	2	GCGGCA
gi|514486271|gb|KE346361.1|	622880	622893	ACCTCC	13	+	2	CCTCCA
gi|514486271|gb|KE346361.1|	622993	623011	CCG	18	+	6	CCG
gi|514486271|gb|KE346361.1|	623106	623118	ACCGCC	12	+	2	GCCACC
gi|514486271|gb|KE346361.1|	623148	623160	ACC	12	+	4	ACC
gi|514486271|gb|KE346361.1|	623167	623182	CCG	15	+	5	CCG
gi|514486271|gb|KE346361.1|	623308	623320	A	12	-	12	T
gi|514486271|gb|KE346361.1|	623318	623332	AAG	14	-	4	TTC
gi|514486271|gb|KE346361.1|	623504	623516	A	12	-	12	T
gi|514486271|gb|KE346361.1|	623646	623658	AACGAT	12	-	2	GTTATC
gi|514486271|gb|KE346361.1|	623774	623786	AGCCGC	12	+	2	AGCCGC
gi|514486271|gb|KE346361.1|	623863	623875	ACGATC	12	+	2	GATCAC
gi|514486271|gb|KE346361.1|	623957	623969	ATC	12	+	4	ATC
gi|514486271|gb|KE346361.1|	624963	624977	AATGCC	14	-	2	GCATTG
gi|514486271|gb|KE346361.1|	625595	625607	AATAC	12	-	2	TGTAT
gi|514486271|gb|KE346361.1|	625882	625895	AATTCC	13	-	2	GGAATT
gi|514486271|gb|KE346361.1|	625984	625996	ATCCC	12	-	2	GGGAT
gi|514486271|gb|KE346361.1|	628173	628190	ATC	17	+	5	CAT
gi|514486271|gb|KE346361.1|	628374	628386	ACC	12	-	4	GGT
gi|514486271|gb|KE346361.1|	630476	630489	ACTCGC	13	-	2	TGCGAG
gi|514486271|gb|KE346361.1|	630517	630529	AAG	12	+	4	AGA
gi|514486271|gb|KE346361.1|	631892	631904	AAAAC	12	+	2	AAACA
gi|514486271|gb|KE346361.1|	631939	631953	AAC	14	+	4	AAC
gi|514486271|gb|KE346361.1|	632239	632251	ACGAGG	12	-	2	CCTCGT
gi|514486271|gb|KE346361.1|	632396	632408	AAAAAC	12	-	2	TTTTTG
gi|514486271|gb|KE346361.1|	632448	632460	AAGCTC	12	-	2	GAGCTT
gi|514486271|gb|KE346361.1|	632527	632539	ACGAGC	12	-	2	TGCTCG
gi|514486271|gb|KE346361.1|	632721	632733	AACCTC	12	+	2	CTCAAC
gi|514486271|gb|KE346361.1|	632808	632820	AACGG	12	+	2	GAACG
gi|514486271|gb|KE346361.1|	633038	633050	ACGGCC	12	-	2	GGCCGT
gi|514486271|gb|KE346361.1|	633426	633446	A	20	+	20	A
gi|514486271|gb|KE346361.1|	634020	634033	A	13	+	13	A
gi|514486271|gb|KE346361.1|	634119	634131	ACAGCG	12	+	2	CGACAG
gi|514486271|gb|KE346361.1|	634245	634273	A	28	+	28	A
gi|514486271|gb|KE346361.1|	634294	634308	A	14	+	14	A
gi|514486271|gb|KE346361.1|	634474	634490	A	16	+	16	A
gi|514486271|gb|KE346361.1|	634688	634708	A	20	+	20	A
gi|514486271|gb|KE346361.1|	635147	635159	AATGTC	12	-	2	TTGACA
gi|514486271|gb|KE346361.1|	635289	635302	ACCCC	13	+	2	CCCAC
gi|514486271|gb|KE346361.1|	635415	635436	A	21	-	21	T
gi|514486271|gb|KE346361.1|	636696	636719	AAAC	23	-	5	GTTT
gi|514486271|gb|KE346361.1|	637409	637421	AAGC	12	-	3	TTGC
gi|514486271|gb|KE346361.1|	638261	638283	A	22	-	22	T
gi|514486271|gb|KE346361.1|	638915	638927	AGAGCG	12	-	2	GCTCTC
gi|514486271|gb|KE346361.1|	638922	638948	AG	26	-	13	CT
gi|514486271|gb|KE346361.1|	638995	639007	ACTATG	12	-	2	GTCATA
gi|514486271|gb|KE346361.1|	639189	639205	ATC	16	-	5	GAT
gi|514486271|gb|KE346361.1|	639351	639363	ACATCG	12	-	2	TGTCGA
gi|514486271|gb|KE346361.1|	640199	640211	AACGAG	12	-	2	TCTCGT
gi|514486271|gb|KE346361.1|	641124	641144	A	20	+	20	A
gi|514486271|gb|KE346361.1|	641480	641494	A	14	+	14	A
gi|514486271|gb|KE346361.1|	641623	641639	AAAAAG	16	-	2	TTTTTC
gi|514486271|gb|KE346361.1|	641784	641807	A	23	-	23	T
gi|514486271|gb|KE346361.1|	641820	641832	A	12	-	12	T
gi|514486271|gb|KE346361.1|	642013	642037	A	24	-	24	T
gi|514486271|gb|KE346361.1|	642034	642046	AAACAG	12	-	2	TTTCTG
gi|514486271|gb|KE346361.1|	642161	642185	AAAAGC	24	-	4	TTTGCT
gi|514486271|gb|KE346361.1|	643729	643742	ACCATC	13	+	2	ATCACC
gi|514486271|gb|KE346361.1|	644134	644147	AGC	13	-	4	TGC
gi|514486271|gb|KE346361.1|	644195	644210	AATTAC	15	+	2	AATTAC
gi|514486271|gb|KE346361.1|	644237	644249	AGGATG	12	+	2	AGGATG
gi|514486271|gb|KE346361.1|	644454	644468	AAAAG	14	+	2	AAAAG
gi|514486271|gb|KE346361.1|	644695	644714	A	19	-	19	T
gi|514486271|gb|KE346361.1|	644890	644911	ACG	21	+	7	ACG
gi|514486271|gb|KE346361.1|	644973	644985	AGGGGG	12	+	2	GGGAGG
gi|514486271|gb|KE346361.1|	644984	644998	AG	14	+	7	GA
gi|514486271|gb|KE346361.1|	644999	645106	AG	107	+	53	AG
gi|514486271|gb|KE346361.1|	645171	645183	AAC	12	-	4	GTT
gi|514486271|gb|KE346361.1|	646002	646027	A	25	-	25	T
gi|514486271|gb|KE346361.1|	646048	646060	AAACTG	12	-	2	CAGTTT
gi|514486271|gb|KE346361.1|	646070	646084	AAAAG	14	-	2	CTTTT
gi|514486271|gb|KE346361.1|	646277	646295	AATAGT	18	-	3	ACTATT
gi|514486271|gb|KE346361.1|	646487	646499	AACC	12	+	3	AACC
gi|514486271|gb|KE346361.1|	647059	647074	ATC	15	-	5	ATG
gi|514486271|gb|KE346361.1|	647279	647292	AATGAG	13	+	2	AGAATG
gi|514486271|gb|KE346361.1|	647292	647312	AGC	20	-	6	TGC
gi|514486271|gb|KE346361.1|	647767	647781	AAC	14	+	4	ACA
gi|514486271|gb|KE346361.1|	648542	648558	AGGATG	16	-	2	CCTCAT
gi|514486271|gb|KE346361.1|	649109	649121	ACATGC	12	-	2	ATGTGC
gi|514486271|gb|KE346361.1|	651514	651527	AGC	13	-	4	GCT
gi|514486271|gb|KE346361.1|	658999	659012	ACTCG	13	-	2	GTCGA
gi|514486271|gb|KE346361.1|	659068	659083	AGCGCG	15	+	2	GAGCGC
gi|514486271|gb|KE346361.1|	659184	659196	AGCCC	12	+	2	CCCAG
gi|514486271|gb|KE346361.1|	660196	660211	ACG	15	+	5	GAC
gi|514486271|gb|KE346361.1|	660798	660810	AGC	12	-	4	TGC
gi|514486271|gb|KE346361.1|	662055	662067	AGCGGC	12	-	2	GCTGCC
gi|514486271|gb|KE346361.1|	662824	662841	AAGGCG	17	+	2	GGCGAA
gi|514486271|gb|KE346361.1|	662836	662848	ACGGCG	12	+	2	GGCGAC
gi|514486271|gb|KE346361.1|	662893	662905	AAGGCG	12	+	2	GAAGGC
gi|514486271|gb|KE346361.1|	663580	663597	AGG	17	+	5	GAG
gi|514486271|gb|KE346361.1|	663710	663722	AAGGCG	12	+	2	AAGGCG
gi|514486271|gb|KE346361.1|	663728	663740	AAG	12	+	4	AAG
gi|514486271|gb|KE346361.1|	663787	663803	CCG	16	-	5	GGC
gi|514486271|gb|KE346361.1|	664271	664284	AAGAGG	13	+	2	AGGAAG
gi|514486271|gb|KE346361.1|	664456	664468	AGC	12	+	4	CAG
gi|514486271|gb|KE346361.1|	664619	664631	AGGCCG	12	+	2	CCGAGG
gi|514486271|gb|KE346361.1|	664804	664822	ACG	18	+	6	GAC
gi|514486271|gb|KE346361.1|	665930	665943	AATGCC	13	+	2	ATGCCA
gi|514486271|gb|KE346361.1|	666202	666215	AAAC	13	-	3	TTGT
gi|514486271|gb|KE346361.1|	666257	666270	AAAC	13	-	3	TTTG
gi|514486271|gb|KE346361.1|	666403	666417	AC	14	+	7	CA
gi|514486271|gb|KE346361.1|	666600	666614	AAAAAC	14	+	2	AAAACA
gi|514486271|gb|KE346361.1|	667449	667461	ACTC	12	-	3	GAGT
gi|514486271|gb|KE346361.1|	667564	667588	ATC	24	-	8	TGA
gi|514486271|gb|KE346361.1|	667806	667818	AAATGG	12	+	2	AATGGA
gi|514486271|gb|KE346361.1|	668639	668652	A	13	+	13	A
gi|514486271|gb|KE346361.1|	668669	668681	AAC	12	+	4	CAA
gi|514486271|gb|KE346361.1|	669011	669034	ACC	23	+	7	CAC
gi|514486271|gb|KE346361.1|	669324	669336	ACTC	12	+	3	CTCA
gi|514486271|gb|KE346361.1|	669579	669597	ACC	18	-	6	GGT
gi|514486271|gb|KE346361.1|	670043	670059	AG	16	-	8	CT
gi|514486271|gb|KE346361.1|	670441	670453	AATG	12	+	3	TGAA
gi|514486271|gb|KE346361.1|	670497	670510	AACAGC	13	+	2	AACAGC
gi|514486271|gb|KE346361.1|	671909	671923	AAAC	14	+	3	AACA
gi|514486271|gb|KE346361.1|	671975	672005	AAC	30	-	10	TTG
gi|514486271|gb|KE346361.1|	673564	673576	AGCGCC	12	-	2	TGGCGC
gi|514486271|gb|KE346361.1|	674462	674475	ACTGC	13	-	2	GTGCA
gi|514486271|gb|KE346361.1|	674515	674527	ACCGTG	12	-	2	TCACGG
gi|514486271|gb|KE346361.1|	674741	674759	CCG	18	+	6	CGC
gi|514486271|gb|KE346361.1|	674775	674791	ATC	16	-	5	GAT
gi|514486271|gb|KE346361.1|	674907	674920	AATGGC	13	-	2	CCATTG
gi|514486271|gb|KE346361.1|	674917	674935	AGC	18	-	6	TGC
gi|514486271|gb|KE346361.1|	674939	674953	ACCATC	14	-	2	GTGATG
gi|514486271|gb|KE346361.1|	675127	675141	A	14	+	14	A
gi|514486271|gb|KE346361.1|	675367	675379	AAGTCG	12	+	2	CGAAGT
gi|514486271|gb|KE346361.1|	675379	675391	C	12	-	12	G
gi|514486271|gb|KE346361.1|	675455	675467	ACCCCC	12	-	2	GGGTGG
gi|514486271|gb|KE346361.1|	675470	675488	AG	18	+	9	GA
gi|514486271|gb|KE346361.1|	675587	675599	AAC	12	+	4	CAA
gi|514486271|gb|KE346361.1|	675628	675646	AATG	18	-	4	CATT
gi|514486271|gb|KE346361.1|	675682	675695	AACTCG	13	-	2	TTCGAG
gi|514486271|gb|KE346361.1|	675729	675741	A	12	+	12	A
gi|514486271|gb|KE346361.1|	675830	675843	AAAAAG	13	+	2	AAAAAG
gi|514486271|gb|KE346361.1|	676858	676870	AAAACC	12	-	2	TTTTGG
gi|514486271|gb|KE346361.1|	677818	677834	AAACCC	16	-	2	TTTGGG
gi|514486271|gb|KE346361.1|	678655	678674	ACG	19	-	6	GTC
gi|514486271|gb|KE346361.1|	679093	679109	ACG	16	-	5	GTC
gi|514486271|gb|KE346361.1|	679429	679441	ACGATG	12	-	2	ATCGTC
gi|514486271|gb|KE346361.1|	679664	679677	AAC	13	-	4	GTT
gi|514486271|gb|KE346361.1|	679675	679689	AGC	14	-	4	TGC
gi|514486271|gb|KE346361.1|	679916	679928	AAGCCG	12	-	2	TCGGCT
gi|514486271|gb|KE346361.1|	680399	680411	AACTC	12	-	2	TGAGT
gi|514486271|gb|KE346361.1|	680434	680530	AC	96	-	48	GT
gi|514486271|gb|KE346361.1|	681098	681110	AAAAC	12	+	2	AACAA
gi|514486271|gb|KE346361.1|	681219	681238	ACC	19	+	6	CCA
gi|514486271|gb|KE346361.1|	681520	681532	AAAGG	12	+	2	AAGGA
gi|514486271|gb|KE346361.1|	681529	681543	AAAAC	14	+	2	AAAAC
gi|514486271|gb|KE346361.1|	681581	681594	A	13	+	13	A
gi|514486271|gb|KE346361.1|	681595	681609	A	14	+	14	A
gi|514486271|gb|KE346361.1|	681888	681900	AAAGCG	12	+	2	AAGCGA
gi|514486271|gb|KE346361.1|	683220	683233	AAAC	13	-	3	GTTT
gi|514486271|gb|KE346361.1|	683234	683258	AAAC	24	-	6	TTGT
gi|514486271|gb|KE346361.1|	683687	683700	ATCCGC	13	+	2	CCGCAT
gi|514486271|gb|KE346361.1|	684944	684969	A	25	-	25	T
gi|514486271|gb|KE346361.1|	685264	685276	CCG	12	-	4	GCG
gi|514486271|gb|KE346361.1|	685280	685294	ACCGCC	14	-	2	GGCGGT
gi|514486271|gb|KE346361.1|	685377	685391	AATGAC	14	+	2	ATGACA
gi|514486271|gb|KE346361.1|	686630	686643	AAGAGC	13	+	2	CAAGAG
gi|514486271|gb|KE346361.1|	686741	686766	AGC	25	+	8	CAG
gi|514486271|gb|KE346361.1|	686898	686913	AAC	15	-	5	TTG
gi|514486271|gb|KE346361.1|	687578	687593	AAC	15	+	5	CAA
gi|514486271|gb|KE346361.1|	687821	687844	AAG	23	+	7	AAG
gi|514486271|gb|KE346361.1|	687957	687969	AGGGGC	12	+	2	GCAGGG
gi|514486271|gb|KE346361.1|	688236	688249	AAAAAG	13	+	2	AAAGAA
gi|514486271|gb|KE346361.1|	688250	688310	A	60	+	60	A
gi|514486271|gb|KE346361.1|	689508	689528	ACC	20	-	6	GTG
gi|514486271|gb|KE346361.1|	689994	690014	AGG	20	+	6	GAG
gi|514486271|gb|KE346361.1|	690364	690379	ACT	15	-	5	TAG
gi|514486271|gb|KE346361.1|	690461	690482	ATC	21	-	7	TGA
gi|514486271|gb|KE346361.1|	690701	690714	AAG	13	+	4	GAA
gi|514486271|gb|KE346361.1|	691166	691178	AAAG	12	+	3	GAAA
gi|514486271|gb|KE346361.1|	691221	691241	A	20	-	20	T
gi|514486271|gb|KE346361.1|	691373	691390	A	17	+	17	A
gi|514486271|gb|KE346361.1|	691613	691629	A	16	+	16	A
gi|514486271|gb|KE346361.1|	691672	691689	A	17	+	17	A
gi|514486271|gb|KE346361.1|	691851	691870	A	19	+	19	A
gi|514486271|gb|KE346361.1|	692056	692073	AAC	17	+	5	AAC
gi|514486271|gb|KE346361.1|	692071	692095	A	24	+	24	A
gi|514486271|gb|KE346361.1|	692165	692177	AAAAAT	12	+	2	AAAATA
gi|514486271|gb|KE346361.1|	692189	692201	AAATAC	12	+	2	TACAAA
gi|514486271|gb|KE346361.1|	692232	692249	AAAAC	17	-	3	TTGTT
gi|514486271|gb|KE346361.1|	692994	693006	AGAGC	12	-	2	TGCTC
gi|514486271|gb|KE346361.1|	693259	693271	ATGCGC	12	+	2	TGCGCA
gi|514486271|gb|KE346361.1|	693579	693596	AGG	17	-	5	TCC
gi|514486271|gb|KE346361.1|	693834	693856	ACC	22	-	7	TGG
gi|514486271|gb|KE346361.1|	695835	695847	AAAGCC	12	-	2	TGGCTT
gi|514486271|gb|KE346361.1|	695940	695952	AGAGCT	12	+	2	CTAGAG
gi|514486271|gb|KE346361.1|	696193	696210	AACAGC	17	+	2	CAGCAA
gi|514486271|gb|KE346361.1|	696205	696229	AGC	24	+	8	CAG
gi|514486271|gb|KE346361.1|	698127	698152	AAGGAG	25	+	4	GAAGGA
gi|514486271|gb|KE346361.1|	700306	700330	AGG	24	+	8	GAG
gi|514486271|gb|KE346361.1|	702592	702604	ATCGCC	12	-	2	CGATGG
gi|514486271|gb|KE346361.1|	703179	703196	AGG	17	+	5	AGG
gi|514486271|gb|KE346361.1|	703431	703443	AAGGTG	12	+	2	GTGAAG
gi|514486271|gb|KE346361.1|	704578	704593	A	15	+	15	A
gi|514486271|gb|KE346361.1|	704816	704831	AGCC	15	+	3	AGCC
gi|514486271|gb|KE346361.1|	705435	705450	AACC	15	+	3	CAAC
gi|514486271|gb|KE346361.1|	705704	705716	C	12	-	12	G
gi|514486271|gb|KE346361.1|	706062	706076	AACC	14	+	3	AACC
gi|514486271|gb|KE346361.1|	706365	706378	AAAC	13	+	3	AAAC
gi|514486271|gb|KE346361.1|	706708	706722	A	14	+	14	A
gi|514486271|gb|KE346361.1|	706871	706885	ACCTCG	14	-	2	AGGTCG
gi|514486271|gb|KE346361.1|	707143	707157	ATC	14	-	4	TGA
gi|514486271|gb|KE346361.1|	707428	707441	AAAAAG	13	+	2	AGAAAA
gi|514486271|gb|KE346361.1|	707443	707458	A	15	+	15	A
gi|514486271|gb|KE346361.1|	707634	707655	A	21	+	21	A
gi|514486271|gb|KE346361.1|	707770	707782	AGAGG	12	+	2	GAGAG
gi|514486271|gb|KE346361.1|	707944	707956	AAC	12	+	4	AAC
gi|514486271|gb|KE346361.1|	708572	708594	AAAAAT	22	+	3	AAAAAT
gi|514486271|gb|KE346361.1|	708793	708816	AG	23	-	11	CT
gi|514486271|gb|KE346361.1|	709135	709153	AACCC	18	+	3	AACCC
gi|514486271|gb|KE346361.1|	709170	709187	AACTCC	17	+	2	CTCCAA
gi|514486271|gb|KE346361.1|	710916	710930	AGCC	14	+	3	CCAG
gi|514486271|gb|KE346361.1|	711164	711176	CCCCG	12	+	2	CCCCG
gi|514486271|gb|KE346361.1|	712468	712482	AAG	14	-	4	TCT
gi|514486271|gb|KE346361.1|	712617	712629	AAAGTG	12	-	2	TTCACT
gi|514486271|gb|KE346361.1|	713010	713026	AACCC	16	-	3	GGGTT
gi|514486271|gb|KE346361.1|	714580	714593	C	13	-	13	G
gi|514486271|gb|KE346361.1|	714689	714701	ACGCG	12	+	2	ACGCG
gi|514486271|gb|KE346361.1|	714944	714958	AAC	14	-	4	TGT
gi|514486271|gb|KE346361.1|	715190	715202	AGC	12	-	4	CTG
gi|514486271|gb|KE346361.1|	715445	715457	AAATCG	12	+	2	TCGAAA
gi|514486271|gb|KE346361.1|	715528	715543	ACCCCC	15	+	2	CCACCC
gi|514486271|gb|KE346361.1|	716188	716200	ACGCTG	12	+	2	TGACGC
gi|514486271|gb|KE346361.1|	716342	716354	ATCGCC	12	-	2	TGGCGA
gi|514486271|gb|KE346361.1|	716514	716528	ACCAGC	14	-	2	TGGTGC
gi|514486271|gb|KE346361.1|	717730	717746	AAAAC	16	+	3	AACAA
gi|514486271|gb|KE346361.1|	717746	717759	AAACC	13	+	2	CAAAC
gi|514486271|gb|KE346361.1|	717769	717783	AAACC	14	+	2	AAACC
gi|514486271|gb|KE346361.1|	717778	717790	AAAC	12	+	3	CAAA
gi|514486271|gb|KE346361.1|	717862	717890	AC	28	+	14	AC
gi|514486271|gb|KE346361.1|	719307	719321	AGC	14	+	4	GCA
gi|514486271|gb|KE346361.1|	719845	719892	A	47	+	47	A
gi|514486271|gb|KE346361.1|	719929	719943	AAAAC	14	-	2	TTTTG
gi|514486271|gb|KE346361.1|	721653	721665	AACATG	12	+	2	ATGAAC
gi|514486271|gb|KE346361.1|	722008	722020	AAGTGG	12	-	2	CTTCCA
gi|514486271|gb|KE346361.1|	723069	723082	AGGCC	13	-	2	GGCCT
gi|514486271|gb|KE346361.1|	723284	723296	ACGAGT	12	-	2	ACTCGT
gi|514486271|gb|KE346361.1|	724093	724107	AGATGG	14	-	2	CCATCT
gi|514486271|gb|KE346361.1|	724199	724229	AACGCC	30	-	5	TGGCGT
gi|514486271|gb|KE346361.1|	725630	725657	AACAGC	27	-	4	TGTTGC
gi|514486271|gb|KE346361.1|	725965	725985	ACGATG	20	-	3	TCGTCA
gi|514486271|gb|KE346361.1|	726007	726019	ACGAGG	12	-	2	TCCTCG
gi|514486271|gb|KE346361.1|	726557	726574	ATC	17	+	5	ATC
gi|514486271|gb|KE346361.1|	727254	727267	AAAGCC	13	-	2	GGCTTT
gi|514486271|gb|KE346361.1|	727317	727333	ACGCTC	16	+	2	CACGCT
gi|514486271|gb|KE346361.1|	727864	727881	A	17	+	17	A
gi|514486271|gb|KE346361.1|	729548	729560	AGCATC	12	-	2	TGCTGA
gi|514486271|gb|KE346361.1|	730191	730204	AATGTG	13	+	2	ATGTGA
gi|514486271|gb|KE346361.1|	730486	730502	ACATCC	16	+	2	CATCCA
gi|514486271|gb|KE346361.1|	730503	730517	AC	14	+	7	AC
gi|514486271|gb|KE346361.1|	730841	730853	AG	12	-	6	TC
gi|514486271|gb|KE346361.1|	730875	730890	AATGTG	15	-	2	ACATTC
gi|514486271|gb|KE346361.1|	731002	731023	A	21	-	21	T
gi|514486271|gb|KE346361.1|	731178	731191	A	13	+	13	A
gi|514486271|gb|KE346361.1|	731968	731992	AAC	24	+	8	CAA
gi|514486271|gb|KE346361.1|	733001	733013	AAAGCC	12	-	2	TTGGCT
gi|514486271|gb|KE346361.1|	733224	733240	ACACTC	16	-	2	GTGAGT
gi|514486271|gb|KE346361.1|	733444	733461	AAC	17	+	5	CAA
gi|514486271|gb|KE346361.1|	733459	733477	AGC	18	+	6	CAG
gi|514486271|gb|KE346361.1|	733476	733488	ACCGCC	12	-	2	GTGGCG
gi|514486271|gb|KE346361.1|	733601	733618	AAGGAC	17	+	2	GACAAG
gi|514486271|gb|KE346361.1|	733628	733648	AAGGAC	20	+	3	GACAAG
gi|514486271|gb|KE346361.1|	733651	733671	AAGGAC	20	+	3	CAAGGA
gi|514486271|gb|KE346361.1|	733734	733752	ACCAGC	18	-	3	CTGGTG
gi|514486271|gb|KE346361.1|	734108	734123	AGG	15	-	5	TCC
gi|514486271|gb|KE346361.1|	734176	734188	AGCGCG	12	+	2	CGAGCG
gi|514486271|gb|KE346361.1|	734633	734649	AAAAAC	16	-	2	TTTTTG
gi|514486271|gb|KE346361.1|	734653	734669	ACACGC	16	-	2	GTGCGT
gi|514486271|gb|KE346361.1|	734777	734795	ACGATG	18	+	3	GACGAT
gi|514486271|gb|KE346361.1|	734815	734845	AGC	30	+	10	AGC
gi|514486271|gb|KE346361.1|	735179	735192	AATGCC	13	+	2	AATGCC
gi|514486271|gb|KE346361.1|	735314	735335	AGC	21	+	7	GCA
gi|514486271|gb|KE346361.1|	735556	735568	ACG	12	+	4	CGA
gi|514486271|gb|KE346361.1|	736437	736449	AAGCAC	12	+	2	ACAAGC
gi|514486271|gb|KE346361.1|	737631	737643	AACGAC	12	+	2	CGACAA
gi|514486271|gb|KE346361.1|	737817	737830	ACAGAG	13	-	2	CTCTGT
gi|514486271|gb|KE346361.1|	738194	738206	AGCTCG	12	+	2	AGCTCG
gi|514486271|gb|KE346361.1|	738347	738360	AGC	13	+	4	GCA
gi|514486271|gb|KE346361.1|	738361	738373	AGCGGC	12	+	2	GGCAGC
gi|514486271|gb|KE346361.1|	740961	740973	ACGCTC	12	-	2	GCGTGA
gi|514486271|gb|KE346361.1|	742893	742905	AACGTC	12	-	2	CGTTGA
gi|514486271|gb|KE346361.1|	744718	744744	A	26	+	26	A
gi|514486271|gb|KE346361.1|	745285	745307	AGGGGG	22	+	3	GGGGAG
gi|514486271|gb|KE346361.1|	746108	746121	A	13	+	13	A
gi|514486271|gb|KE346361.1|	746149	746161	AGCCG	12	+	2	AGCCG
gi|514486271|gb|KE346361.1|	746303	746315	AAT	12	+	4	TAA
gi|514486271|gb|KE346361.1|	746337	746353	A	16	-	16	T
gi|514486271|gb|KE346361.1|	746558	746572	A	14	+	14	A
gi|514486271|gb|KE346361.1|	746847	746860	ACATGC	13	-	2	TGCATG
gi|514486271|gb|KE346361.1|	747032	747045	AAAGTC	13	+	2	AGTCAA
gi|514486271|gb|KE346361.1|	747062	747074	A	12	-	12	T
gi|514486271|gb|KE346361.1|	747672	747684	AAAAGG	12	-	2	CTTTTC
gi|514486271|gb|KE346361.1|	749637	749651	A	14	-	14	T
gi|514486271|gb|KE346361.1|	751742	751760	AAAAAG	18	-	3	CTTTTT
gi|514486271|gb|KE346361.1|	752107	752119	ACGCTG	12	-	2	CGTCAG
gi|514486271|gb|KE346361.1|	752400	752415	A	15	+	15	A
gi|514486271|gb|KE346361.1|	752778	752790	ACTC	12	+	3	CACT
gi|514486271|gb|KE346361.1|	755154	755166	AACACC	12	+	2	CAACAC
gi|514486271|gb|KE346361.1|	755290	755307	A	17	-	17	T
gi|514486271|gb|KE346361.1|	755309	755324	A	15	-	15	T
gi|514486271|gb|KE346361.1|	755333	755348	AAAC	15	-	3	TTTG
gi|514486271|gb|KE346361.1|	755500	755512	A	12	-	12	T
gi|514486271|gb|KE346361.1|	755513	755526	A	13	-	13	T
gi|514486271|gb|KE346361.1|	755545	755557	A	12	-	12	T
gi|514486271|gb|KE346361.1|	755967	755982	AATC	15	+	3	CAAT
gi|514486271|gb|KE346361.1|	756235	756247	AACCAC	12	-	2	TGTGGT
gi|514486271|gb|KE346361.1|	756345	756361	A	16	-	16	T
gi|514486271|gb|KE346361.1|	756582	756604	A	22	+	22	A
gi|514486271|gb|KE346361.1|	756632	756646	ACTCTC	14	+	2	TCTCAC
gi|514486271|gb|KE346361.1|	756643	756658	ACTCTC	15	+	2	CTCACT
gi|514486271|gb|KE346361.1|	756893	756908	AAT	15	-	5	TAT
gi|514486271|gb|KE346361.1|	759145	759157	ACTGG	12	-	2	CAGTC
gi|514486271|gb|KE346361.1|	759812	759825	AAAACG	13	-	2	GTTTTC
gi|514486271|gb|KE346361.1|	760028	760053	A	25	-	25	T
gi|514486271|gb|KE346361.1|	760062	760075	A	13	-	13	T
gi|514486271|gb|KE346361.1|	760088	760100	AAAAAC	12	-	2	TGTTTT
gi|514486271|gb|KE346361.1|	760108	760128	A	20	-	20	T
gi|514486271|gb|KE346361.1|	760683	760695	AGGC	12	+	3	GCAG
gi|514486271|gb|KE346361.1|	760758	760775	ACCTCG	17	+	2	CGACCT
gi|514486271|gb|KE346361.1|	761774	761786	AAACAC	12	-	2	TTTGTG
gi|514486271|gb|KE346361.1|	762193	762208	AC	15	-	7	TG
gi|514486271|gb|KE346361.1|	762517	762529	AAAGG	12	-	2	TCCTT
gi|514486271|gb|KE346361.1|	762553	762570	ACTGAT	17	+	2	TGATAC
gi|514486271|gb|KE346361.1|	762571	762606	ACTGAT	35	+	5	TGATAC
gi|514486271|gb|KE346361.1|	762607	762625	AGCATC	18	-	3	TGATGC
gi|514486271|gb|KE346361.1|	762879	762891	AGC	12	+	4	AGC
gi|514486271|gb|KE346361.1|	763488	763523	ATC	35	-	11	TGA
gi|514486271|gb|KE346361.1|	763521	763539	AAC	18	-	6	TGT
gi|514486271|gb|KE346361.1|	765688	765706	A	18	-	18	T
gi|514486271|gb|KE346361.1|	767561	767573	AGCTCG	12	+	2	GCTCGA
gi|514486271|gb|KE346361.1|	768909	768925	AAAAGC	16	+	2	AAAAGC
gi|514486271|gb|KE346361.1|	769172	769199	AACAGC	27	-	4	CTGTTG
gi|514486271|gb|KE346361.1|	769209	769223	AGC	14	-	4	TGC
gi|514486271|gb|KE346361.1|	769278	769290	AAATCC	12	+	2	TCCAAA
gi|514486271|gb|KE346361.1|	769696	769708	AC	12	-	6	TG
gi|514486271|gb|KE346361.1|	770451	770463	ACGGCG	12	-	2	CGTCGC
gi|514486271|gb|KE346361.1|	770640	770654	ACG	14	-	4	CGT
gi|514486271|gb|KE346361.1|	770944	770957	AATGCG	13	+	2	TGCGAA
gi|514486271|gb|KE346361.1|	771057	771078	AGC	21	+	7	AGC
gi|514486271|gb|KE346361.1|	771176	771189	ACGAGG	13	-	2	CCTCGT
gi|514486271|gb|KE346361.1|	771350	771362	ACGAGG	12	-	2	CCTCGT
gi|514486271|gb|KE346361.1|	771549	771564	AGCTCC	15	-	2	CTGGAG
gi|514486271|gb|KE346361.1|	771645	771657	AAACTG	12	+	2	TGAAAC
gi|514486271|gb|KE346361.1|	771694	771711	ACAGCC	17	-	2	TGGCTG
gi|514486271|gb|KE346361.1|	771848	771874	A	26	+	26	A
gi|514486271|gb|KE346361.1|	771904	771919	AAACG	15	+	3	ACGAA
gi|514486271|gb|KE346361.1|	772830	772849	A	19	-	19	T
gi|514486271|gb|KE346361.1|	773773	773803	AAC	30	-	10	TTG
gi|514486271|gb|KE346361.1|	774475	774491	AACGAC	16	-	2	TCGTTG
gi|514486271|gb|KE346361.1|	774685	774706	A	21	-	21	T
gi|514486271|gb|KE346361.1|	774711	774727	A	16	-	16	T
gi|514486271|gb|KE346361.1|	774724	774736	AAAGG	12	-	2	TTTCC
gi|514486271|gb|KE346361.1|	774908	774920	AGCGCC	12	-	2	GCTGGC
gi|514486271|gb|KE346361.1|	774970	774987	AACACC	17	+	2	CCAACA
gi|514486271|gb|KE346361.1|	775237	775268	AAG	31	-	10	TCT
gi|514486271|gb|KE346361.1|	775431	775461	A	30	-	30	T
gi|514486271|gb|KE346361.1|	776523	776535	AACACC	12	+	2	ACCAAC
gi|514486271|gb|KE346361.1|	776897	776916	AG	19	-	9	TC
gi|514486271|gb|KE346361.1|	776946	776960	ACACAT	14	-	2	GTATGT
gi|514486271|gb|KE346361.1|	777722	777734	AACTTG	12	-	2	AGTTCA
gi|514486271|gb|KE346361.1|	777740	777752	AAAAGC	12	+	2	AAAGCA
gi|514486271|gb|KE346361.1|	777757	777779	ACTC	22	-	5	GAGT
gi|514486271|gb|KE346361.1|	777931	777944	AAGG	13	+	3	GAAG
gi|514486271|gb|KE346361.1|	778263	778275	AAAAAC	12	+	2	ACAAAA
gi|514486271|gb|KE346361.1|	778831	778845	A	14	+	14	A
gi|514486271|gb|KE346361.1|	779591	779606	AAGTCC	15	-	2	GGACTT
gi|514486271|gb|KE346361.1|	780033	780045	AAAAC	12	+	2	AAAAC
gi|514486271|gb|KE346361.1|	780975	780987	ACCCAG	12	-	2	GGGTCT
gi|514486271|gb|KE346361.1|	781342	781355	AAAGCG	13	+	2	AAAGCG
gi|514486271|gb|KE346361.1|	781768	781781	AAAATC	13	+	2	AAAATC
gi|514486271|gb|KE346361.1|	781782	781801	AAACG	19	+	3	ACGAA
gi|514486271|gb|KE346361.1|	782226	782244	ACC	18	+	6	CCA
gi|514486271|gb|KE346361.1|	782242	782260	AGC	18	+	6	CAG
gi|514486271|gb|KE346361.1|	782257	782306	AGAGCC	49	+	8	CAGAGC
gi|514486271|gb|KE346361.1|	782376	782399	ACG	23	+	7	GAC
gi|514486271|gb|KE346361.1|	782394	782408	ACGATG	14	+	2	GACGAT
gi|514486271|gb|KE346361.1|	782713	782727	AAAAC	14	+	2	AAAAC
gi|514486271|gb|KE346361.1|	784483	784495	CCG	12	+	4	CGC
gi|514486271|gb|KE346361.1|	785119	785131	AGCCTG	12	+	2	CTGAGC
gi|514486271|gb|KE346361.1|	785146	785207	AGC	61	-	20	CTG
gi|514486271|gb|KE346361.1|	787470	787485	ACGGCG	15	-	2	CGTCGC
gi|514486271|gb|KE346361.1|	787480	787497	AACGGC	17	-	2	GCCGTT
gi|514486271|gb|KE346361.1|	787706	787719	AGC	13	-	4	GCT
gi|514486271|gb|KE346361.1|	787717	787749	ATC	32	-	10	TGA
gi|514486271|gb|KE346361.1|	787899	787918	A	19	+	19	A
gi|514486271|gb|KE346361.1|	787991	788003	AAAC	12	-	3	TTTG
gi|514486271|gb|KE346361.1|	788119	788131	AATCG	12	+	2	AATCG
gi|514486271|gb|KE346361.1|	788263	788276	AC	13	-	6	TG
gi|514486271|gb|KE346361.1|	788430	788445	ATC	15	+	5	TCA
gi|514486271|gb|KE346361.1|	788447	788470	AGCATC	23	+	3	ATCAGC
gi|514486271|gb|KE346361.1|	788471	788491	AGC	20	+	6	AGC
gi|514486271|gb|KE346361.1|	789830	789842	A	12	+	12	A
gi|514486271|gb|KE346361.1|	789897	789909	AACAAG	12	-	2	TTCTTG
gi|514486271|gb|KE346361.1|	790308	790320	CCCCCG	12	-	2	GGCGGG
gi|514486271|gb|KE346361.1|	790360	790377	ACGAGG	17	-	2	TCGTCC
gi|514486271|gb|KE346361.1|	791545	791558	AG	13	+	6	AG
gi|514486271|gb|KE346361.1|	791729	791742	AGAGCG	13	+	2	GAGAGC
gi|514486271|gb|KE346361.1|	792297	792309	AGAGCG	12	-	2	TCGCTC
gi|514486271|gb|KE346361.1|	792303	792317	AGCG	14	-	3	TCGC
gi|514486271|gb|KE346361.1|	792496	792508	AC	12	-	6	TG
gi|514486271|gb|KE346361.1|	792528	792542	ACTCG	14	-	2	CGAGT
gi|514486271|gb|KE346361.1|	792700	792726	A	26	+	26	A
gi|514486271|gb|KE346361.1|	793478	793492	AACAGC	14	+	2	AACAGC
gi|514486271|gb|KE346361.1|	793587	793601	AAAAAC	14	+	2	AACAAA
gi|514486271|gb|KE346361.1|	793596	793619	A	23	+	23	A
gi|514486271|gb|KE346361.1|	793631	793643	AAC	12	+	4	ACA
gi|514486271|gb|KE346361.1|	793916	793935	ATCGGC	19	+	3	CATCGG
gi|514486271|gb|KE346361.1|	794130	794146	AAAC	16	+	4	CAAA
gi|514486271|gb|KE346361.1|	794143	794157	A	14	+	14	A
gi|514486271|gb|KE346361.1|	794202	794214	AATCAG	12	-	2	TTCTGA
gi|514486271|gb|KE346361.1|	794867	794879	A	12	+	12	A
gi|514486271|gb|KE346361.1|	795209	795258	AGC	49	+	16	GCA
gi|514486271|gb|KE346361.1|	795553	795571	AG	18	-	9	TC
gi|514486271|gb|KE346361.1|	795934	795948	AAGGAC	14	+	2	ACAAGG
gi|514486271|gb|KE346361.1|	795958	795972	AAGGAC	14	+	2	ACAAGG
gi|514486271|gb|KE346361.1|	796388	796400	AACGC	12	-	2	CGTTG
gi|514486271|gb|KE346361.1|	797971	797992	ACCAT	21	+	4	CCATA
gi|514486271|gb|KE346361.1|	797995	798007	ACCAT	12	+	2	ACCAT
gi|514486271|gb|KE346361.1|	798459	798471	AGC	12	-	4	CTG
gi|514486271|gb|KE346361.1|	798548	798561	ACG	13	-	4	TCG
gi|514486271|gb|KE346361.1|	798562	798574	AACGAC	12	-	2	GTTGTC
gi|514486271|gb|KE346361.1|	798800	798812	ACGATG	12	-	2	TCATCG
gi|514486271|gb|KE346361.1|	799307	799324	ACCAGC	17	-	2	GGTGCT
gi|514486271|gb|KE346361.1|	799342	799354	CCCCG	12	-	2	GGCGG
gi|514486271|gb|KE346361.1|	799604	799619	ACCCCC	15	-	2	GGGGGT
gi|514486271|gb|KE346361.1|	800204	800219	AACAGC	15	-	2	TTGCTG
gi|514486271|gb|KE346361.1|	800998	801011	AGC	13	-	4	GCT
gi|514486271|gb|KE346361.1|	801616	801629	AAAAC	13	+	2	AACAA
gi|514486271|gb|KE346361.1|	802597	802609	A	12	+	12	A
gi|514486271|gb|KE346361.1|	803468	803483	AAAAG	15	-	3	CTTTT
gi|514486271|gb|KE346361.1|	805159	805175	AGG	16	+	5	AGG
gi|514486271|gb|KE346361.1|	806116	806130	AGC	14	-	4	GCT
gi|514486271|gb|KE346361.1|	806804	806816	AAGAG	12	+	2	AGAAG
gi|514486271|gb|KE346361.1|	807005	807019	AAAC	14	+	3	AACA
gi|514486271|gb|KE346361.1|	807062	807076	AAGGAC	14	-	2	CTTGTC
gi|514486271|gb|KE346361.1|	807954	807969	AAAC	15	+	3	AAAC
gi|514486271|gb|KE346361.1|	808460	808472	AAAAC	12	-	2	TTTTG
gi|514486271|gb|KE346361.1|	808730	808744	ACCAGC	14	+	2	CACCAG
gi|514486271|gb|KE346361.1|	808796	808819	A	23	+	23	A
gi|514486271|gb|KE346361.1|	808921	808935	AAGACG	14	+	2	AAGACG
gi|514486271|gb|KE346361.1|	809355	809383	ACAGAG	28	+	4	GAGACA
gi|514486271|gb|KE346361.1|	809571	809583	AAAAAC	12	+	2	CAAAAA
gi|514486271|gb|KE346361.1|	809619	809644	A	25	-	25	T
gi|514486271|gb|KE346361.1|	809992	810004	AAG	12	+	4	AGA
gi|514486271|gb|KE346361.1|	810419	810431	AG	12	-	6	CT
gi|514486271|gb|KE346361.1|	810491	810509	AGAGG	18	+	3	AGGAG
gi|514486271|gb|KE346361.1|	810675	810688	AGC	13	+	4	CAG
gi|514486271|gb|KE346361.1|	810761	810776	CCG	15	+	5	CGC
gi|514486271|gb|KE346361.1|	810888	810906	AAAAC	18	+	3	AAACA
gi|514486271|gb|KE346361.1|	810902	810916	A	14	+	14	A
gi|514486271|gb|KE346361.1|	811499	811511	AGCCTC	12	-	2	GCTGAG
gi|514486271|gb|KE346361.1|	811877	811891	AAAG	14	+	3	AAAG
gi|514486271|gb|KE346361.1|	811892	811905	A	13	+	13	A
gi|514486271|gb|KE346361.1|	812501	812519	CCG	18	-	6	GGC
gi|514486271|gb|KE346361.1|	812977	812999	AGC	22	+	7	CAG
gi|514486271|gb|KE346361.1|	813172	813184	AAGCTC	12	-	2	TTGAGC
gi|514486271|gb|KE346361.1|	813184	813196	AGCGGC	12	-	2	CTGCCG
gi|514486271|gb|KE346361.1|	813332	813351	A	19	+	19	A
gi|514486271|gb|KE346361.1|	814159	814176	ACGATG	17	+	2	GACGAT
gi|514486271|gb|KE346361.1|	814171	814191	ACG	20	+	6	GAC
gi|514486271|gb|KE346361.1|	814645	814661	AGC	16	+	5	AGC
gi|514486271|gb|KE346361.1|	816891	816904	AAAAAC	13	+	2	AAAACA
gi|514486271|gb|KE346361.1|	817017	817029	CCCCCG	12	-	2	GGGCGG
gi|514486271|gb|KE346361.1|	817349	817362	AGGGGG	13	+	2	GGGGAG
gi|514486271|gb|KE346361.1|	817634	817647	ACG	13	+	4	ACG
gi|514486271|gb|KE346361.1|	818002	818014	AGCGGC	12	+	2	GCGGCA
gi|514486271|gb|KE346361.1|	818339	818353	AAAGCG	14	-	2	GCTTTC
gi|514486271|gb|KE346361.1|	818508	818553	A	45	+	45	A
gi|514486271|gb|KE346361.1|	819153	819166	AATTC	13	+	2	ATTCA
gi|514486271|gb|KE346361.1|	820319	820331	AACAC	12	+	2	AACAC
gi|514486271|gb|KE346361.1|	820773	820786	AGCCGC	13	+	2	CCGCAG
gi|514486271|gb|KE346361.1|	821173	821185	AAAC	12	-	3	TTTG
gi|514486271|gb|KE346361.1|	821281	821293	AGGGGG	12	-	2	CCCCTC
gi|514486271|gb|KE346361.1|	821526	821541	AGCCTG	15	-	2	CAGGCT
gi|514486271|gb|KE346361.1|	821599	821611	C	12	+	12	C
gi|514486271|gb|KE346361.1|	823594	823606	AATCAG	12	+	2	CAGAAT
gi|514486271|gb|KE346361.1|	824818	824830	AAAAAT	12	+	2	AAAAAT
gi|514486271|gb|KE346361.1|	825614	825627	AAAAC	13	-	2	TTGTT
gi|514486271|gb|KE346361.1|	828923	828937	AACTCC	14	-	2	TGGAGT
gi|514486271|gb|KE346361.1|	831170	831184	A	14	+	14	A
gi|514486271|gb|KE346361.1|	831888	831904	AC	16	+	8	AC
gi|514486271|gb|KE346361.1|	832156	832168	ACCCC	12	+	2	CCCAC
gi|514486271|gb|KE346361.1|	834295	834310	AGCTCG	15	+	2	TCGAGC
gi|514486271|gb|KE346361.1|	834890	834903	AAATCC	13	+	2	CCAAAT
gi|514486271|gb|KE346361.1|	835229	835246	AGG	17	+	5	AGG
gi|514486271|gb|KE346361.1|	835858	835874	AGGCCC	16	+	2	AGGCCC
gi|514486271|gb|KE346361.1|	837130	837142	AATTC	12	+	2	TTCAA
gi|514486271|gb|KE346361.1|	837425	837440	A	15	+	15	A
gi|514486271|gb|KE346361.1|	837452	837472	A	20	-	20	T
gi|514486271|gb|KE346361.1|	838093	838107	AAAAG	14	+	2	AAAAG
gi|514486271|gb|KE346361.1|	838313	838326	A	13	-	13	T
gi|514486271|gb|KE346361.1|	842240	842264	ACG	24	+	8	CGA
gi|514486271|gb|KE346361.1|	842268	842286	ATC	18	-	6	GAT
gi|514486271|gb|KE346361.1|	842318	842330	ACG	12	+	4	CGA
gi|514486271|gb|KE346361.1|	842372	842385	ACG	13	+	4	CGA
gi|514486271|gb|KE346361.1|	842485	842501	AGC	16	-	5	CTG
gi|514486271|gb|KE346361.1|	843001	843014	AC	13	+	6	CA
gi|514486271|gb|KE346361.1|	843283	843295	ACGCGC	12	+	2	GCGCAC
gi|514486271|gb|KE346361.1|	843660	843672	ATCCGC	12	+	2	CGCATC
gi|514486271|gb|KE346361.1|	844427	844439	ACTGCG	12	-	2	GTCGCA
gi|514486271|gb|KE346361.1|	846195	846210	ACCGTC	15	-	2	ACGGTG
gi|514486271|gb|KE346361.1|	847154	847168	AACTGG	14	+	2	GGAACT
gi|514486271|gb|KE346361.1|	847354	847366	ACGCTC	12	+	2	CGCTCA
gi|514486271|gb|KE346361.1|	847678	847693	A	15	+	15	A
gi|514486271|gb|KE346361.1|	847885	847905	A	20	+	20	A
gi|514486271|gb|KE346361.1|	848099	848119	A	20	+	20	A
gi|514486271|gb|KE346361.1|	848217	848229	AACAC	12	+	2	AACAC
gi|514486271|gb|KE346361.1|	848282	848296	A	14	+	14	A
gi|514486271|gb|KE346361.1|	848291	848308	AAAAAT	17	+	2	AAAAAT
gi|514486271|gb|KE346361.1|	848330	848342	AG	12	-	6	TC
gi|514486271|gb|KE346361.1|	848343	848355	ACTCTG	12	+	2	CTCTGA
gi|514486271|gb|KE346361.1|	848616	848629	AATTC	13	+	2	AATTC
gi|514486271|gb|KE346361.1|	848669	848683	AAG	14	+	4	GAA
gi|514486271|gb|KE346361.1|	848945	848957	AC	12	+	6	AC
gi|514486271|gb|KE346361.1|	848958	848971	A	13	+	13	A
gi|514486271|gb|KE346361.1|	849325	849338	A	13	+	13	A
gi|514486271|gb|KE346361.1|	849372	849384	AGCC	12	+	3	CAGC
gi|514486271|gb|KE346361.1|	849782	849799	AAAC	17	+	4	ACAA
gi|514486271|gb|KE346361.1|	849806	849828	A	22	+	22	A
gi|514486271|gb|KE346361.1|	850001	850014	ACAGC	13	+	2	GCACA
gi|514486271|gb|KE346361.1|	850312	850333	A	21	+	21	A
gi|514486271|gb|KE346361.1|	850344	850360	A	16	+	16	A
gi|514486271|gb|KE346361.1|	850541	850554	A	13	+	13	A
gi|514486271|gb|KE346361.1|	850615	850633	AC	18	+	9	AC
gi|514486271|gb|KE346361.1|	850676	850690	AAAGCC	14	+	2	AAAGCC
gi|514486271|gb|KE346361.1|	850779	850795	AG	16	-	8	TC
gi|514486271|gb|KE346361.1|	850796	850810	AG	14	-	7	CT
gi|514486271|gb|KE346361.1|	851044	851057	AAC	13	-	4	TGT
gi|514486271|gb|KE346361.1|	851521	851533	ACACTC	12	+	2	ACACTC
gi|514486271|gb|KE346361.1|	852036	852051	AC	15	-	7	TG
gi|514486271|gb|KE346361.1|	852123	852143	AAAGCC	20	+	3	CCAAAG
gi|514486271|gb|KE346361.1|	852169	852188	A	19	-	19	T
gi|514486271|gb|KE346361.1|	852194	852208	A	14	-	14	T
gi|514486271|gb|KE346361.1|	852219	852233	A	14	-	14	T
gi|514486271|gb|KE346361.1|	854275	854287	AAAAGG	12	+	2	AAAGGA
gi|514486271|gb|KE346361.1|	855835	855852	ACC	17	-	5	TGG
gi|514486271|gb|KE346361.1|	856027	856039	AACTGC	12	-	2	GCAGTT
gi|514486271|gb|KE346361.1|	856076	856094	ACC	18	+	6	CAC
gi|514486271|gb|KE346361.1|	856089	856103	ACCACT	14	+	2	ACCACT
gi|514486271|gb|KE346361.1|	856186	856203	ACGAGG	17	-	2	TCGTCC
gi|514486271|gb|KE346361.1|	856452	856465	ATC	13	+	4	CAT
gi|514486271|gb|KE346361.1|	856483	856496	AG	13	+	6	GA
gi|514486271|gb|KE346361.1|	856521	856536	ACTGAG	15	+	2	ACTGAG
gi|514486271|gb|KE346361.1|	856691	856705	AATAGC	14	+	2	AATAGC
gi|514486271|gb|KE346361.1|	857224	857236	AACAGC	12	-	2	TGCTGT
gi|514486271|gb|KE346361.1|	857397	857409	AGCTGC	12	+	2	TGCAGC
gi|514486271|gb|KE346361.1|	857766	857784	AGC	18	-	6	TGC
gi|514486271|gb|KE346361.1|	858037	858053	ACGAGG	16	+	2	GAGGAC
gi|514486271|gb|KE346361.1|	858325	858337	ACG	12	-	4	TCG
gi|514486271|gb|KE346361.1|	858550	858562	AAAAAC	12	+	2	AACAAA
gi|514486271|gb|KE346361.1|	858589	858603	A	14	+	14	A
gi|514486271|gb|KE346361.1|	858819	858831	AG	12	+	6	AG
gi|514486271|gb|KE346361.1|	858932	858948	AAC	16	+	5	AAC
gi|514486271|gb|KE346361.1|	859127	859142	AGCATC	15	-	2	TGCTGA
gi|514486271|gb|KE346361.1|	859773	859795	A	22	-	22	T
gi|514486271|gb|KE346361.1|	859792	859806	AAACC	14	-	2	TTTGG
gi|514486271|gb|KE346361.1|	860027	860045	AGCCGC	18	-	3	GGCTGC
gi|514486271|gb|KE346361.1|	860450	860462	A	12	+	12	A
gi|514486271|gb|KE346361.1|	861518	861530	ATCCCC	12	-	2	GGGATG
gi|514486271|gb|KE346361.1|	861544	861557	AAGGAC	13	-	2	CTTGTC
gi|514486271|gb|KE346361.1|	861705	861720	AAGAGG	15	-	2	CCTCTT
gi|514486271|gb|KE346361.1|	861899	861913	AAAAAG	14	+	2	AAAAAG
gi|514486271|gb|KE346361.1|	862128	862140	AAAGGG	12	-	2	CCTTTC
gi|514486271|gb|KE346361.1|	862480	862527	AG	47	+	23	GA
gi|514486271|gb|KE346361.1|	862736	862755	AGC	19	-	6	TGC
gi|514486271|gb|KE346361.1|	863515	863528	ACCGCG	13	+	2	CGACCG
gi|514486271|gb|KE346361.1|	864077	864094	AC	17	-	8	GT
gi|514486271|gb|KE346361.1|	864361	864378	ATC	17	+	5	CAT
gi|514486271|gb|KE346361.1|	864800	864812	AAATTG	12	-	2	CAATTT
gi|514486271|gb|KE346361.1|	864998	865024	AACTGG	26	+	4	AACTGG
gi|514486271|gb|KE346361.1|	865247	865262	AAACC	15	-	3	GTTTG
gi|514486271|gb|KE346361.1|	865259	865273	AAC	14	-	4	TTG
gi|514486271|gb|KE346361.1|	865286	865298	A	12	+	12	A
gi|514486271|gb|KE346361.1|	865646	865669	AGATGC	23	+	3	TGCAGA
gi|514486271|gb|KE346361.1|	866002	866014	AGCGCC	12	-	2	CTGGCG
gi|514486271|gb|KE346361.1|	866395	866407	AGAGG	12	+	2	GGAGA
gi|514486271|gb|KE346361.1|	866688	866702	AGCTGC	14	+	2	GCTGCA
gi|514486271|gb|KE346361.1|	867759	867771	AGC	12	+	4	AGC
gi|514486271|gb|KE346361.1|	868167	868179	AACTGG	12	-	2	GTTCCA
gi|514486271|gb|KE346361.1|	868796	868819	A	23	+	23	A
gi|514486271|gb|KE346361.1|	869362	869374	AAAAGG	12	-	2	CTTTTC
gi|514486271|gb|KE346361.1|	869427	869439	AAAAAC	12	+	2	AAACAA
gi|514486271|gb|KE346361.1|	869708	869720	ACATGC	12	+	2	CACATG
gi|514486271|gb|KE346361.1|	871434	871450	AAC	16	-	5	TGT
gi|514486271|gb|KE346361.1|	872201	872216	AAAAC	15	+	3	CAAAA
gi|514486271|gb|KE346361.1|	872267	872279	ATCGGC	12	+	2	CGGCAT
gi|514486271|gb|KE346361.1|	872634	872646	AAGTGC	12	+	2	TGCAAG
gi|514486271|gb|KE346361.1|	873030	873042	AAGC	12	+	3	GCAA
gi|514486271|gb|KE346361.1|	873056	873072	AAAAAC	16	+	2	AAACAA
gi|514486271|gb|KE346361.1|	873077	873108	AAAAGC	31	+	5	CAAAAG
gi|514486271|gb|KE346361.1|	873425	873439	AAAAAC	14	+	2	AACAAA
gi|514486271|gb|KE346361.1|	873564	873581	ACAGAG	17	+	2	AGAGAC
gi|514486271|gb|KE346361.1|	873611	873627	AAAAAC	16	+	2	AAAAAC
gi|514486271|gb|KE346361.1|	875034	875054	A	20	-	20	T
gi|514486271|gb|KE346361.1|	875174	875194	AAT	20	-	6	TTA
gi|514486271|gb|KE346361.1|	875381	875393	AAGACC	12	+	2	ACCAAG
gi|514486271|gb|KE346361.1|	875653	875666	ACACGC	13	-	2	GTGCGT
gi|514486271|gb|KE346361.1|	876444	876457	AAAAC	13	-	2	TTGTT
gi|514486271|gb|KE346361.1|	878237	878250	AGCATG	13	-	2	GCTCAT
gi|514486271|gb|KE346361.1|	878304	878316	AATCAG	12	-	2	ATTCTG
gi|514486271|gb|KE346361.1|	879015	879027	AATAGC	12	+	2	AGCAAT
gi|514486271|gb|KE346361.1|	879545	879559	AAC	14	-	4	TTG
gi|514486271|gb|KE346361.1|	879572	879584	AACAAG	12	-	2	TTGTTC
gi|514486271|gb|KE346361.1|	879851	879870	AAG	19	+	6	AGA
gi|514486271|gb|KE346361.1|	879871	879909	AAG	38	+	12	AAG
gi|514486271|gb|KE346361.1|	880617	880629	ACACGC	12	-	2	GTGTGC
gi|514486271|gb|KE346361.1|	880999	881011	AAAAAC	12	-	2	TTGTTT
gi|514486271|gb|KE346361.1|	881020	881032	A	12	+	12	A
gi|514486271|gb|KE346361.1|	881052	881064	AAATGG	12	+	2	ATGGAA
gi|514486271|gb|KE346361.1|	881070	881082	AAAAAT	12	+	2	TAAAAA
gi|514486271|gb|KE346361.1|	881128	881142	ACTCC	14	+	2	CTCCA
gi|514486271|gb|KE346361.1|	881955	881968	AATGAG	13	+	2	ATGAGA
gi|514486271|gb|KE346361.1|	882867	882881	AGCG	14	-	3	CGCT
gi|514486271|gb|KE346361.1|	883283	883297	ACG	14	-	4	TCG
gi|514486271|gb|KE346361.1|	883302	883314	AACGAC	12	-	2	CGTTGT
gi|514486271|gb|KE346361.1|	883427	883441	ACG	14	-	4	TCG
gi|514486271|gb|KE346361.1|	883544	883568	ACG	24	-	8	TCG
gi|514486271|gb|KE346361.1|	884676	884690	AAAC	14	+	3	AAAC
gi|514486271|gb|KE346361.1|	887696	887709	ACCGTC	13	-	2	CGGTGA
gi|514486271|gb|KE346361.1|	887706	887718	ACTGAG	12	+	2	GACTGA
gi|514486271|gb|KE346361.1|	888988	889001	AGC	13	+	4	AGC
gi|514486271|gb|KE346361.1|	889150	889167	ACTC	17	-	4	GAGT
gi|514486271|gb|KE346361.1|	889303	889333	AGG	30	+	10	GGA
gi|514486271|gb|KE346361.1|	889459	889472	AATCGC	13	-	2	TGCGAT
gi|514486271|gb|KE346361.1|	889670	889682	AATGAG	12	-	2	TTCTCA
gi|514486271|gb|KE346361.1|	889740	889759	A	19	-	19	T
gi|514486271|gb|KE346361.1|	890048	890062	A	14	+	14	A
gi|514486271|gb|KE346361.1|	890065	890082	A	17	+	17	A
gi|514486271|gb|KE346361.1|	890412	890441	A	29	-	29	T
gi|514486271|gb|KE346361.1|	890517	890529	AGG	12	-	4	CTC
gi|514486271|gb|KE346361.1|	890538	890551	AGAGGG	13	-	2	CTCTCC
gi|514486271|gb|KE346361.1|	890590	890602	ACATGC	12	-	2	GTGCAT
gi|514486271|gb|KE346361.1|	890652	890669	A	17	-	17	T
gi|514486271|gb|KE346361.1|	890683	890699	A	16	-	16	T
gi|514486271|gb|KE346361.1|	890843	890856	A	13	-	13	T
gi|514486271|gb|KE346361.1|	890982	891027	A	45	-	45	T
gi|514486271|gb|KE346361.1|	891892	891983	AG	91	-	45	TC
gi|514486271|gb|KE346361.1|	891984	892001	AG	17	-	8	TC
gi|514486271|gb|KE346361.1|	893265	893277	A	12	+	12	A
gi|514486271|gb|KE346361.1|	893383	893395	AACGCG	12	+	2	AACGCG
gi|514486271|gb|KE346361.1|	893401	893415	AAGCC	14	+	2	CCAAG
gi|514486271|gb|KE346361.1|	894130	894146	A	16	+	16	A
gi|514486271|gb|KE346361.1|	894467	894484	ACGGCC	17	-	2	GGCCGT
gi|514486271|gb|KE346361.1|	894802	894815	AGGCCG	13	-	2	CCTCGG
gi|514486271|gb|KE346361.1|	895529	895545	AAAAAC	16	-	2	TTTTGT
gi|514486271|gb|KE346361.1|	895772	895784	ACC	12	-	4	GGT
gi|514486271|gb|KE346361.1|	895837	895851	AAAGTC	14	+	2	AAAGTC
gi|514486271|gb|KE346361.1|	896165	896177	AACCTC	12	-	2	AGGTTG
gi|514486271|gb|KE346361.1|	896243	896255	AGGCGG	12	+	2	GGAGGC
gi|514486271|gb|KE346361.1|	896606	896618	AGCTCG	12	+	2	AGCTCG
gi|514486271|gb|KE346361.1|	897358	897370	ATGC	12	+	3	CATG
gi|514486271|gb|KE346361.1|	898523	898540	ACC	17	-	5	TGG
gi|514486271|gb|KE346361.1|	898868	898882	AAGC	14	+	3	CAAG
gi|514486271|gb|KE346361.1|	898904	898930	A	26	+	26	A
gi|514486271|gb|KE346361.1|	898951	898974	A	23	+	23	A
gi|514486271|gb|KE346361.1|	899149	899161	A	12	+	12	A
gi|514486271|gb|KE346361.1|	899164	899181	A	17	+	17	A
gi|514486271|gb|KE346361.1|	899486	899498	AACAC	12	-	2	TGTGT
gi|514486271|gb|KE346361.1|	899690	899704	AGATCG	14	+	2	GATCGA
gi|514486271|gb|KE346361.1|	899729	899741	AAAAAC	12	+	2	AAAAAC
gi|514486271|gb|KE346361.1|	900026	900038	AACT	12	-	3	AGTT
gi|514486271|gb|KE346361.1|	900827	900844	ACG	17	+	5	GAC
gi|514486271|gb|KE346361.1|	900839	900852	ACGAGG	13	+	2	GACGAG
gi|514486271|gb|KE346361.1|	901037	901050	A	13	+	13	A
gi|514486271|gb|KE346361.1|	902151	902164	AAGACC	13	-	2	TTGGTC
gi|514486271|gb|KE346361.1|	902406	902427	A	21	-	21	T
gi|514486271|gb|KE346361.1|	902432	902446	AAG	14	-	4	TTC
gi|514486271|gb|KE346361.1|	902600	902616	AG	16	-	8	CT
gi|514486271|gb|KE346361.1|	903650	903662	ACTCTC	12	-	2	GAGAGT
gi|514486271|gb|KE346361.1|	904420	904432	A	12	-	12	T
gi|514486271|gb|KE346361.1|	904593	904605	AAATCG	12	+	2	AAATCG
gi|514486271|gb|KE346361.1|	904731	904743	AGCCAT	12	-	2	TGGCTA
gi|514486271|gb|KE346361.1|	905619	905631	ACGAGG	12	+	2	CGAGGA
gi|514486271|gb|KE346361.1|	906076	906088	AAC	12	+	4	CAA
gi|514486271|gb|KE346361.1|	906209	906222	A	13	+	13	A
gi|514486271|gb|KE346361.1|	907553	907565	ACG	12	-	4	TCG
gi|514486271|gb|KE346361.1|	907568	907581	AAC	13	-	4	TTG
gi|514486271|gb|KE346361.1|	907579	907594	ACG	15	-	5	GTC
gi|514486271|gb|KE346361.1|	907618	907630	ACGATG	12	+	2	CGATGA
gi|514486271|gb|KE346361.1|	908088	908113	A	25	+	25	A
gi|514486271|gb|KE346361.1|	908159	908178	A	19	+	19	A
gi|514486271|gb|KE346361.1|	908331	908353	A	22	+	22	A
gi|514486271|gb|KE346361.1|	908737	908763	A	26	+	26	A
gi|514486271|gb|KE346361.1|	909743	909755	ACGAT	12	-	2	CGTAT
gi|514486271|gb|KE346361.1|	910766	910779	AATGCC	13	+	2	CAATGC
gi|514486271|gb|KE346361.1|	911424	911437	AAACTC	13	-	2	AGTTTG
gi|514486271|gb|KE346361.1|	912016	912028	AAGCC	12	-	2	CTTGG
gi|514486271|gb|KE346361.1|	912103	912117	ACACAT	14	+	2	CATACA
gi|514486271|gb|KE346361.1|	912184	912198	ACACAT	14	+	2	CATACA
gi|514486271|gb|KE346361.1|	914978	914992	AAC	14	+	4	CAA
gi|514486271|gb|KE346361.1|	914990	915004	ATC	14	+	4	CAT
gi|514486271|gb|KE346361.1|	915051	915068	AAAGCC	17	+	2	AAAGCC
gi|514486271|gb|KE346361.1|	915317	915330	AAACAC	13	-	2	GTGTTT
gi|514486271|gb|KE346361.1|	915449	915463	AACCAC	14	-	2	GTTGTG
gi|514486271|gb|KE346361.1|	915973	915989	ACC	16	-	5	TGG
gi|514486271|gb|KE346361.1|	916146	916158	ACGGGC	12	+	2	ACGGGC
gi|514486271|gb|KE346361.1|	916490	916502	AAAATG	12	+	2	ATGAAA
gi|514486271|gb|KE346361.1|	916767	916783	A	16	+	16	A
gi|514486271|gb|KE346361.1|	916844	916856	AAAAGC	12	+	2	GCAAAA
gi|514486271|gb|KE346361.1|	917155	917185	A	30	+	30	A
gi|514486271|gb|KE346361.1|	917322	917334	AAGGG	12	+	2	GGGAA
gi|514486271|gb|KE346361.1|	917418	917430	AAGGG	12	+	2	GGAAG
gi|514486271|gb|KE346361.1|	917507	917521	AGGG	14	+	3	GGGA
gi|514486271|gb|KE346361.1|	917560	917581	A	21	+	21	A
gi|514486271|gb|KE346361.1|	917596	917609	A	13	+	13	A
gi|514486271|gb|KE346361.1|	917741	917753	AAAAAT	12	+	2	TAAAAA
gi|514486271|gb|KE346361.1|	918324	918347	A	23	-	23	T
gi|514486271|gb|KE346361.1|	918499	918511	ACACCC	12	-	2	GTGGGT
gi|514486271|gb|KE346361.1|	919001	919015	AAAAC	14	-	2	TTTTG
gi|514486271|gb|KE346361.1|	919074	919089	AGCGCC	15	+	2	CCAGCG
gi|514486271|gb|KE346361.1|	920122	920135	AAAC	13	-	3	TTTG
gi|514486271|gb|KE346361.1|	920129	920141	AAACAC	12	-	2	GTTTGT
gi|514486271|gb|KE346361.1|	920341	920360	A	19	-	19	T
gi|514486271|gb|KE346361.1|	922459	922471	ACAGAG	12	-	2	GTCTCT
gi|514486271|gb|KE346361.1|	922872	922884	AAGCTC	12	+	2	TCAAGC
gi|514486271|gb|KE346361.1|	923996	924008	AATG	12	+	3	AATG
gi|514486271|gb|KE346361.1|	924240	924252	AAG	12	+	4	AAG
gi|514486271|gb|KE346361.1|	924331	924349	AAAAC	18	+	3	CAAAA
gi|514486271|gb|KE346361.1|	924571	924584	ACCGTC	13	-	2	CGGTGA
gi|514486271|gb|KE346361.1|	925141	925156	A	15	+	15	A
gi|514486271|gb|KE346361.1|	925372	925386	AAAAT	14	+	2	AAAAT
gi|514486271|gb|KE346361.1|	925618	925640	AAAAAT	22	+	3	AAAAAT
gi|514486271|gb|KE346361.1|	925799	925812	A	13	+	13	A
gi|514486271|gb|KE346361.1|	925817	925837	A	20	+	20	A
gi|514486271|gb|KE346361.1|	926724	926736	ATGGCC	12	+	2	GGCCAT
gi|514486271|gb|KE346361.1|	927531	927554	AG	23	+	11	AG
gi|514486271|gb|KE346361.1|	927658	927687	AATG	29	+	7	GAAT
gi|514486271|gb|KE346361.1|	927811	927823	AACTC	12	-	2	TGAGT
gi|514486271|gb|KE346361.1|	928010	928025	ATC	15	-	5	ATG
gi|514486271|gb|KE346361.1|	928109	928123	AGC	14	-	4	CTG
gi|514486271|gb|KE346361.1|	928135	928149	AAGCGC	14	-	2	TGCGCT
gi|514486271|gb|KE346361.1|	928594	928606	AAAGAG	12	+	2	AAGAGA
gi|514486271|gb|KE346361.1|	928958	928971	AACGGC	13	-	2	GCCGTT
gi|514486271|gb|KE346361.1|	930223	930236	A	13	+	13	A
gi|514486271|gb|KE346361.1|	930480	930492	AAAGCG	12	-	2	CGCTTT
gi|514486271|gb|KE346361.1|	930841	930853	A	12	-	12	T
gi|514486271|gb|KE346361.1|	931068	931083	AG	15	-	7	CT
gi|514486271|gb|KE346361.1|	931281	931293	ACGCAG	12	-	2	GCGTCT
gi|514486271|gb|KE346361.1|	931507	931527	AC	20	+	10	AC
gi|514486271|gb|KE346361.1|	931738	931750	ACACTG	12	+	2	TGACAC
gi|514486271|gb|KE346361.1|	931763	931778	AATCCT	15	+	2	CCTAAT
gi|514486271|gb|KE346361.1|	932460	932472	AAAGGC	12	+	2	AAGGCA
gi|514486271|gb|KE346361.1|	933573	933586	ACCGCC	13	-	2	GGCGGT
gi|514486271|gb|KE346361.1|	934434	934446	ACGCG	12	+	2	CGCGA
gi|514486271|gb|KE346361.1|	935009	935021	AGCTCG	12	+	2	CGAGCT
gi|514486271|gb|KE346361.1|	935269	935281	AATGAT	12	-	2	TTATCA
gi|514486271|gb|KE346361.1|	935970	935983	A	13	+	13	A
gi|514486271|gb|KE346361.1|	937560	937575	ACGG	15	+	3	GGAC
gi|514486271|gb|KE346361.1|	937649	937662	ACGATG	13	-	2	CATCGT
gi|514486271|gb|KE346361.1|	938035	938047	AGCGCG	12	+	2	CGAGCG
gi|514486271|gb|KE346361.1|	938479	938491	ACG	12	-	4	TCG
gi|514486271|gb|KE346361.1|	938578	938592	ATC	14	-	4	TGA
gi|514486271|gb|KE346361.1|	938812	938833	AAGCGC	21	-	3	TTGCGC
gi|514486271|gb|KE346361.1|	939252	939265	ACACGC	13	+	2	CACGCA
gi|514486271|gb|KE346361.1|	939443	939455	AAGTC	12	-	2	TGACT
gi|514486271|gb|KE346361.1|	939452	939464	AAC	12	-	4	TTG
gi|514486271|gb|KE346361.1|	939465	939481	ATC	16	-	5	TGA
gi|514486271|gb|KE346361.1|	939491	939505	AAGGG	14	-	2	CCCTT
gi|514486271|gb|KE346361.1|	939648	939660	ACGAGG	12	-	2	CTCGTC
gi|514486271|gb|KE346361.1|	940435	940450	AC	15	-	7	TG
gi|514486271|gb|KE346361.1|	940487	940504	A	17	-	17	T
gi|514486271|gb|KE346361.1|	941975	941992	ACCAGC	17	+	2	CAGCAC
gi|514486271|gb|KE346361.1|	942349	942361	AATG	12	+	3	ATGA
gi|514486271|gb|KE346361.1|	942376	942414	AAGTG	38	+	7	TGAAG
gi|514486271|gb|KE346361.1|	942657	942669	AATCTC	12	+	2	TCAATC
gi|514486271|gb|KE346361.1|	942680	942696	AACAGC	16	+	2	AACAGC
gi|514486271|gb|KE346361.1|	942693	942705	AC	12	+	6	AC
gi|514486271|gb|KE346361.1|	947084	947107	AAAC	23	+	5	AAAC
gi|514486271|gb|KE346361.1|	947197	947215	AAGAGG	18	-	3	CTCTTC
gi|514486271|gb|KE346361.1|	947766	947784	AAAGCC	18	+	3	CAAAGC
gi|514486271|gb|KE346361.1|	947806	947818	AACCTG	12	-	2	GTTCAG
gi|514486271|gb|KE346361.1|	947932	947948	ATC	16	+	5	ATC
gi|514486271|gb|KE346361.1|	948780	948792	ACCGCC	12	+	2	CCGCCA
gi|514486271|gb|KE346361.1|	949959	949975	AAC	16	+	5	CAA
gi|514486271|gb|KE346361.1|	950109	950121	AGGC	12	-	3	CTGC
gi|514486271|gb|KE346361.1|	951351	951365	AGC	14	-	4	GCT
gi|514486271|gb|KE346361.1|	952771	952783	ACAGTG	12	+	2	TGACAG
gi|514486271|gb|KE346361.1|	953198	953210	A	12	+	12	A
gi|514486271|gb|KE346361.1|	953743	953756	AGGGGG	13	+	2	GGAGGG
gi|514486271|gb|KE346361.1|	954813	954825	ACCGCG	12	-	2	CGGTCG
gi|514486271|gb|KE346361.1|	955079	955092	AAAC	13	+	3	AACA
gi|514486271|gb|KE346361.1|	955878	955893	AAGAG	15	+	3	GAGAA
gi|514486271|gb|KE346361.1|	956009	956021	AGCTGC	12	+	2	CAGCTG
gi|514486271|gb|KE346361.1|	956054	956066	AAAAAG	12	+	2	GAAAAA
gi|514486271|gb|KE346361.1|	956882	956894	AAAGAG	12	-	2	TTCTCT
gi|514486271|gb|KE346361.1|	957045	957060	AAAC	15	+	3	CAAA
gi|514486271|gb|KE346361.1|	957257	957282	AGGG	25	+	6	GGGA
gi|514486271|gb|KE346361.1|	957490	957502	AAAGC	12	+	2	AAAGC
gi|514486271|gb|KE346361.1|	957525	957538	AAATGC	13	+	2	TGCAAA
gi|514486271|gb|KE346361.1|	958129	958146	AAAAAG	17	+	2	AAAAAG
gi|514486271|gb|KE346361.1|	958434	958447	AAAC	13	+	3	ACAA
gi|514486271|gb|KE346361.1|	958574	958588	AAAGC	14	+	2	CAAAG
gi|514486271|gb|KE346361.1|	958995	959007	AAGCCG	12	-	2	GCTTCG
gi|514486271|gb|KE346361.1|	959150	959169	A	19	+	19	A
gi|514486271|gb|KE346361.1|	959909	959924	A	15	+	15	A
gi|514486271|gb|KE346361.1|	959919	959931	AAAAAG	12	+	2	AAAAAG
gi|514486271|gb|KE346361.1|	959966	959986	AGCC	20	-	5	CTGG
gi|514486271|gb|KE346361.1|	961138	961150	C	12	+	12	C
gi|514486271|gb|KE346361.1|	961378	961390	AAC	12	-	4	TTG
gi|514486271|gb|KE346361.1|	961564	961590	AC	26	-	13	TG
gi|514486271|gb|KE346361.1|	961908	961923	A	15	-	15	T
gi|514486271|gb|KE346361.1|	961918	961930	AAAAAC	12	-	2	TTTTTG
gi|514486271|gb|KE346361.1|	962264	962279	A	15	-	15	T
gi|514486271|gb|KE346361.1|	962611	962623	A	12	-	12	T
gi|514486271|gb|KE346361.1|	962852	962864	ACACCC	12	-	2	GTGTGG
gi|514486271|gb|KE346361.1|	963465	963478	ACGCAG	13	+	2	CAGACG
gi|514486271|gb|KE346361.1|	963787	963803	AAAC	16	+	4	ACAA
gi|514486271|gb|KE346361.1|	963846	963858	CCCCCG	12	+	2	CCCCGC
gi|514486271|gb|KE346361.1|	963867	963881	AC	14	+	7	CA
gi|514486271|gb|KE346361.1|	963964	963976	ACCGCC	12	+	2	CACCGC
gi|514486271|gb|KE346361.1|	964409	964423	AAAAC	14	+	2	AAAAC
gi|514486271|gb|KE346361.1|	964417	964429	AAAAAC	12	+	2	ACAAAA
gi|514486271|gb|KE346361.1|	964425	964441	AAAAAC	16	+	2	AAAACA
gi|514486271|gb|KE346361.1|	964903	964918	AAAAAC	15	-	2	TTTTTG
gi|514486271|gb|KE346361.1|	964915	964927	AAAAC	12	-	2	TTTGT
gi|514486271|gb|KE346361.1|	964996	965011	AATGTC	15	+	2	GTCAAT
gi|514486271|gb|KE346361.1|	965244	965273	A	29	+	29	A
gi|514486271|gb|KE346361.1|	965317	965329	ACAGCG	12	-	2	CTGTCG
gi|514486271|gb|KE346361.1|	965580	965593	CCG	13	-	4	GGC
gi|514486271|gb|KE346361.1|	965645	965660	ACCACG	15	+	2	CACGAC
gi|514486271|gb|KE346361.1|	965838	965850	AACCTC	12	+	2	TCAACC
gi|514486271|gb|KE346361.1|	966107	966132	AATC	25	+	6	TCAA
gi|514486271|gb|KE346361.1|	966134	966147	AATC	13	+	3	TCAA
gi|514486271|gb|KE346361.1|	966659	966671	A	12	-	12	T
gi|514486271|gb|KE346361.1|	967369	967391	A	22	+	22	A
gi|514486271|gb|KE346361.1|	967596	967610	AAAAC	14	+	2	AAAAC
gi|514486271|gb|KE346361.1|	967606	967621	A	15	+	15	A
gi|514486271|gb|KE346361.1|	967664	967688	A	24	-	24	T
gi|514486271|gb|KE346361.1|	967883	967896	A	13	-	13	T
gi|514486271|gb|KE346361.1|	968038	968055	AAAAAG	17	-	2	TTTTTC
gi|514486271|gb|KE346361.1|	968064	968078	A	14	-	14	T
gi|514486271|gb|KE346361.1|	968083	968098	AAAT	15	+	3	AAAT
gi|514486271|gb|KE346361.1|	968168	968181	AAAG	13	-	3	TTTC
gi|514486271|gb|KE346361.1|	968190	968225	ACAGAG	35	-	5	TCTCTG
gi|514486271|gb|KE346361.1|	968313	968327	AAAAAC	14	-	2	GTTTTT
gi|514486271|gb|KE346361.1|	968333	968348	A	15	-	15	T
gi|514486271|gb|KE346361.1|	968356	968383	AAAC	27	-	6	TTGT
gi|514486271|gb|KE346361.1|	969000	969012	ACCATG	12	+	2	GACCAT
gi|514486271|gb|KE346361.1|	969662	969674	AAGC	12	-	3	TTGC
gi|514486271|gb|KE346361.1|	969682	969701	A	19	+	19	A
gi|514486271|gb|KE346361.1|	971091	971103	AGAGC	12	-	2	GCTCT
gi|514486271|gb|KE346361.1|	972898	972918	A	20	-	20	T
gi|514486271|gb|KE346361.1|	973520	973532	AAACAC	12	-	2	TTGTGT
gi|514486271|gb|KE346361.1|	973732	973762	A	30	+	30	A
gi|514486271|gb|KE346361.1|	974316	974333	A	17	-	17	T
gi|514486271|gb|KE346361.1|	974516	974531	AAGGCG	15	-	2	GCCTTC
gi|514486271|gb|KE346361.1|	976162	976174	ACGGCG	12	+	2	CGGCGA
gi|514486271|gb|KE346361.1|	976199	976218	CCG	19	-	6	GGC
gi|514486271|gb|KE346361.1|	977691	977703	AAACCG	12	+	2	GAAACC
gi|514486271|gb|KE346361.1|	977703	977716	AAAAAG	13	+	2	AGAAAA
gi|514486271|gb|KE346361.1|	978523	978537	A	14	-	14	T
gi|514486271|gb|KE346361.1|	978815	978827	AATCAC	12	-	2	ATTGTG
gi|514486271|gb|KE346361.1|	979013	979029	A	16	-	16	T
gi|514486271|gb|KE346361.1|	979201	979219	A	18	+	18	A
gi|514486271|gb|KE346361.1|	979491	979518	AGCC	27	-	6	TGGC
gi|514486271|gb|KE346361.1|	980162	980182	AAAC	20	-	5	TTTG
gi|514486271|gb|KE346361.1|	981105	981120	A	15	-	15	T
gi|514486271|gb|KE346361.1|	981424	981439	AGCGGC	15	-	2	GCTGCC
gi|514486271|gb|KE346361.1|	981463	981489	AACAGC	26	+	4	CAACAG
gi|514486271|gb|KE346361.1|	981619	981634	AGC	15	-	5	GCT
gi|514486271|gb|KE346361.1|	982000	982012	C	12	-	12	G
gi|514486271|gb|KE346361.1|	982245	982262	A	17	-	17	T
gi|514486271|gb|KE346361.1|	982280	982292	AGCGGG	12	-	2	CGCTCC
gi|514486271|gb|KE346361.1|	982325	982338	ACGGGG	13	-	2	CCCCGT
gi|514486271|gb|KE346361.1|	982440	982452	A	12	+	12	A
gi|514486271|gb|KE346361.1|	982463	982476	A	13	+	13	A
gi|514486271|gb|KE346361.1|	984087	984099	AAAACC	12	+	2	AAACCA
gi|514486271|gb|KE346361.1|	984668	984684	AGCCGC	16	-	2	GCGGCT
gi|514486271|gb|KE346361.1|	984841	984853	AAAAG	12	+	2	AAGAA
gi|514486271|gb|KE346361.1|	984977	984991	AAC	14	+	4	ACA
gi|514486271|gb|KE346361.1|	985043	985058	A	15	+	15	A
gi|514486271|gb|KE346361.1|	986769	986781	ATGGCC	12	+	2	ATGGCC
gi|514486271|gb|KE346361.1|	986868	986880	ACAGAG	12	+	2	CAGAGA
gi|514486271|gb|KE346361.1|	986927	986942	AAAC	15	+	3	AACA
gi|514486271|gb|KE346361.1|	986952	986964	ACC	12	+	4	ACC
gi|514486271|gb|KE346361.1|	987217	987232	AATG	15	+	3	GAAT
gi|514486271|gb|KE346361.1|	987660	987683	AGC	23	-	7	TGC
gi|514486271|gb|KE346361.1|	987688	987701	ATC	13	-	4	GAT
gi|514486271|gb|KE346361.1|	987880	987893	AAAGAG	13	+	2	AAAGAG
gi|514486271|gb|KE346361.1|	987919	987935	AG	16	+	8	GA
gi|514486271|gb|KE346361.1|	987984	987997	ACACTC	13	-	2	GTGAGT
gi|514486271|gb|KE346361.1|	988128	988140	AAGTG	12	+	2	AAGTG
gi|514486271|gb|KE346361.1|	988160	988190	A	30	+	30	A
gi|514486271|gb|KE346361.1|	988405	988431	A	26	+	26	A
gi|514486271|gb|KE346361.1|	988450	988464	A	14	+	14	A
gi|514486271|gb|KE346361.1|	988777	988789	AGAGCG	12	+	2	CGAGAG
gi|514486271|gb|KE346361.1|	989255	989268	AGAGGG	13	-	2	TCTCCC
gi|514486271|gb|KE346361.1|	989370	989383	AAATCG	13	-	2	GATTTC
gi|514486271|gb|KE346361.1|	989576	989593	ACG	17	-	5	TCG
gi|514486271|gb|KE346361.1|	989809	989821	AATGTC	12	-	2	CATTGA
gi|514486271|gb|KE346361.1|	990781	990796	AATC	15	+	3	CAAT
gi|514486271|gb|KE346361.1|	992686	992698	AAAAAC	12	+	2	AAACAA
gi|514486271|gb|KE346361.1|	993700	993712	AGCAGG	12	+	2	GAGCAG
gi|514486271|gb|KE346361.1|	994070	994100	ACTGGC	30	+	5	GGCACT
gi|514486271|gb|KE346361.1|	994102	994124	AGCATC	22	+	3	CAGCAT
gi|514486271|gb|KE346361.1|	994346	994359	AGC	13	+	4	CAG
gi|514486271|gb|KE346361.1|	994365	994381	ACC	16	-	5	TGG
gi|514486271|gb|KE346361.1|	995587	995599	AAC	12	+	4	CAA
gi|514486271|gb|KE346361.1|	995623	995638	AAAAAC	15	+	2	AAACAA
gi|514486271|gb|KE346361.1|	998000	998020	A	20	+	20	A
gi|514486271|gb|KE346361.1|	998026	998038	AAT	12	+	4	AAT
gi|514486271|gb|KE346361.1|	998495	998512	AAT	17	+	5	AAT
gi|514486271|gb|KE346361.1|	998706	998718	AAGAC	12	+	2	AAGAC
gi|514486271|gb|KE346361.1|	998769	998781	AAGCTC	12	+	2	CAAGCT
gi|514486271|gb|KE346361.1|	998910	998924	AAAAG	14	+	2	AAAAG
gi|514486271|gb|KE346361.1|	998920	998934	A	14	+	14	A
gi|514486271|gb|KE346361.1|	999680	999703	A	23	+	23	A
gi|514486271|gb|KE346361.1|	999893	999905	AATCC	12	+	2	AATCC
gi|514486271|gb|KE346361.1|	1000511	1000523	AG	12	-	6	TC
gi|514486271|gb|KE346361.1|	1000760	1000773	AAC	13	-	4	GTT
gi|514486271|gb|KE346361.1|	1001721	1001734	AACATT	13	-	2	TAATGT
gi|514486271|gb|KE346361.1|	1001938	1001950	AATGTC	12	-	2	TTGACA
gi|514486271|gb|KE346361.1|	1002169	1002183	ACTCTC	14	-	2	GAGTGA
gi|514486271|gb|KE346361.1|	1002214	1002227	AC	13	-	6	GT
gi|514486271|gb|KE346361.1|	1002489	1002501	AGC	12	+	4	AGC
gi|514486271|gb|KE346361.1|	1002519	1002535	ACG	16	+	5	CGA
gi|514486271|gb|KE346361.1|	1002541	1002553	AGC	12	+	4	GCA
gi|514486271|gb|KE346361.1|	1002759	1002777	ACATCC	18	+	3	CATCCA
gi|514486271|gb|KE346361.1|	1003313	1003328	A	15	+	15	A
gi|514486271|gb|KE346361.1|	1009357	1009375	AGGCGC	18	+	3	GCAGGC
gi|514486271|gb|KE346361.1|	1009885	1009897	ACCCCT	12	-	2	TAGGGG
gi|514486271|gb|KE346361.1|	1010040	1010091	AG	51	-	25	CT
gi|514486271|gb|KE346361.1|	1010103	1010120	AACAGC	17	+	2	AACAGC
gi|514486271|gb|KE346361.1|	1010170	1010184	ATC	14	-	4	ATG
gi|514486271|gb|KE346361.1|	1011729	1011745	ACG	16	+	5	GAC
gi|514486271|gb|KE346361.1|	1011863	1011878	ACC	15	-	5	TGG
gi|514486271|gb|KE346361.1|	1012300	1012312	AG	12	-	6	TC
gi|514486271|gb|KE346361.1|	1012313	1012326	ACTC	13	+	3	CACT
gi|514486271|gb|KE346361.1|	1012504	1012520	AAGAG	16	-	3	TTCTC
gi|514486271|gb|KE346361.1|	1012578	1012591	AC	13	+	6	CA
gi|514486271|gb|KE346361.1|	1012689	1012701	A	12	+	12	A
gi|514486271|gb|KE346361.1|	1012727	1012741	A	14	+	14	A
gi|514486271|gb|KE346361.1|	1012818	1012831	AG	13	+	6	GA
gi|514486271|gb|KE346361.1|	1012826	1012848	AGAGCG	22	+	3	GAGAGC
gi|514486271|gb|KE346361.1|	1012932	1012953	A	21	-	21	T
gi|514486271|gb|KE346361.1|	1013449	1013462	AC	13	+	6	AC
gi|514486271|gb|KE346361.1|	1013598	1013610	AAGGCC	12	+	2	GCCAAG
gi|514486271|gb|KE346361.1|	1013773	1013795	AGCGCC	22	-	3	CTGGCG
gi|514486271|gb|KE346361.1|	1016193	1016205	AGCAGG	12	+	2	GGAGCA
gi|514486271|gb|KE346361.1|	1016410	1016425	ACGGAG	15	+	2	AGACGG
gi|514486271|gb|KE346361.1|	1016613	1016626	AAAAGC	13	-	2	TTGCTT
gi|514486271|gb|KE346361.1|	1016789	1016805	CCG	16	+	5	CCG
gi|514486271|gb|KE346361.1|	1016939	1016960	A	21	-	21	T
gi|514486271|gb|KE346361.1|	1017311	1017323	A	12	+	12	A
gi|514486271|gb|KE346361.1|	1017330	1017348	AAAAAG	18	-	3	CTTTTT
gi|514486271|gb|KE346361.1|	1017350	1017363	A	13	-	13	T
gi|514486271|gb|KE346361.1|	1017522	1017535	AAAAC	13	-	2	TTTGT
gi|514486271|gb|KE346361.1|	1017904	1017916	AAAGGG	12	+	2	GGAAAG
gi|514486271|gb|KE346361.1|	1018112	1018126	AAGTCG	14	-	2	TTCGAC
gi|514486271|gb|KE346361.1|	1018831	1018844	AAGATC	13	+	2	GATCAA
gi|514486271|gb|KE346361.1|	1019282	1019294	AAACAC	12	-	2	TTTGTG
gi|514486271|gb|KE346361.1|	1019300	1019312	ACATGC	12	-	2	TGTGCA
gi|514486271|gb|KE346361.1|	1019909	1019921	ACTCG	12	-	2	CGAGT
gi|514486271|gb|KE346361.1|	1020400	1020413	AATGAG	13	-	2	TCATTC
gi|514486271|gb|KE346361.1|	1022604	1022618	ACTCCC	14	+	2	CCACTC
gi|514486271|gb|KE346361.1|	1022896	1022911	A	15	-	15	T
gi|514486271|gb|KE346361.1|	1022945	1022960	A	15	-	15	T
gi|514486271|gb|KE346361.1|	1023181	1023202	A	21	-	21	T
gi|514486271|gb|KE346361.1|	1023839	1023853	AAGC	14	-	3	CTTG
gi|514486271|gb|KE346361.1|	1024577	1024589	ACGACT	12	+	2	ACGACT
gi|514486271|gb|KE346361.1|	1024591	1024605	ACGAGG	14	+	2	GACGAG
gi|514486271|gb|KE346361.1|	1026566	1026582	ACG	16	-	5	GTC
gi|514486271|gb|KE346361.1|	1027053	1027067	AAATC	14	-	2	TTTGA
gi|514486271|gb|KE346361.1|	1027197	1027209	AGGGG	12	+	2	GGGAG
gi|514486271|gb|KE346361.1|	1027850	1027872	AC	22	+	11	CA
gi|514486271|gb|KE346361.1|	1028171	1028186	ACAGAG	15	-	2	CTCTGT
gi|514486271|gb|KE346361.1|	1028385	1028397	AAATGC	12	-	2	TTGCAT
gi|514486271|gb|KE346361.1|	1029190	1029204	AAAAC	14	+	2	ACAAA
gi|514486271|gb|KE346361.1|	1029742	1029754	AAAGAC	12	+	2	GACAAA
gi|514486271|gb|KE346361.1|	1029999	1030012	AAAAAG	13	-	2	TTCTTT
gi|514486271|gb|KE346361.1|	1030210	1030222	ATCCCC	12	-	2	TGGGGA
gi|514486271|gb|KE346361.1|	1030327	1030341	ATCCCC	14	-	2	TGGGGA
gi|514486271|gb|KE346361.1|	1030568	1030580	ACCTCG	12	-	2	CGAGGT
gi|514486271|gb|KE346361.1|	1031565	1031577	AAATTG	12	+	2	TGAAAT
gi|514486271|gb|KE346361.1|	1032498	1032518	AAC	20	-	6	TTG
gi|514486271|gb|KE346361.1|	1032515	1032533	AACG	18	-	4	GTTC
gi|514486271|gb|KE346361.1|	1032896	1032913	CCG	17	-	5	GCG
gi|514486271|gb|KE346361.1|	1033292	1033313	A	21	-	21	T
gi|514486271|gb|KE346361.1|	1033548	1033560	AATC	12	-	3	ATTG
gi|514486271|gb|KE346361.1|	1033965	1033981	AC	16	-	8	TG
gi|514486271|gb|KE346361.1|	1034170	1034182	AACGAC	12	+	2	CAACGA
gi|514486271|gb|KE346361.1|	1034186	1034228	A	42	-	42	T
gi|514486271|gb|KE346361.1|	1034306	1034326	AACAGC	20	-	3	CTGTTG
gi|514486271|gb|KE346361.1|	1034472	1034486	ATC	14	-	4	GAT
gi|514486271|gb|KE346361.1|	1034809	1034821	ACGGCC	12	-	2	CCGTGG
gi|514486271|gb|KE346361.1|	1035539	1035615	AGC	76	-	25	TGC
gi|514486271|gb|KE346361.1|	1035785	1035798	AAAAAG	13	-	2	CTTTTT
gi|514486271|gb|KE346361.1|	1035817	1035829	AAGCGC	12	+	2	AGCGCA
gi|514486271|gb|KE346361.1|	1036017	1036033	AAAACC	16	+	2	AACCAA
gi|514486271|gb|KE346361.1|	1036372	1036385	AGGCCG	13	-	2	CTCGGC
gi|514486271|gb|KE346361.1|	1036920	1036932	AATGAG	12	-	2	TCATTC
gi|514486271|gb|KE346361.1|	1037021	1037041	A	20	+	20	A
gi|514486271|gb|KE346361.1|	1037249	1037265	AAAAT	16	+	3	ATAAA
gi|514486271|gb|KE346361.1|	1037266	1037280	AAAAT	14	+	2	AAAAT
gi|514486271|gb|KE346361.1|	1037274	1037292	AAAAAT	18	+	3	ATAAAA
gi|514486271|gb|KE346361.1|	1037286	1037298	AAAAT	12	+	2	ATAAA
gi|514486271|gb|KE346361.1|	1037472	1037487	A	15	-	15	T
gi|514486271|gb|KE346361.1|	1037683	1037695	AACGAC	12	-	2	GTTGTC
gi|514486271|gb|KE346361.1|	1037915	1037929	AACATG	14	-	2	TGTTCA
gi|514486271|gb|KE346361.1|	1038902	1038915	ACCCCC	13	-	2	GGGGTG
gi|514486271|gb|KE346361.1|	1039700	1039724	AAGGCG	24	+	4	AAGGCG
gi|514486271|gb|KE346361.1|	1039894	1039923	ACAGAG	29	+	4	AGAGAC
gi|514486271|gb|KE346361.1|	1040781	1040799	AG	18	-	9	CT
gi|514486271|gb|KE346361.1|	1040818	1040830	ACTC	12	+	3	TCAC
gi|514486271|gb|KE346361.1|	1041186	1041198	AAAGG	12	+	2	GGAAA
gi|514486271|gb|KE346361.1|	1041311	1041323	AACGAC	12	+	2	CAACGA
gi|514486271|gb|KE346361.1|	1041691	1041704	AAACGG	13	-	2	CGTTTC
gi|514486271|gb|KE346361.1|	1041749	1041779	AAC	30	-	10	TTG
gi|514486271|gb|KE346361.1|	1042203	1042216	ACGCCG	13	+	2	CGCCGA
gi|514486271|gb|KE346361.1|	1043854	1043867	A	13	-	13	T
gi|514486271|gb|KE346361.1|	1044237	1044256	A	19	-	19	T
gi|514486271|gb|KE346361.1|	1044441	1044453	A	12	-	12	T
gi|514486271|gb|KE346361.1|	1044463	1044475	AAAAGC	12	-	2	TTTTGC
gi|514486271|gb|KE346361.1|	1044490	1044502	A	12	-	12	T
gi|514486271|gb|KE346361.1|	1044707	1044730	A	23	-	23	T
gi|514486271|gb|KE346361.1|	1044922	1044936	AAAAT	14	-	2	TTTTA
gi|514486271|gb|KE346361.1|	1045093	1045107	A	14	-	14	T
gi|514486271|gb|KE346361.1|	1045280	1045296	A	16	+	16	A
gi|514486271|gb|KE346361.1|	1045458	1045474	AACAGC	16	-	2	GTTGCT
gi|514486271|gb|KE346361.1|	1045581	1045593	AAAAAT	12	-	2	ATTTTT
gi|514486271|gb|KE346361.1|	1045594	1045611	AAAAAC	17	-	2	TTGTTT
gi|514486271|gb|KE346361.1|	1045627	1045648	AAAAAC	21	-	3	TTTGTT
gi|514486271|gb|KE346361.1|	1045657	1045679	A	22	-	22	T
gi|514486271|gb|KE346361.1|	1046024	1046039	A	15	-	15	T
gi|514486271|gb|KE346361.1|	1046386	1046398	AACCAC	12	-	2	GGTTGT
gi|514486271|gb|KE346361.1|	1046434	1046447	AAAAAC	13	-	2	TGTTTT
gi|514486271|gb|KE346361.1|	1046452	1046469	A	17	-	17	T
gi|514486271|gb|KE346361.1|	1047080	1047097	AAAAAC	17	-	2	TTTTTG
gi|514486271|gb|KE346361.1|	1047388	1047406	AC	18	-	9	TG
gi|514486271|gb|KE346361.1|	1047433	1047445	ACGTC	12	-	2	ACGTG
gi|514486271|gb|KE346361.1|	1047640	1047655	AAC	15	-	5	TGT
gi|514486271|gb|KE346361.1|	1047786	1047798	AAGAGC	12	+	2	AGCAAG
gi|514486271|gb|KE346361.1|	1047889	1047901	AAAAAC	12	-	2	TTTTTG
gi|514486271|gb|KE346361.1|	1048431	1048448	A	17	-	17	T
gi|514486271|gb|KE346361.1|	1048470	1048484	AAC	14	-	4	TTG
gi|514486271|gb|KE346361.1|	1048494	1048506	AAAC	12	-	3	TTTG
gi|514486271|gb|KE346361.1|	1048697	1048709	AAAAC	12	-	2	TTGTT
gi|514486271|gb|KE346361.1|	1048993	1049042	AG	49	-	24	TC
gi|514486271|gb|KE346361.1|	1049043	1049057	AG	14	-	7	TC
gi|514486271|gb|KE346361.1|	1049150	1049162	AGGGG	12	-	2	CCCCT
gi|514486271|gb|KE346361.1|	1049189	1049205	AAACG	16	+	3	ACGAA
gi|514486271|gb|KE346361.1|	1050263	1050275	AGGCCG	12	-	2	GCCTCG
gi|514486271|gb|KE346361.1|	1050692	1050708	AGC	16	-	5	GCT
gi|514486271|gb|KE346361.1|	1050706	1050720	AAC	14	-	4	TGT
gi|514486271|gb|KE346361.1|	1050727	1050744	AAC	17	-	5	TGT
gi|514486271|gb|KE346361.1|	1050759	1050771	AATGCG	12	+	2	GCGAAT
gi|514486271|gb|KE346361.1|	1052107	1052119	AAGGGC	12	+	2	GCAAGG
gi|514486271|gb|KE346361.1|	1053379	1053392	CCG	13	-	4	GGC
gi|514486271|gb|KE346361.1|	1053591	1053608	AT	17	+	8	TA
gi|514486271|gb|KE346361.1|	1053607	1053631	AC	24	-	12	TG
gi|514486271|gb|KE346361.1|	1053794	1053810	ACT	16	-	5	GTA
gi|514486271|gb|KE346361.1|	1053934	1053954	ACG	20	+	6	CGA
gi|514486271|gb|KE346361.1|	1053975	1053988	ACG	13	+	4	ACG
gi|514486271|gb|KE346361.1|	1054143	1054155	ATC	12	-	4	ATG
gi|514486271|gb|KE346361.1|	1054168	1054184	CCG	16	-	5	CGG
gi|514486271|gb|KE346361.1|	1054239	1054253	A	14	+	14	A
gi|514486271|gb|KE346361.1|	1054266	1054285	A	19	+	19	A
gi|514486271|gb|KE346361.1|	1054307	1054319	AATGG	12	+	2	GAATG
gi|514486271|gb|KE346361.1|	1054901	1054952	A	51	+	51	A
gi|514486271|gb|KE346361.1|	1055517	1055531	ACCCCC	14	-	2	GGGTGG
gi|514486271|gb|KE346361.1|	1057281	1057293	AGAGAT	12	+	2	TAGAGA
gi|514486271|gb|KE346361.1|	1058461	1058475	ACCCCC	14	+	2	CCCCAC
gi|514486271|gb|KE346361.1|	1058597	1058609	AAAACG	12	+	2	AAAACG
gi|514486271|gb|KE346361.1|	1063227	1063241	A	14	+	14	A
gi|514486271|gb|KE346361.1|	1064864	1064879	AACAGC	15	+	2	CAACAG
gi|514486271|gb|KE346361.1|	1065214	1065226	AGCAT	12	-	2	CTATG
gi|514486271|gb|KE346361.1|	1066444	1066459	AAAAC	15	+	3	CAAAA
gi|514486271|gb|KE346361.1|	1066944	1066958	AAAAG	14	+	2	AAAAG
gi|514486271|gb|KE346361.1|	1067288	1067305	AGCCGC	17	+	2	CAGCCG
gi|514486271|gb|KE346361.1|	1067306	1067322	AGCCGC	16	+	2	CAGCCG
gi|514486271|gb|KE346361.1|	1068779	1068791	A	12	+	12	A
gi|514486271|gb|KE346361.1|	1069355	1069368	ACTGCG	13	+	2	CTGCGA
gi|514486271|gb|KE346361.1|	1069755	1069769	AAAAAC	14	+	2	AAAAAC
gi|514486271|gb|KE346361.1|	1070357	1070369	AAAAAC	12	+	2	ACAAAA
gi|514486271|gb|KE346361.1|	1070363	1070375	AAAAC	12	+	2	ACAAA
gi|514486271|gb|KE346361.1|	1070384	1070405	AC	21	+	10	AC
gi|514486271|gb|KE346361.1|	1070979	1070991	AACGGG	12	+	2	AACGGG
gi|514486271|gb|KE346361.1|	1071154	1071168	AC	14	+	7	AC
gi|514486271|gb|KE346361.1|	1072804	1072817	AGGGGG	13	+	2	GAGGGG
gi|514486271|gb|KE346361.1|	1072921	1072936	AGC	15	+	5	AGC
gi|514486271|gb|KE346361.1|	1073026	1073049	AGAGGG	23	+	3	GAGAGG
gi|514486271|gb|KE346361.1|	1073321	1073389	AC	68	+	34	CA
gi|514486271|gb|KE346361.1|	1073689	1073705	AAAATG	16	-	2	TTTTCA
gi|514486271|gb|KE346361.1|	1073701	1073713	A	12	-	12	T
gi|514486271|gb|KE346361.1|	1074088	1074101	AACCAC	13	+	2	CAACCA
gi|514486271|gb|KE346361.1|	1074415	1074427	AC	12	+	6	AC
gi|514486271|gb|KE346361.1|	1074520	1074532	AGG	12	-	4	TCC
gi|514486271|gb|KE346361.1|	1074578	1074592	ACCCAT	14	+	2	CCATAC
gi|514486271|gb|KE346361.1|	1074632	1074649	ACC	17	+	5	CCA
gi|514486271|gb|KE346361.1|	1075751	1075764	A	13	+	13	A
gi|514486271|gb|KE346361.1|	1076980	1076995	ACATGC	15	+	2	ATGCAC
gi|514486271|gb|KE346361.1|	1078227	1078240	AAACC	13	-	2	TGGTT
gi|514486271|gb|KE346361.1|	1078982	1078999	AACAGC	17	+	2	CAACAG
gi|514486271|gb|KE346361.1|	1079940	1079952	CCG	12	+	4	GCC
gi|514486271|gb|KE346361.1|	1080403	1080441	AG	38	+	19	AG
gi|514486271|gb|KE346361.1|	1080472	1080484	AG	12	+	6	GA
gi|514486271|gb|KE346361.1|	1081441	1081454	A	13	+	13	A
gi|514486271|gb|KE346361.1|	1081490	1081503	AAAAAC	13	-	2	TGTTTT
gi|514486271|gb|KE346361.1|	1081502	1081514	AAAAAC	12	-	2	TTTTTG
gi|514486271|gb|KE346361.1|	1081870	1081890	A	20	-	20	T
gi|514486271|gb|KE346361.1|	1081925	1081938	AAGGCG	13	-	2	CTTCGC
gi|514486271|gb|KE346361.1|	1081943	1081955	AAAGAG	12	-	2	TTTCTC
gi|514486271|gb|KE346361.1|	1082116	1082134	AGC	18	-	6	GCT
gi|514486271|gb|KE346361.1|	1082236	1082248	A	12	-	12	T
gi|514486271|gb|KE346361.1|	1082273	1082286	A	13	-	13	T
gi|514486271|gb|KE346361.1|	1082483	1082496	AAAC	13	+	3	AACA
gi|514486271|gb|KE346361.1|	1082518	1082535	AAAAAT	17	-	2	TTTTTA
gi|514486271|gb|KE346361.1|	1082698	1082713	A	15	-	15	T
gi|514486271|gb|KE346361.1|	1083161	1083173	AGCCTC	12	-	2	AGGCTG
gi|514486271|gb|KE346361.1|	1086770	1086784	AGCGGC	14	-	2	GCCGCT
gi|514486271|gb|KE346361.1|	1086779	1086803	AGC	24	-	8	GCT
gi|514486271|gb|KE346361.1|	1087298	1087313	ACGATG	15	+	2	TGACGA
gi|514486271|gb|KE346361.1|	1087506	1087528	ACG	22	-	7	GTC
gi|514486271|gb|KE346361.1|	1087583	1087595	AACAGC	12	-	2	TTGCTG
gi|514486271|gb|KE346361.1|	1087614	1087634	ATCGCC	20	+	3	CCATCG
gi|514486271|gb|KE346361.1|	1087669	1087694	ACAGGC	25	-	4	GTGCCT
gi|514486271|gb|KE346361.1|	1088404	1088416	AAAC	12	-	3	TGTT
gi|514486271|gb|KE346361.1|	1088517	1088530	ACCACG	13	+	2	CGACCA
gi|514486271|gb|KE346361.1|	1088528	1088540	AACCAC	12	+	2	ACCACA
gi|514486271|gb|KE346361.1|	1088541	1088556	ACCACG	15	+	2	CGACCA
gi|514486271|gb|KE346361.1|	1089821	1089833	AACGAC	12	+	2	ACAACG
gi|514486271|gb|KE346361.1|	1091834	1091846	ACTCTG	12	+	2	CTGACT
gi|514486271|gb|KE346361.1|	1092028	1092040	AGCGCC	12	-	2	GCTGGC
gi|514486271|gb|KE346361.1|	1092431	1092444	AACGAC	13	+	2	ACGACA
gi|514486271|gb|KE346361.1|	1093001	1093013	AACGAC	12	+	2	GACAAC
gi|514486271|gb|KE346361.1|	1093485	1093499	AAGCAG	14	+	2	AGAAGC
gi|514486271|gb|KE346361.1|	1093701	1093713	AACTAC	12	-	2	TGTAGT
gi|514486271|gb|KE346361.1|	1094482	1094494	A	12	-	12	T
gi|514486271|gb|KE346361.1|	1094747	1094766	ATC	19	-	6	GAT
gi|514486271|gb|KE346361.1|	1094767	1094780	ATC	13	-	4	TGA
gi|514486271|gb|KE346361.1|	1095184	1095202	AAAG	18	+	4	GAAA
gi|514486271|gb|KE346361.1|	1096951	1096970	AAGAG	19	+	3	AAGAG
gi|514486271|gb|KE346361.1|	1097663	1097678	CCG	15	-	5	GCG
gi|514486271|gb|KE346361.1|	1097839	1097851	ACTGCT	12	-	2	GCAGTA
gi|514486271|gb|KE346361.1|	1098137	1098150	A	13	+	13	A
gi|514486271|gb|KE346361.1|	1098419	1098432	ACTGAG	13	-	2	TCTCAG
gi|514486271|gb|KE346361.1|	1098432	1098445	ACTGAG	13	-	2	TCTCAG
gi|514486271|gb|KE346361.1|	1098769	1098784	ACG	15	+	5	CGA
gi|514486271|gb|KE346361.1|	1098932	1098948	ACCG	16	+	4	CGAC
gi|514486271|gb|KE346361.1|	1099171	1099186	ACG	15	+	5	CGA
gi|514486271|gb|KE346361.1|	1099418	1099430	AGAGGC	12	+	2	GCAGAG
gi|514486271|gb|KE346361.1|	1099489	1099501	AATGTG	12	-	2	CATTCA
gi|514486271|gb|KE346361.1|	1099946	1099960	AAGATG	14	+	2	GAAGAT
gi|514486271|gb|KE346361.1|	1099964	1099978	AGGATG	14	+	2	GATGAG
gi|514486271|gb|KE346361.1|	1100687	1100700	AAAGC	13	-	2	TTTGC
gi|514486271|gb|KE346361.1|	1101746	1101761	A	15	-	15	T
gi|514486271|gb|KE346361.1|	1101885	1101899	A	14	-	14	T
gi|514486271|gb|KE346361.1|	1102917	1102930	ATCGGC	13	-	2	GATGCC
gi|514486271|gb|KE346361.1|	1103469	1103486	AC	17	+	8	CA
gi|514486271|gb|KE346361.1|	1103680	1103693	AAAGGC	13	+	2	GGCAAA
gi|514486271|gb|KE346361.1|	1104200	1104214	ACTATC	14	-	2	GTGATA
gi|514486271|gb|KE346361.1|	1104933	1104949	AAG	16	-	5	TCT
gi|514486271|gb|KE346361.1|	1105195	1105208	AATGAG	13	+	2	GAGAAT
gi|514486271|gb|KE346361.1|	1105229	1105242	AAAG	13	+	3	AAAG
gi|514486271|gb|KE346361.1|	1105791	1105804	AGCGGC	13	+	2	GCGGCA
gi|514486271|gb|KE346361.1|	1105814	1105826	AGGGGC	12	+	2	GGCAGG
gi|514486271|gb|KE346361.1|	1107411	1107425	ATCATG	14	+	2	TGATCA
gi|514486271|gb|KE346361.1|	1107655	1107676	AAC	21	+	7	CAA
gi|514486271|gb|KE346361.1|	1108064	1108076	AACAGG	12	+	2	CAGGAA
gi|514486271|gb|KE346361.1|	1108441	1108453	AGGGGG	12	+	2	GGAGGG
gi|514486271|gb|KE346361.1|	1108500	1108513	AC	13	+	6	AC
gi|514486271|gb|KE346361.1|	1108747	1108759	AATGCC	12	+	2	ATGCCA
gi|514486271|gb|KE346361.1|	1110130	1110142	ACGAGC	12	+	2	GAGCAC
gi|514486271|gb|KE346361.1|	1110260	1110273	AGCTC	13	-	2	GCTGA
gi|514486271|gb|KE346361.1|	1110472	1110487	AAACCC	15	+	2	CCCAAA
gi|514486271|gb|KE346361.1|	1110590	1110603	AAGCC	13	+	2	AGCCA
gi|514486271|gb|KE346361.1|	1110636	1110648	AAATGC	12	-	2	TGCATT
gi|514486271|gb|KE346361.1|	1112253	1112266	ACTGAG	13	+	2	GAGACT
gi|514486271|gb|KE346361.1|	1112951	1112965	AGAGCG	14	+	2	CGAGAG
gi|514486271|gb|KE346361.1|	1113163	1113175	ACCTCC	12	+	2	TCCACC
gi|514486271|gb|KE346361.1|	1113454	1113466	AACAGC	12	+	2	CAGCAA
gi|514486271|gb|KE346361.1|	1113485	1113498	AACAGC	13	+	2	AGCAAC
gi|514486271|gb|KE346361.1|	1114099	1114112	AGCTCC	13	-	2	AGCTGG
gi|514486271|gb|KE346361.1|	1115846	1115858	AACATC	12	-	2	TGTTGA
gi|514486271|gb|KE346361.1|	1116696	1116708	ACGATG	12	+	2	GACGAT
gi|514486271|gb|KE346361.1|	1117182	1117196	AGAGCC	14	+	2	CCAGAG
gi|514486271|gb|KE346361.1|	1117226	1117238	ACGTCG	12	+	2	GACGTC
gi|514486271|gb|KE346361.1|	1117234	1117246	ACGATG	12	-	2	CGTCAT
gi|514486271|gb|KE346361.1|	1121138	1121150	AAGCAC	12	+	2	AAGCAC
gi|514486271|gb|KE346361.1|	1121959	1121972	AGAGGC	13	+	2	CAGAGG
gi|514486271|gb|KE346361.1|	1123451	1123466	AGC	15	-	5	TGC
gi|514486271|gb|KE346361.1|	1124274	1124288	AACAGC	14	-	2	TGTTGC
gi|514486271|gb|KE346361.1|	1124303	1124323	AACAGC	20	-	3	TGTTGC
gi|514486271|gb|KE346361.1|	1124333	1124348	AACAGC	15	-	2	TGCTGT
gi|514486271|gb|KE346361.1|	1124515	1124527	CCG	12	-	4	GGC
gi|514486271|gb|KE346361.1|	1124522	1124536	AGCCGC	14	-	2	GCGGCT
gi|514486271|gb|KE346361.1|	1125401	1125413	AACACC	12	-	2	TTGGTG
gi|514486271|gb|KE346361.1|	1125488	1125502	AAC	14	-	4	GTT
gi|514486271|gb|KE346361.1|	1125709	1125721	AACAGC	12	-	2	TTGCTG
gi|514486271|gb|KE346361.1|	1125956	1125968	ACACGC	12	-	2	GTGTGC
gi|514486271|gb|KE346361.1|	1126430	1126442	AGC	12	-	4	CTG
gi|514486271|gb|KE346361.1|	1126802	1126814	ACG	12	+	4	GAC
gi|514486271|gb|KE346361.1|	1127272	1127292	ACG	20	+	6	CGA
gi|514486271|gb|KE346361.1|	1127401	1127413	ATGGCC	12	+	2	CATGGC
gi|514486271|gb|KE346361.1|	1127435	1127449	CCG	14	-	4	GCG
gi|514486271|gb|KE346361.1|	1127584	1127604	CCG	20	+	6	GCC
gi|514486271|gb|KE346361.1|	1127697	1127711	AGC	14	+	4	CAG
gi|514486271|gb|KE346361.1|	1127726	1127738	ACTGCT	12	-	2	GCAGTA
gi|514486271|gb|KE346361.1|	1127831	1127845	ACCATC	14	-	2	TGATGG
gi|514486271|gb|KE346361.1|	1127969	1127981	ACCTCC	12	+	2	CCACCT
gi|514486271|gb|KE346361.1|	1128000	1128012	AACGAT	12	+	2	AACGAT
gi|514486271|gb|KE346361.1|	1128015	1128029	AAAAG	14	+	2	AGAAA
gi|514486271|gb|KE346361.1|	1128054	1128067	AAACG	13	+	2	AACGA
gi|514486271|gb|KE346361.1|	1128443	1128457	ACCTGC	14	-	2	GGTGCA
gi|514486271|gb|KE346361.1|	1129197	1129209	ACTGCG	12	+	2	CTGCGA
gi|514486271|gb|KE346361.1|	1131229	1131242	ACGACT	13	-	2	GTAGTC
gi|514486271|gb|KE346361.1|	1131392	1131408	ACG	16	+	5	GAC
gi|514486271|gb|KE346361.1|	1132237	1132272	AGC	35	+	11	AGC
gi|514486271|gb|KE346361.1|	1133309	1133321	ACGAGG	12	+	2	GACGAG
gi|514486271|gb|KE346361.1|	1133456	1133468	ACCCAG	12	+	2	CCAGAC
gi|514486271|gb|KE346361.1|	1134061	1134073	ACCC	12	-	3	GTGG
gi|514486271|gb|KE346361.1|	1136623	1136635	AAGCC	12	-	2	GGCTT
gi|514486271|gb|KE346361.1|	1137021	1137040	ATC	19	+	6	CAT
gi|514486271|gb|KE346361.1|	1137041	1137053	AACGAC	12	-	2	TCGTTG
gi|514486271|gb|KE346361.1|	1137630	1137642	AGCGGC	12	-	2	CGCTGC
gi|514486271|gb|KE346361.1|	1137670	1137682	AAGAG	12	+	2	GAAGA
gi|514486271|gb|KE346361.1|	1138189	1138206	ACACAG	17	-	2	CTGTGT
gi|514486271|gb|KE346361.1|	1138226	1138243	AAC	17	-	5	TGT
gi|514486271|gb|KE346361.1|	1138241	1138258	AGC	17	-	5	TGC
gi|514486271|gb|KE346361.1|	1138523	1138535	ACATGG	12	-	2	ATGTCC
gi|514486271|gb|KE346361.1|	1140873	1140886	AGC	13	-	4	CTG
gi|514486271|gb|KE346361.1|	1144334	1144346	AACTGC	12	-	2	GTTGCA
gi|514486271|gb|KE346361.1|	1145071	1145083	AACAGC	12	-	2	TTGCTG
gi|514486271|gb|KE346361.1|	1145395	1145413	AGC	18	+	6	GCA
gi|514486271|gb|KE346361.1|	1145514	1145526	ACACAT	12	+	2	TACACA
gi|514486271|gb|KE346361.1|	1145596	1145608	AGATG	12	-	2	CATCT
gi|514486271|gb|KE346361.1|	1145758	1145771	AGCGCC	13	-	2	GCTGGC
gi|514486271|gb|KE346361.1|	1145819	1145842	AGC	23	+	7	GCA
gi|514486271|gb|KE346361.1|	1146942	1146956	AAAACG	14	-	2	TCGTTT
gi|514486271|gb|KE346361.1|	1147511	1147525	A	14	+	14	A
gi|514486271|gb|KE346361.1|	1147726	1147739	AAAAAC	13	-	2	TTGTTT
gi|514486271|gb|KE346361.1|	1148333	1148354	AAACC	21	-	4	TTGGT
gi|514486271|gb|KE346361.1|	1148680	1148698	AAAAAC	18	-	3	TGTTTT
gi|514486271|gb|KE346361.1|	1148699	1148711	A	12	-	12	T
gi|514486271|gb|KE346361.1|	1150863	1150877	AAAC	14	-	3	GTTT
gi|514486271|gb|KE346361.1|	1150878	1150893	AAAC	15	-	3	TGTT
gi|514486271|gb|KE346361.1|	1152615	1152628	AATGCC	13	+	2	TGCCAA
gi|514486271|gb|KE346361.1|	1152683	1152695	ACCCCC	12	-	2	GGGGGT
gi|514486271|gb|KE346361.1|	1152727	1152740	AAGCAC	13	-	2	TTGTGC
gi|514486271|gb|KE346361.1|	1153686	1153698	AAGTCG	12	-	2	CTTCGA
gi|514486271|gb|KE346361.1|	1153751	1153765	AGCCGC	14	-	2	GCGGCT
gi|514486271|gb|KE346361.1|	1153793	1153806	ACGGCG	13	+	2	GGCGAC
gi|514486271|gb|KE346361.1|	1153949	1153961	AACGAG	12	+	2	AACGAG
gi|514486271|gb|KE346361.1|	1154576	1154589	ACTCCC	13	-	2	GGAGTG
gi|514486271|gb|KE346361.1|	1156892	1156904	AACAGC	12	-	2	CTGTTG
gi|514486271|gb|KE346361.1|	1157147	1157160	AGC	13	-	4	GCT
gi|514486271|gb|KE346361.1|	1157170	1157182	AAC	12	-	4	TGT
gi|514486271|gb|KE346361.1|	1157432	1157444	AAACTG	12	+	2	TGAAAC
gi|514486271|gb|KE346361.1|	1158166	1158187	AGC	21	-	7	TGC
gi|514486271|gb|KE346361.1|	1158193	1158205	AGC	12	-	4	TGC
gi|514486271|gb|KE346361.1|	1159477	1159493	AAC	16	-	5	TGT
gi|514486271|gb|KE346361.1|	1159646	1159665	A	19	-	19	T
gi|514486271|gb|KE346361.1|	1159663	1159680	AAC	17	-	5	TTG
gi|514486271|gb|KE346361.1|	1160328	1160340	AGATCG	12	-	2	TCTCGA
gi|514486271|gb|KE346361.1|	1160777	1160792	A	15	-	15	T
gi|514486271|gb|KE346361.1|	1162673	1162685	AAGGCC	12	-	2	TGGCCT
gi|514486271|gb|KE346361.1|	1162839	1162851	AAAGAG	12	+	2	AAGAGA
gi|514486271|gb|KE346361.1|	1162846	1162863	AG	17	+	8	AG
gi|514486271|gb|KE346361.1|	1162863	1162875	AACCCT	12	-	2	AGGGTT
gi|514486271|gb|KE346361.1|	1163087	1163101	AGC	14	+	4	GCA
gi|514486271|gb|KE346361.1|	1163171	1163184	ACGGCG	13	+	2	GCGACG
gi|514486271|gb|KE346361.1|	1163240	1163254	AC	14	+	7	AC
gi|514486271|gb|KE346361.1|	1163472	1163485	ACAGAG	13	+	2	AGAGAC
gi|514486271|gb|KE346361.1|	1163620	1163632	AAAG	12	+	3	AAAG
gi|514486271|gb|KE346361.1|	1163683	1163701	AC	18	-	9	TG
gi|514486271|gb|KE346361.1|	1164683	1164712	ATCC	29	-	7	GGAT
gi|514486271|gb|KE346361.1|	1164964	1164976	ATC	12	-	4	GAT
gi|514486271|gb|KE346361.1|	1165424	1165447	AGC	23	+	7	CAG
gi|514486271|gb|KE346361.1|	1165508	1165520	AGCGGC	12	-	2	CGCTGC
gi|514486271|gb|KE346361.1|	1166135	1166148	A	13	-	13	T
gi|514486271|gb|KE346361.1|	1166304	1166316	ACGCCG	12	+	2	GACGCC
gi|514486271|gb|KE346361.1|	1166466	1166481	AAC	15	+	5	ACA
gi|514486271|gb|KE346361.1|	1166479	1166495	AGC	16	+	5	CAG
gi|514486271|gb|KE346361.1|	1168390	1168405	A	15	-	15	T
gi|514486271|gb|KE346361.1|	1168717	1168731	A	14	-	14	T
gi|514486271|gb|KE346361.1|	1169401	1169414	AGCATG	13	-	2	GCTCAT
gi|514486271|gb|KE346361.1|	1169817	1169829	AACGAC	12	-	2	TGTCGT
gi|514486271|gb|KE346361.1|	1170233	1170249	AAAAAT	16	-	2	TTTTTA
gi|514486271|gb|KE346361.1|	1170598	1170610	AAGCAC	12	-	2	TGTGCT
gi|514486271|gb|KE346361.1|	1170731	1170744	ACC	13	+	4	CCA
gi|514486271|gb|KE346361.1|	1170782	1170794	AAGAGC	12	+	2	GCAAGA
gi|514486271|gb|KE346361.1|	1170930	1170954	AGC	24	+	8	CAG
gi|514486271|gb|KE346361.1|	1171129	1171141	AGCTCG	12	+	2	AGCTCG
gi|514486271|gb|KE346361.1|	1171141	1171155	AATCAG	14	-	2	TCTGAT
gi|514486271|gb|KE346361.1|	1171150	1171164	AATCCG	14	-	2	GATTCG
gi|514486271|gb|KE346361.1|	1171824	1171838	AAAAAC	14	-	2	TTTGTT
gi|514486271|gb|KE346361.1|	1171834	1171846	AAAAAC	12	-	2	TTTTGT
gi|514486271|gb|KE346361.1|	1172042	1172054	AATGTG	12	-	2	CACATT
gi|514486271|gb|KE346361.1|	1172120	1172139	A	19	-	19	T
gi|514486271|gb|KE346361.1|	1172200	1172212	ACGCCG	12	+	2	CGACGC
gi|514486271|gb|KE346361.1|	1172226	1172242	ATC	16	+	5	CAT
gi|514486271|gb|KE346361.1|	1172237	1172257	ACGATG	20	-	3	TCATCG
gi|514486271|gb|KE346361.1|	1172487	1172499	AGC	12	+	4	GCA
gi|514486271|gb|KE346361.1|	1172494	1172508	AACAGC	14	+	2	CAGCAA
gi|514486271|gb|KE346361.1|	1172503	1172516	AAC	13	+	4	CAA
gi|514486271|gb|KE346361.1|	1172700	1172722	AGC	22	-	7	CTG
gi|514486271|gb|KE346361.1|	1172874	1172886	ACGAGG	12	+	2	AGGACG
gi|514486271|gb|KE346361.1|	1173960	1173973	ACATCC	13	+	2	CATCCA
gi|514486271|gb|KE346361.1|	1175556	1175570	AAAAAC	14	-	2	TTTTTG
gi|514486271|gb|KE346361.1|	1175666	1175679	ACTGCC	13	+	2	CCACTG
gi|514486271|gb|KE346361.1|	1175700	1175712	AATGG	12	-	2	TTCCA
gi|514486271|gb|KE346361.1|	1175743	1175769	A	26	-	26	T
gi|514486271|gb|KE346361.1|	1175786	1175800	A	14	-	14	T
gi|514486271|gb|KE346361.1|	1175810	1175824	A	14	-	14	T
gi|514486271|gb|KE346361.1|	1175992	1176036	A	44	-	44	T
gi|514486271|gb|KE346361.1|	1176101	1176115	AGC	14	+	4	GCA
gi|514486271|gb|KE346361.1|	1176149	1176161	ACTGC	12	+	2	ACTGC
gi|514486271|gb|KE346361.1|	1176201	1176216	AGCAGG	15	+	2	AGCAGG
gi|514486271|gb|KE346361.1|	1176256	1176273	AGCAGG	17	+	2	AGCAGG
gi|514486271|gb|KE346361.1|	1176357	1176369	AGC	12	+	4	GCA
gi|514486271|gb|KE346361.1|	1176476	1176488	AGC	12	+	4	CAG
gi|514486271|gb|KE346361.1|	1176542	1176554	AGCCGC	12	-	2	GCTGCG
gi|514486271|gb|KE346361.1|	1176596	1176609	ACAGCC	13	+	2	ACAGCC
gi|514486271|gb|KE346361.1|	1176699	1176720	ACG	21	-	7	CGT
gi|514486271|gb|KE346361.1|	1176949	1176961	AGG	12	-	4	TCC
gi|514486271|gb|KE346361.1|	1177066	1177080	AGCTGC	14	+	2	GCAGCT
gi|514486271|gb|KE346361.1|	1177469	1177482	ACCAGC	13	+	2	AGCACC
gi|514486271|gb|KE346361.1|	1178012	1178025	AGC	13	+	4	CAG
gi|514486271|gb|KE346361.1|	1179678	1179693	ACGAGG	15	+	2	ACGAGG
gi|514486271|gb|KE346361.1|	1180314	1180331	ACCGCC	17	+	2	CCGCCA
gi|514486271|gb|KE346361.1|	1180326	1180346	CCG	20	+	6	CCG
gi|514486271|gb|KE346361.1|	1181132	1181144	AAAAAC	12	-	2	TTTTTG
gi|514486271|gb|KE346361.1|	1181253	1181269	A	16	+	16	A
gi|514486271|gb|KE346361.1|	1181432	1181445	ACAG	13	+	3	ACAG
gi|514486271|gb|KE346361.1|	1181465	1181478	AGG	13	-	4	CTC
gi|514486271|gb|KE346361.1|	1181658	1181689	AAGCAG	31	-	5	TCTGCT
gi|514486271|gb|KE346361.1|	1181735	1181751	AAGAGC	16	-	2	CTCTTG
gi|514486271|gb|KE346361.1|	1182077	1182092	AAAC	15	+	3	AAAC
gi|514486271|gb|KE346361.1|	1182091	1182103	AAACC	12	+	2	AAACC
gi|514486271|gb|KE346361.1|	1182161	1182173	AGCG	12	-	3	GCTC
gi|514486271|gb|KE346361.1|	1182631	1182643	ACCGCG	12	+	2	ACCGCG
gi|514486271|gb|KE346361.1|	1183717	1183729	AAGAGC	12	+	2	GCAAGA
gi|514486271|gb|KE346361.1|	1183881	1183893	AAAACC	12	+	2	ACCAAA
gi|514486271|gb|KE346361.1|	1183918	1183930	AAAAG	12	-	2	TTTCT
gi|514486271|gb|KE346361.1|	1183953	1183990	A	37	-	37	T
gi|514486271|gb|KE346361.1|	1184083	1184106	ACAG	23	-	5	TCTG
gi|514486271|gb|KE346361.1|	1184139	1184154	AGCCGC	15	+	2	CAGCCG
gi|514486271|gb|KE346361.1|	1184295	1184311	AGC	16	-	5	CTG
gi|514486271|gb|KE346361.1|	1184339	1184357	AGCTCG	18	+	3	TCGAGC
gi|514486271|gb|KE346361.1|	1184512	1184529	ATC	17	-	5	GAT
gi|514486271|gb|KE346361.1|	1184619	1184633	AG	14	+	7	AG
gi|514486271|gb|KE346361.1|	1184931	1184945	AGC	14	+	4	CAG
gi|514486271|gb|KE346361.1|	1184961	1184973	ACTCGG	12	-	2	CGAGTC
gi|514486271|gb|KE346361.1|	1185426	1185440	ACC	14	+	4	CAC
gi|514486271|gb|KE346361.1|	1185586	1185598	AACGCC	12	+	2	AACGCC
gi|514486271|gb|KE346361.1|	1186956	1186970	A	14	-	14	T
gi|514486271|gb|KE346361.1|	1187357	1187370	ACCGCC	13	+	2	CCACCG
gi|514486271|gb|KE346361.1|	1187517	1187533	ACATG	16	+	3	GACAT
gi|514486271|gb|KE346361.1|	1187813	1187825	AAC	12	+	4	CAA
gi|514486271|gb|KE346361.1|	1187841	1187854	AACC	13	+	3	CCAA
gi|514486271|gb|KE346361.1|	1188121	1188134	ACCAT	13	+	2	ATACC
gi|514486271|gb|KE346361.1|	1188500	1188512	ACGTCG	12	+	2	TCGACG
gi|514486271|gb|KE346361.1|	1188628	1188641	AATGAG	13	+	2	GAGAAT
gi|514486271|gb|KE346361.1|	1188863	1188879	AAAC	16	+	4	AAAC
gi|514486271|gb|KE346361.1|	1190003	1190033	AGC	30	-	10	CTG
gi|514486271|gb|KE346361.1|	1191766	1191781	AAAAAC	15	-	2	TTTTTG
gi|514486271|gb|KE346361.1|	1191902	1191940	A	38	-	38	T
gi|514486271|gb|KE346361.1|	1192001	1192015	AC	14	-	7	TG
gi|514486271|gb|KE346361.1|	1192249	1192278	A	29	+	29	A
gi|514486271|gb|KE346361.1|	1192294	1192324	A	30	-	30	T
gi|514486271|gb|KE346361.1|	1192445	1192458	ACTCTC	13	-	2	GTGAGA
gi|514486271|gb|KE346361.1|	1192611	1192634	AGAGGG	23	+	3	GGGAGA
gi|514486271|gb|KE346361.1|	1192672	1192696	A	24	+	24	A
gi|514486271|gb|KE346361.1|	1192885	1192899	AAAGG	14	-	2	CCTTT
gi|514486271|gb|KE346361.1|	1193408	1193437	A	29	+	29	A
gi|514486271|gb|KE346361.1|	1193459	1193477	AAAAT	18	+	3	AAAAT
gi|514486271|gb|KE346361.1|	1193546	1193559	AG	13	+	6	AG
gi|514486271|gb|KE346361.1|	1193967	1193980	AGC	13	-	4	CTG
gi|514486271|gb|KE346361.1|	1194345	1194359	ATC	14	+	4	ATC
gi|514486271|gb|KE346361.1|	1194590	1194602	AACCGG	12	+	2	AACCGG
gi|514486271|gb|KE346361.1|	1194661	1194673	AG	12	-	6	CT
gi|514486271|gb|KE346361.1|	1194820	1194834	A	14	-	14	T
gi|514486271|gb|KE346361.1|	1194922	1194937	ACGGCG	15	+	2	ACGGCG
gi|514486271|gb|KE346361.1|	1194988	1195000	AGGCGC	12	+	2	GGCGCA
gi|514486271|gb|KE346361.1|	1196095	1196108	AAGCCC	13	+	2	CCCAAG
gi|514486271|gb|KE346361.1|	1196303	1196315	ATCGCC	12	+	2	TCGCCA
gi|514486271|gb|KE346361.1|	1196494	1196518	A	24	-	24	T
gi|514486271|gb|KE346361.1|	1197175	1197187	ACCGCG	12	+	2	ACCGCG
gi|514486271|gb|KE346361.1|	1197468	1197482	A	14	-	14	T
gi|514486271|gb|KE346361.1|	1197715	1197727	AGGG	12	-	3	TCCC
gi|514486271|gb|KE346361.1|	1198024	1198053	A	29	+	29	A
gi|514486271|gb|KE346361.1|	1198252	1198287	A	35	+	35	A
gi|514486271|gb|KE346361.1|	1198305	1198318	A	13	+	13	A
gi|514486271|gb|KE346361.1|	1198433	1198445	A	12	-	12	T
gi|514486271|gb|KE346361.1|	1198612	1198632	AAAAC	20	+	4	CAAAA
gi|514486271|gb|KE346361.1|	1198628	1198640	A	12	+	12	A
gi|514486271|gb|KE346361.1|	1198664	1198682	A	18	-	18	T
gi|514486271|gb|KE346361.1|	1198785	1198797	AATGGC	12	-	2	CATTGC
gi|514486271|gb|KE346361.1|	1198886	1198907	AGGATG	21	-	3	TCCTCA
gi|514486271|gb|KE346361.1|	1198909	1198923	ATC	14	+	4	TCA
gi|514486271|gb|KE346361.1|	1199542	1199559	A	17	-	17	T
gi|514486271|gb|KE346361.1|	1200784	1200796	AAAAAC	12	-	2	GTTTTT
gi|514486271|gb|KE346361.1|	1201001	1201017	A	16	-	16	T
gi|514486271|gb|KE346361.1|	1201027	1201047	A	20	-	20	T
gi|514486271|gb|KE346361.1|	1201234	1201246	AATTC	12	+	2	TTCAA
gi|514486271|gb|KE346361.1|	1201266	1201286	A	20	-	20	T
gi|514486271|gb|KE346361.1|	1201463	1201484	A	21	-	21	T
gi|514486271|gb|KE346361.1|	1201502	1201523	A	21	-	21	T
gi|514486271|gb|KE346361.1|	1201704	1201720	A	16	-	16	T
gi|514486271|gb|KE346361.1|	1201746	1201771	A	25	-	25	T
gi|514486271|gb|KE346361.1|	1201914	1201927	AAGGG	13	-	2	TTCCC
gi|514486271|gb|KE346361.1|	1201926	1201949	ACGG	23	-	5	CGTC
gi|514486271|gb|KE346361.1|	1202210	1202222	ACGGGC	12	+	2	GGCACG
gi|514486271|gb|KE346361.1|	1202289	1202301	ACCTCG	12	-	2	AGGTCG
gi|514486271|gb|KE346361.1|	1202387	1202401	ACG	14	-	4	TCG
gi|514486271|gb|KE346361.1|	1202875	1202887	C	12	+	12	C
gi|514486271|gb|KE346361.1|	1203186	1203198	AGCT	12	+	3	AGCT
gi|514486271|gb|KE346361.1|	1203720	1203741	AG	21	-	10	TC
gi|514486271|gb|KE346361.1|	1203990	1204006	AAC	16	-	5	GTT
gi|514486271|gb|KE346361.1|	1204061	1204073	AAGGGG	12	-	2	TTCCCC
gi|514486271|gb|KE346361.1|	1204240	1204261	AGCTCC	21	+	3	CCAGCT
gi|514486271|gb|KE346361.1|	1204435	1204449	ACAGGC	14	+	2	GCACAG
gi|514486271|gb|KE346361.1|	1204483	1204495	ACG	12	+	4	GAC
gi|514486271|gb|KE346361.1|	1204519	1204533	CCG	14	+	4	GCC
gi|514486271|gb|KE346361.1|	1204542	1204563	AGC	21	-	7	TGC
gi|514486271|gb|KE346361.1|	1204582	1204600	AGGATC	18	+	3	GGATCA
gi|514486271|gb|KE346361.1|	1204943	1204956	AGGGCG	13	+	2	GCGAGG
gi|514486271|gb|KE346361.1|	1205914	1205935	ACG	21	-	7	TCG
gi|514486271|gb|KE346361.1|	1210238	1210251	AAACG	13	+	2	AACGA
gi|514486271|gb|KE346361.1|	1212263	1212275	AGCGCG	12	+	2	GCGCGA
gi|514486271|gb|KE346361.1|	1212275	1212289	AACCCC	14	-	2	TGGGGT
gi|514486271|gb|KE346361.1|	1212593	1212605	ACGAG	12	+	2	GAGAC
gi|514486271|gb|KE346361.1|	1212909	1212928	AAAAG	19	+	3	AAAAG
gi|514486271|gb|KE346361.1|	1213780	1213793	AAC	13	+	4	CAA
gi|514486271|gb|KE346361.1|	1214257	1214269	AACGAC	12	+	2	ACAACG
gi|514486271|gb|KE346361.1|	1215305	1215318	AAAAT	13	+	2	AAAAT
gi|514486271|gb|KE346361.1|	1215686	1215698	AGCGCC	12	-	2	GCTGGC
gi|514486271|gb|KE346361.1|	1216381	1216394	AACATC	13	+	2	ATCAAC
gi|514486271|gb|KE346361.1|	1216396	1216408	ACACG	12	+	2	ACGAC
gi|514486271|gb|KE346361.1|	1216596	1216608	AGGCCG	12	-	2	GGCCTC
gi|514486271|gb|KE346361.1|	1216625	1216638	AACGAC	13	-	2	CGTTGT
gi|514486271|gb|KE346361.1|	1217002	1217015	ACAGCG	13	-	2	TCGCTG
gi|514486271|gb|KE346361.1|	1217546	1217560	AGAGG	14	+	2	GAGGA
gi|514486271|gb|KE346361.1|	1217697	1217709	AC	12	-	6	GT
gi|514486271|gb|KE346361.1|	1217866	1217880	ACTG	14	-	3	TCAG
gi|514486271|gb|KE346361.1|	1218059	1218071	ACC	12	-	4	TGG
gi|514486271|gb|KE346361.1|	1218107	1218119	ACG	12	+	4	CGA
gi|514486271|gb|KE346361.1|	1218120	1218135	ACGGCC	15	+	2	CACGGC
gi|514486271|gb|KE346361.1|	1218162	1218174	ACGGCG	12	+	2	GACGGC
gi|514486271|gb|KE346361.1|	1218226	1218248	AAAAGC	22	+	3	AGCAAA
gi|514486271|gb|KE346361.1|	1218272	1218296	A	24	-	24	T
gi|514486271|gb|KE346361.1|	1219349	1219361	AGCCCC	12	-	2	GCTGGG
gi|514486271|gb|KE346361.1|	1220906	1220925	ACTCGG	19	-	3	GTCCGA
gi|514486271|gb|KE346361.1|	1221078	1221094	ACGCGG	16	+	2	GACGCG
gi|514486271|gb|KE346361.1|	1221245	1221257	ACGAGG	12	+	2	CGAGGA
gi|514486271|gb|KE346361.1|	1221561	1221588	AGC	27	+	9	AGC
gi|514486271|gb|KE346361.1|	1222073	1222087	AAGACG	14	+	2	AGACGA
gi|514486271|gb|KE346361.1|	1223074	1223086	AAGAGG	12	+	2	GGAAGA
gi|514486271|gb|KE346361.1|	1223252	1223315	AGC	63	+	21	AGC
gi|514486271|gb|KE346361.1|	1223616	1223636	AAC	20	-	6	TTG
gi|514486271|gb|KE346361.1|	1223716	1223743	A	27	-	27	T
gi|514486271|gb|KE346361.1|	1223854	1223867	AGC	13	+	4	AGC
gi|514486271|gb|KE346361.1|	1223969	1223981	ACGGCG	12	-	2	GTCGCC
gi|514486271|gb|KE346361.1|	1224160	1224174	AGCATC	14	-	2	TGATGC
gi|514486271|gb|KE346361.1|	1225391	1225403	AGCCCC	12	-	2	GCTGGG
gi|514486271|gb|KE346361.1|	1226716	1226729	AAC	13	+	4	CAA
gi|514486271|gb|KE346361.1|	1226738	1226752	AAC	14	+	4	ACA
gi|514486271|gb|KE346361.1|	1226753	1226772	AAC	19	+	6	ACA
gi|514486271|gb|KE346361.1|	1227811	1227823	AAAGGC	12	+	2	AAAGGC
gi|514486271|gb|KE346361.1|	1228158	1228170	AAAC	12	+	3	AAAC
gi|514486271|gb|KE346361.1|	1228294	1228312	AAC	18	+	6	ACA
gi|514486271|gb|KE346361.1|	1228675	1228688	ACAG	13	-	3	CTGT
gi|514486271|gb|KE346361.1|	1228826	1228842	AAAC	16	+	4	AACA
gi|514486271|gb|KE346361.1|	1228998	1229011	AAGCCG	13	-	2	TTCGGC
gi|514486271|gb|KE346361.1|	1229488	1229503	AACG	15	+	3	CGAA
gi|514486271|gb|KE346361.1|	1229700	1229714	AAATG	14	-	2	TTTCA
gi|514486271|gb|KE346361.1|	1229780	1229799	AATG	19	+	4	TGAA
gi|514486271|gb|KE346361.1|	1229800	1229819	AATG	19	+	4	TGAA
gi|514486271|gb|KE346361.1|	1229906	1229930	AG	24	-	12	CT
gi|514486271|gb|KE346361.1|	1230229	1230248	ACG	19	+	6	CGA
gi|514486271|gb|KE346361.1|	1230979	1230991	AATGTG	12	-	2	ACATTC
gi|514486271|gb|KE346361.1|	1234209	1234221	A	12	-	12	T
gi|514486271|gb|KE346361.1|	1234265	1234277	AAAC	12	-	3	GTTT
gi|514486271|gb|KE346361.1|	1234520	1234536	AAGC	16	-	4	TTGC
gi|514486271|gb|KE346361.1|	1235462	1235478	ACTCTG	16	-	2	GAGTCA
gi|514486271|gb|KE346361.1|	1236221	1236233	AATGCG	12	+	2	ATGCGA
gi|514486271|gb|KE346361.1|	1236796	1236814	AC	18	+	9	AC
gi|514486271|gb|KE346361.1|	1237336	1237348	AAC	12	+	4	CAA
gi|514486271|gb|KE346361.1|	1237355	1237367	AAG	12	+	4	AAG
gi|514486271|gb|KE346361.1|	1238206	1238218	AAACTC	12	-	2	GAGTTT
gi|514486271|gb|KE346361.1|	1238731	1238746	ACGATG	15	-	2	GTCATC
gi|514486271|gb|KE346361.1|	1239056	1239069	AAGTC	13	-	2	TTGAC
gi|514486271|gb|KE346361.1|	1239263	1239281	ACTG	18	-	4	CAGT
gi|514486271|gb|KE346361.1|	1239281	1239305	ACTG	24	-	6	AGTC
gi|514486271|gb|KE346361.1|	1239527	1239543	AACAAT	16	+	2	TAACAA
gi|514486271|gb|KE346361.1|	1239542	1239556	AGCTC	14	-	2	CTGAG
gi|514486271|gb|KE346361.1|	1240697	1240716	ACC	19	-	6	GGT
gi|514486271|gb|KE346361.1|	1240736	1240750	AATGTG	14	+	2	TGAATG
gi|514486271|gb|KE346361.1|	1240745	1240757	ACATGC	12	-	2	ATGTGC
gi|514486271|gb|KE346361.1|	1241065	1241086	ACG	21	-	7	CGT
gi|514486271|gb|KE346361.1|	1241426	1241439	ACTC	13	-	3	AGTG
gi|514486271|gb|KE346361.1|	1241651	1241663	AAAAC	12	-	2	TTTTG
gi|514486271|gb|KE346361.1|	1241952	1241967	A	15	-	15	T
gi|514486271|gb|KE346361.1|	1242260	1242272	AAGGAG	12	+	2	GAAGGA
gi|514486271|gb|KE346361.1|	1242270	1242285	AACG	15	+	3	GAAC
gi|514486271|gb|KE346361.1|	1243097	1243111	A	14	+	14	A
gi|514486271|gb|KE346361.1|	1244588	1244601	A	13	+	13	A
gi|514486271|gb|KE346361.1|	1244800	1244815	AAAC	15	+	3	AAAC
gi|514486271|gb|KE346361.1|	1245512	1245528	A	16	+	16	A
gi|514486271|gb|KE346361.1|	1245539	1245551	ACCGCC	12	+	2	GCCACC
gi|514486271|gb|KE346361.1|	1245588	1245601	AGGCCG	13	-	2	TCGGCC
gi|514486271|gb|KE346361.1|	1245946	1245963	AG	17	+	8	GA
gi|514486271|gb|KE346361.1|	1246026	1246039	AACACC	13	+	2	AACACC
gi|514486271|gb|KE346361.1|	1246677	1246689	ACAGTC	12	-	2	CTGTGA
gi|514486271|gb|KE346361.1|	1246689	1246718	AGC	29	-	9	TGC
gi|514486271|gb|KE346361.1|	1246779	1246791	ACAGC	12	+	2	AGCAC
gi|514486271|gb|KE346361.1|	1247040	1247053	AGATGG	13	-	2	ATCTCC
gi|514486271|gb|KE346361.1|	1248050	1248062	ATGC	12	+	3	TGCA
gi|514486271|gb|KE346361.1|	1248178	1248194	A	16	+	16	A
gi|514486271|gb|KE346361.1|	1249140	1249163	AGC	23	+	7	AGC
gi|514486271|gb|KE346361.1|	1250605	1250641	AC	36	+	18	CA
gi|514486271|gb|KE346361.1|	1250866	1250878	AATGCC	12	-	2	GCATTG
gi|514486271|gb|KE346361.1|	1251280	1251453	AG	173	-	86	TC
gi|514486271|gb|KE346361.1|	1251456	1251486	AG	30	-	15	TC
gi|514486271|gb|KE346361.1|	1251487	1251503	AG	16	-	8	CT
gi|514486271|gb|KE346361.1|	1252001	1252014	A	13	+	13	A
gi|514486271|gb|KE346361.1|	1252084	1252104	ATC	20	-	6	TGA
gi|514486271|gb|KE346361.1|	1252316	1252334	AGCCGC	18	-	3	TGCGGC
gi|514486271|gb|KE346361.1|	1252394	1252414	AAC	20	-	6	TTG
gi|514486271|gb|KE346361.1|	1253449	1253484	A	35	+	35	A
gi|514486271|gb|KE346361.1|	1254118	1254131	AATGCC	13	-	2	ATTGGC
gi|514486271|gb|KE346361.1|	1254230	1254242	AAAAC	12	+	2	AACAA
gi|514486271|gb|KE346361.1|	1254238	1254254	A	16	+	16	A
gi|514486271|gb|KE346361.1|	1255992	1256005	ACTC	13	-	3	AGTG
gi|514486271|gb|KE346361.1|	1256062	1256074	ACGC	12	-	3	TGCG
gi|514486271|gb|KE346361.1|	1256128	1256140	C	12	+	12	C
gi|514486271|gb|KE346361.1|	1256312	1256325	AGC	13	+	4	GCA
gi|514486271|gb|KE346361.1|	1256416	1256428	AGCGGC	12	+	2	GGCAGC
gi|514486271|gb|KE346361.1|	1256545	1256557	AAAAGG	12	+	2	AAGGAA
gi|514486271|gb|KE346361.1|	1257030	1257042	AAAGGC	12	+	2	GGCAAA
gi|514486271|gb|KE346361.1|	1257297	1257310	ATCGGC	13	+	2	ATCGGC
gi|514486271|gb|KE346361.1|	1257427	1257440	AAATCC	13	-	2	GATTTG
gi|514486271|gb|KE346361.1|	1258927	1258939	AAAAC	12	+	2	AACAA
gi|514486271|gb|KE346361.1|	1260047	1260061	A	14	+	14	A
gi|514486271|gb|KE346361.1|	1260543	1260555	AATGTG	12	+	2	TGTGAA
gi|514486271|gb|KE346361.1|	1260755	1260768	AAAGC	13	-	2	TTTGC
gi|514486271|gb|KE346361.1|	1260863	1260878	A	15	-	15	T
gi|514486271|gb|KE346361.1|	1260880	1260895	A	15	-	15	T
gi|514486271|gb|KE346361.1|	1260931	1260943	AAAAAC	12	+	2	AAAAAC
gi|514486271|gb|KE346361.1|	1260985	1260999	AGAGG	14	-	2	CCTCT
gi|514486271|gb|KE346361.1|	1261143	1261158	ACGC	15	+	3	CACG
gi|514486271|gb|KE346361.1|	1261322	1261334	ATC	12	-	4	ATG
gi|514486271|gb|KE346361.1|	1261332	1261344	ACAGCC	12	-	2	TGGCTG
gi|514486271|gb|KE346361.1|	1261902	1261917	A	15	+	15	A
gi|514486271|gb|KE346361.1|	1262045	1262057	ACAGAG	12	+	2	CAGAGA
gi|514486271|gb|KE346361.1|	1265435	1265447	ACGAGG	12	-	2	TCCTCG
gi|514486271|gb|KE346361.1|	1265654	1265666	AGGCCG	12	-	2	GCCTCG
gi|514486271|gb|KE346361.1|	1265677	1265689	AGG	12	-	4	CTC
gi|514486271|gb|KE346361.1|	1265817	1265829	AGCTCC	12	-	2	GCTGGA
gi|514486271|gb|KE346361.1|	1266054	1266068	AAGCTC	14	-	2	TGAGCT
gi|514486271|gb|KE346361.1|	1266132	1266146	ATCCGC	14	-	2	TGCGGA
gi|514486271|gb|KE346361.1|	1267834	1267854	AGAGG	20	+	4	AGAGG
gi|514486271|gb|KE346361.1|	1268013	1268025	AAGTGT	12	+	2	AGTGTA
gi|514486271|gb|KE346361.1|	1268219	1268237	A	18	+	18	A
gi|514486271|gb|KE346361.1|	1268281	1268301	AAAAAT	20	+	3	AATAAA
gi|514486271|gb|KE346361.1|	1268358	1268370	ACCC	12	+	3	CCAC
gi|514486271|gb|KE346361.1|	1268475	1268488	A	13	+	13	A
gi|514486271|gb|KE346361.1|	1268681	1268696	AAAAT	15	+	3	AAAAT
gi|514486271|gb|KE346361.1|	1269246	1269258	AAAACG	12	+	2	AAAACG
gi|514486271|gb|KE346361.1|	1269288	1269303	A	15	-	15	T
gi|514486271|gb|KE346361.1|	1269457	1269469	AAAAAT	12	+	2	AAAATA
gi|514486271|gb|KE346361.1|	1269475	1269488	AAAAAT	13	+	2	AAAAAT
gi|514486271|gb|KE346361.1|	1269500	1269514	A	14	-	14	T
gi|514486271|gb|KE346361.1|	1269653	1269665	AAGGGG	12	+	2	GGAAGG
gi|514486271|gb|KE346361.1|	1270187	1270204	AG	17	-	8	CT
gi|514486271|gb|KE346361.1|	1270205	1270219	AG	14	-	7	CT
gi|514486271|gb|KE346361.1|	1270280	1270292	AAGAG	12	-	2	CTCTT
gi|514486271|gb|KE346361.1|	1270309	1270321	AAAAAG	12	-	2	TTCTTT
gi|514486271|gb|KE346361.1|	1270334	1270348	AAAAAG	14	-	2	CTTTTT
gi|514486271|gb|KE346361.1|	1270527	1270543	AACACC	16	+	2	AACACC
gi|514486271|gb|KE346361.1|	1272142	1272161	AAAAC	19	+	3	CAAAA
gi|514486271|gb|KE346361.1|	1272205	1272219	AAAAC	14	+	2	ACAAA
gi|514486271|gb|KE346361.1|	1272285	1272302	AAAC	17	+	4	ACAA
gi|514486271|gb|KE346361.1|	1273245	1273257	AGCGGC	12	+	2	GCAGCG
gi|514486271|gb|KE346361.1|	1273566	1273586	ACG	20	+	6	GAC
gi|514486271|gb|KE346361.1|	1274668	1274682	ACCGCC	14	+	2	CGCCAC
gi|514486271|gb|KE346361.1|	1274871	1274883	ACTGCG	12	+	2	ACTGCG
gi|514486271|gb|KE346361.1|	1275306	1275318	ACGCCG	12	-	2	TCGGCG
gi|514486271|gb|KE346361.1|	1275615	1275630	ACGAGG	15	+	2	GACGAG
gi|514486271|gb|KE346361.1|	1275713	1275731	ATC	18	-	6	TGA
gi|514486271|gb|KE346361.1|	1275976	1275992	A	16	+	16	A
gi|514486271|gb|KE346361.1|	1276014	1276032	AAC	18	-	6	TTG
gi|514486271|gb|KE346361.1|	1276033	1276047	AAGC	14	-	3	TTGC
gi|514486271|gb|KE346361.1|	1276866	1276878	ATCGC	12	-	2	TGCGA
gi|514486271|gb|KE346361.1|	1277853	1277865	ACGCTC	12	+	2	GCTCAC
gi|514486271|gb|KE346361.1|	1278043	1278067	AAAC	24	+	6	CAAA
gi|514486271|gb|KE346361.1|	1278269	1278281	A	12	+	12	A
gi|514486271|gb|KE346361.1|	1278282	1278296	A	14	+	14	A
gi|514486271|gb|KE346361.1|	1278659	1278673	AGCTCG	14	+	2	GAGCTC
gi|514486271|gb|KE346361.1|	1280321	1280333	AAAAGC	12	+	2	AAGCAA
gi|514486271|gb|KE346361.1|	1281255	1281278	AACAGC	23	-	3	TGTTGC
gi|514486271|gb|KE346361.1|	1281273	1281287	AAC	14	-	4	TGT
gi|514486271|gb|KE346361.1|	1281572	1281584	AATCGG	12	-	2	TTCCGA
gi|514486271|gb|KE346361.1|	1281866	1281878	AACCGC	12	-	2	TGCGGT
gi|514486271|gb|KE346361.1|	1282708	1282725	AGC	17	+	5	CAG
gi|514486271|gb|KE346361.1|	1282849	1282868	AGC	19	+	6	CAG
gi|514486271|gb|KE346361.1|	1282884	1282897	ACTGCG	13	-	2	GTCGCA
gi|514486271|gb|KE346361.1|	1282941	1282957	ACTGGC	16	-	2	CCAGTG
gi|514486271|gb|KE346361.1|	1282956	1282976	CCG	20	+	6	GCC
gi|514486271|gb|KE346361.1|	1283056	1283069	AATGCG	13	-	2	TCGCAT
gi|514486271|gb|KE346361.1|	1283082	1283096	AAC	14	-	4	GTT
gi|514486271|gb|KE346361.1|	1283127	1283143	CCG	16	+	5	GCC
gi|514486271|gb|KE346361.1|	1283284	1283303	AGCAGG	19	-	3	CTGCTC
gi|514486271|gb|KE346361.1|	1283621	1283633	A	12	+	12	A
gi|514486271|gb|KE346361.1|	1283835	1283848	AGCAGG	13	+	2	CAGGAG
gi|514486271|gb|KE346361.1|	1285200	1285212	ACTGG	12	-	2	CAGTC
gi|514486271|gb|KE346361.1|	1285312	1285325	ACGATG	13	-	2	CGTCAT
gi|514486271|gb|KE346361.1|	1285618	1285632	AAAC	14	+	3	AAAC
gi|514486271|gb|KE346361.1|	1286089	1286105	AC	16	+	8	CA
gi|514486271|gb|KE346361.1|	1286109	1286121	AC	12	+	6	CA
gi|514486271|gb|KE346361.1|	1286507	1286519	AAAAAC	12	+	2	AAAAAC
gi|514486271|gb|KE346361.1|	1286746	1286759	AAGGTC	13	-	2	GACCTT
gi|514486271|gb|KE346361.1|	1287232	1287246	AAAAG	14	+	2	AAAAG
gi|514486271|gb|KE346361.1|	1287597	1287611	AGCGCC	14	+	2	CGCCAG
gi|514486271|gb|KE346361.1|	1288200	1288218	A	18	-	18	T
gi|514486271|gb|KE346361.1|	1288214	1288226	AAAACC	12	-	2	TTTTGG
gi|514486271|gb|KE346361.1|	1288428	1288448	ACAG	20	-	5	CTGT
gi|514486271|gb|KE346361.1|	1288462	1288474	ACCTCG	12	-	2	GGTCGA
gi|514486271|gb|KE346361.1|	1288899	1288911	AATTGC	12	+	2	ATTGCA
gi|514486271|gb|KE346361.1|	1289298	1289310	A	12	-	12	T
gi|514486271|gb|KE346361.1|	1289764	1289779	A	15	-	15	T
gi|514486271|gb|KE346361.1|	1290090	1290102	AGCGGC	12	+	2	GGCAGC
gi|514486271|gb|KE346361.1|	1290860	1290883	ACT	23	+	7	CTA
gi|514486271|gb|KE346361.1|	1292207	1292219	AGGCGG	12	+	2	AGGCGG
gi|514486271|gb|KE346361.1|	1292483	1292498	AGCGCC	15	+	2	CAGCGC
gi|514486271|gb|KE346361.1|	1292499	1292526	ACG	27	-	9	GTC
gi|514486271|gb|KE346361.1|	1293225	1293293	ACG	68	-	22	GTC
gi|514486271|gb|KE346361.1|	1293337	1293387	ACG	50	-	16	GTC
gi|514486271|gb|KE346361.1|	1293497	1293511	AGCCGC	14	+	2	GCAGCC
gi|514486271|gb|KE346361.1|	1294242	1294255	AAACAC	13	+	2	ACAAAC
gi|514486271|gb|KE346361.1|	1294262	1294275	AACG	13	-	3	TTCG
gi|514486271|gb|KE346361.1|	1294313	1294327	A	14	-	14	T
gi|514486271|gb|KE346361.1|	1294513	1294531	ACCAGT	18	+	3	ACCAGT
gi|514486271|gb|KE346361.1|	1294762	1294774	AACAAG	12	-	2	CTTGTT
gi|514486271|gb|KE346361.1|	1294778	1294790	ACG	12	-	4	TCG
gi|514486271|gb|KE346361.1|	1295010	1295026	AGCCCG	16	+	2	CGAGCC
gi|514486271|gb|KE346361.1|	1295063	1295089	AACAGC	26	-	4	TGCTGT
gi|514486271|gb|KE346361.1|	1295213	1295225	AC	12	+	6	CA
gi|514486271|gb|KE346361.1|	1295425	1295440	AG	15	-	7	TC
gi|514486271|gb|KE346361.1|	1296277	1296289	AAACCC	12	-	2	GTTTGG
gi|514486271|gb|KE346361.1|	1296526	1296538	ACTATC	12	+	2	TATCAC
gi|514486271|gb|KE346361.1|	1297286	1297298	AGC	12	-	4	GCT
gi|514486271|gb|KE346361.1|	1297393	1297416	AAAAC	23	+	4	AAAAC
gi|514486271|gb|KE346361.1|	1298036	1298049	AATAC	13	+	2	ACAAT
gi|514486271|gb|KE346361.1|	1298237	1298251	A	14	+	14	A
gi|514486271|gb|KE346361.1|	1298283	1298301	A	18	+	18	A
gi|514486271|gb|KE346361.1|	1298407	1298424	ATC	17	-	5	GAT
gi|514486271|gb|KE346361.1|	1298563	1298575	AACGC	12	+	2	CGCAA
gi|514486271|gb|KE346361.1|	1299075	1299089	AATGGT	14	+	2	GTAATG
gi|514486271|gb|KE346361.1|	1299141	1299160	AC	19	+	9	CA
gi|514486271|gb|KE346361.1|	1299183	1299195	ATCCGC	12	+	2	GCATCC
gi|514486271|gb|KE346361.1|	1299239	1299252	A	13	-	13	T
gi|514486271|gb|KE346361.1|	1299409	1299429	ATC	20	+	6	CAT
gi|514486271|gb|KE346361.1|	1301039	1301065	A	26	-	26	T
gi|514486271|gb|KE346361.1|	1301209	1301224	AAAC	15	+	3	ACAA
gi|514486271|gb|KE346361.1|	1302400	1302413	AACGAT	13	-	2	TATCGT
gi|514486271|gb|KE346361.1|	1303171	1303183	AAGGC	12	-	2	CTTGC
gi|514486271|gb|KE346361.1|	1303264	1303276	ACCCAG	12	+	2	CCAGAC
gi|514486271|gb|KE346361.1|	1303430	1303444	ACG	14	+	4	GAC
gi|514486271|gb|KE346361.1|	1304466	1304478	AGC	12	-	4	TGC
gi|514486271|gb|KE346361.1|	1304585	1304597	AATCAG	12	-	2	TGATTC
gi|514486271|gb|KE346361.1|	1304906	1304918	AAGCGC	12	-	2	TGCGCT
gi|514486271|gb|KE346361.1|	1306466	1306478	AAGGAC	12	+	2	ACAAGG
gi|514486271|gb|KE346361.1|	1306873	1306885	ACGAGC	12	+	2	ACGAGC
gi|514486271|gb|KE346361.1|	1308047	1308062	AAAC	15	-	3	TTTG
gi|514486271|gb|KE346361.1|	1308211	1308223	AACTC	12	+	2	CAACT
gi|514486271|gb|KE346361.1|	1308289	1308301	AACAAG	12	-	2	TTGTTC
gi|514486271|gb|KE346361.1|	1308360	1308380	A	20	-	20	T
gi|514486271|gb|KE346361.1|	1308481	1308494	A	13	-	13	T
gi|514486271|gb|KE346361.1|	1308521	1308537	ACTC	16	+	4	TCAC
gi|514486271|gb|KE346361.1|	1308694	1308711	ACTC	17	+	4	CACT
gi|514486271|gb|KE346361.1|	1308986	1309000	AAATCC	14	-	2	TGGATT
gi|514486271|gb|KE346361.1|	1309248	1309261	AACAGC	13	+	2	AGCAAC
gi|514486271|gb|KE346361.1|	1309338	1309351	CCG	13	+	4	CCG
gi|514486271|gb|KE346361.1|	1309927	1309942	AAGACC	15	+	2	CAAGAC
gi|514486271|gb|KE346361.1|	1310153	1310167	ACGATG	14	-	2	TCGTCA
gi|514486271|gb|KE346361.1|	1310416	1310428	AGGCCG	12	-	2	GGCCTC
gi|514486271|gb|KE346361.1|	1310907	1310928	AGCGGG	21	-	3	CCCGCT
gi|514486271|gb|KE346361.1|	1311484	1311498	AC	14	+	7	CA
gi|514486271|gb|KE346361.1|	1311496	1311510	ATGC	14	+	3	CATG
gi|514486271|gb|KE346361.1|	1311590	1311602	ACCACG	12	-	2	TCGTGG
gi|514486271|gb|KE346361.1|	1311609	1311621	ACGGCC	12	-	2	CGTGGC
gi|514486271|gb|KE346361.1|	1311626	1311638	ACCACG	12	-	2	TCGTGG
gi|514486271|gb|KE346361.1|	1311891	1311903	CCGG	12	+	3	CGGC
gi|514486271|gb|KE346361.1|	1312622	1312635	ACGAGG	13	+	2	ACGAGG
gi|514486271|gb|KE346361.1|	1313240	1313256	AC	16	-	8	GT
gi|514486271|gb|KE346361.1|	1313756	1313778	ACAG	22	-	5	GTCT
gi|514486271|gb|KE346361.1|	1313779	1313793	ACAG	14	-	3	TGTC
gi|514486271|gb|KE346361.1|	1313795	1313809	AAACG	14	-	2	CGTTT
gi|514486271|gb|KE346361.1|	1314034	1314047	AAAAAC	13	+	2	ACAAAA
gi|514486271|gb|KE346361.1|	1314532	1314544	ACACTC	12	-	2	TGAGTG
gi|514486271|gb|KE346361.1|	1314553	1314566	AAAAC	13	+	2	AACAA
gi|514486271|gb|KE346361.1|	1314593	1314610	AGGGG	17	-	3	CCCCT
gi|514486271|gb|KE346361.1|	1315206	1315218	AAAGGG	12	-	2	TTTCCC
gi|514486271|gb|KE346361.1|	1315384	1315398	ACCATC	14	+	2	CATCAC
gi|514486271|gb|KE346361.1|	1315399	1315413	ACCATC	14	+	2	CATCAC
gi|514486271|gb|KE346361.1|	1315411	1315423	AGCATC	12	+	2	CAGCAT
gi|514486271|gb|KE346361.1|	1315468	1315484	AGC	16	+	5	CAG
gi|514486271|gb|KE346361.1|	1316951	1316963	ACCATG	12	+	2	CCATGA
gi|514486271|gb|KE346361.1|	1317286	1317312	ACCCAG	26	-	4	TCTGGG
gi|514486271|gb|KE346361.1|	1317326	1317340	AGC	14	+	4	AGC
gi|514486271|gb|KE346361.1|	1317376	1317394	AGC	18	-	6	GCT
gi|514486271|gb|KE346361.1|	1317447	1317460	AGCATG	13	+	2	CATGAG
gi|514486271|gb|KE346361.1|	1317834	1317850	AGC	16	+	5	CAG
gi|514486271|gb|KE346361.1|	1318493	1318506	AAGCAC	13	-	2	TTGTGC
gi|514486271|gb|KE346361.1|	1318769	1318782	AATGAC	13	+	2	ATGACA
gi|514486271|gb|KE346361.1|	1319550	1319562	ACATC	12	+	2	CATCA
gi|514486271|gb|KE346361.1|	1320093	1320105	AACCAC	12	+	2	CAACCA
gi|514486271|gb|KE346361.1|	1320218	1320231	ACCGCC	13	-	2	GTGGCG
gi|514486271|gb|KE346361.1|	1320257	1320274	AAAAAC	17	+	2	ACAAAA
gi|514486271|gb|KE346361.1|	1320503	1320516	AAGGGG	13	+	2	GAAGGG
gi|514486271|gb|KE346361.1|	1320689	1320713	A	24	+	24	A
gi|514486271|gb|KE346361.1|	1321717	1321730	AGGCCG	13	-	2	CGGCCT
gi|514486271|gb|KE346361.1|	1323211	1323239	A	28	+	28	A
gi|514486271|gb|KE346361.1|	1323236	1323250	AAAG	14	+	3	AAAG
gi|514486271|gb|KE346361.1|	1323428	1323460	A	32	-	32	T
gi|514486271|gb|KE346361.1|	1323524	1323537	AAAGTC	13	+	2	CAAAGT
gi|514486271|gb|KE346361.1|	1323722	1323737	ACAG	15	+	3	ACAG
gi|514486271|gb|KE346361.1|	1323812	1323826	AAAAT	14	-	2	TTTTA
gi|514486271|gb|KE346361.1|	1323975	1323998	AGCGGC	23	+	3	GCGGCA
gi|514486271|gb|KE346361.1|	1324622	1324634	AAAG	12	-	3	TCTT
gi|514486271|gb|KE346361.1|	1324782	1324813	ATCC	31	+	7	CCAT
gi|514486271|gb|KE346361.1|	1324932	1324944	ACCCGC	12	+	2	CCGCAC
gi|514486271|gb|KE346361.1|	1324941	1324959	AC	18	+	9	CA
gi|514486271|gb|KE346361.1|	1325118	1325131	AC	13	+	6	AC
gi|514486271|gb|KE346361.1|	1325263	1325285	A	22	-	22	T
gi|514486271|gb|KE346361.1|	1326712	1326726	A	14	-	14	T
gi|514486271|gb|KE346361.1|	1327558	1327570	AAGCTC	12	+	2	AAGCTC
gi|514486271|gb|KE346361.1|	1327819	1327834	AAAAC	15	-	3	GTTTT
gi|514486271|gb|KE346361.1|	1328580	1328815	AG	235	+	117	AG
gi|514486271|gb|KE346361.1|	1329805	1329818	AAAAC	13	-	2	TGTTT
gi|514486271|gb|KE346361.1|	1330214	1330228	AG	14	-	7	TC
gi|514486271|gb|KE346361.1|	1330502	1330514	A	12	-	12	T
gi|514486271|gb|KE346361.1|	1330510	1330522	AAAACG	12	-	2	TTTTCG
gi|514486271|gb|KE346361.1|	1332062	1332074	AC	12	-	6	GT
gi|514486271|gb|KE346361.1|	1332119	1332131	AAACAC	12	+	2	AAACAC
gi|514486271|gb|KE346361.1|	1333240	1333253	AAAAAC	13	-	2	TGTTTT
gi|514486271|gb|KE346361.1|	1333768	1333781	AATGAG	13	+	2	GAGAAT
gi|514486271|gb|KE346361.1|	1334754	1334769	ACGGCC	15	+	2	GGCCAC
gi|514486271|gb|KE346361.1|	1334821	1334836	CCG	15	-	5	GCG
gi|514486271|gb|KE346361.1|	1334881	1334894	AGCTC	13	-	2	CTGAG
gi|514486271|gb|KE346361.1|	1334983	1334995	CCGCG	12	+	2	GCCGC
gi|514486271|gb|KE346361.1|	1335160	1335172	AAATC	12	+	2	AAATC
gi|514486271|gb|KE346361.1|	1336174	1336186	AAGAG	12	+	2	AGAAG
gi|514486271|gb|KE346361.1|	1336459	1336473	ACTCG	14	+	2	TCGAC
gi|514486271|gb|KE346361.1|	1336718	1336733	AGCAGG	15	+	2	AGCAGG
gi|514486271|gb|KE346361.1|	1337534	1337555	AGC	21	-	7	CTG
gi|514486271|gb|KE346361.1|	1337981	1337993	AAC	12	+	4	ACA
gi|514486271|gb|KE346361.1|	1337994	1338009	AAC	15	+	5	CAA
gi|514486271|gb|KE346361.1|	1339840	1339852	AATGCG	12	-	2	TCGCAT
gi|514486271|gb|KE346361.1|	1340361	1340373	AACTC	12	+	2	TCAAC
gi|514486271|gb|KE346361.1|	1340416	1340430	ACTCAG	14	-	2	GAGTCT
gi|514486271|gb|KE346361.1|	1340519	1340539	ACCTCG	20	+	3	TCGACC
gi|514486271|gb|KE346361.1|	1340597	1340614	ACC	17	-	5	TGG
gi|514486271|gb|KE346361.1|	1340737	1340752	AAGTCC	15	+	2	CCAAGT
gi|514486271|gb|KE346361.1|	1340918	1340934	ACG	16	-	5	GTC
gi|514486271|gb|KE346361.1|	1341314	1341327	ACGCCG	13	+	2	CGACGC
gi|514486271|gb|KE346361.1|	1341468	1341480	AAGAC	12	-	2	GTCTT
gi|514486271|gb|KE346361.1|	1341508	1341521	ACTC	13	-	3	GTGA
gi|514486271|gb|KE346361.1|	1342074	1342087	AATCC	13	+	2	CCAAT
gi|514486271|gb|KE346361.1|	1342941	1342953	ATCG	12	+	3	CGAT
gi|514486271|gb|KE346361.1|	1344148	1344160	ACGCCG	12	+	2	CGACGC
gi|514486271|gb|KE346361.1|	1344166	1344178	AGCGCC	12	+	2	CGCCAG
gi|514486271|gb|KE346361.1|	1346289	1346302	AAATGC	13	+	2	GCAAAT
gi|514486271|gb|KE346361.1|	1346306	1346321	ACTC	15	-	3	GAGT
gi|514486271|gb|KE346361.1|	1346326	1346343	ACTC	17	-	4	GTGA
gi|514486271|gb|KE346361.1|	1346367	1346383	A	16	-	16	T
gi|514486271|gb|KE346361.1|	1346540	1346553	ATC	13	-	4	GAT
gi|514486271|gb|KE346361.1|	1347192	1347215	AAT	23	-	7	TTA
gi|514486271|gb|KE346361.1|	1347213	1347225	A	12	-	12	T
gi|514486271|gb|KE346361.1|	1347334	1347367	AG	33	-	16	TC
gi|514486271|gb|KE346361.1|	1347447	1347473	ACCTG	26	+	5	CCTGA
gi|514486271|gb|KE346361.1|	1347607	1347619	AGCGGC	12	+	2	GGCAGC
gi|514486271|gb|KE346361.1|	1347850	1347862	ACG	12	-	4	TCG
gi|514486271|gb|KE346361.1|	1348067	1348093	AACAGC	26	+	4	GCAACA
gi|514486271|gb|KE346361.1|	1348229	1348243	CCG	14	-	4	GCG
gi|514486271|gb|KE346361.1|	1348328	1348348	AAC	20	+	6	ACA
gi|514486271|gb|KE346361.1|	1348525	1348548	A	23	-	23	T
gi|514486271|gb|KE346361.1|	1348856	1348872	AAAATC	16	-	2	TTTTGA
gi|514486271|gb|KE346361.1|	1349104	1349116	ACCC	12	+	3	ACCC
gi|514486271|gb|KE346361.1|	1349334	1349346	ACT	12	+	4	ACT
gi|514486271|gb|KE346361.1|	1350246	1350261	A	15	-	15	T
gi|514486271|gb|KE346361.1|	1350262	1350277	A	15	-	15	T
gi|514486271|gb|KE346361.1|	1350748	1350762	A	14	-	14	T
gi|514486271|gb|KE346361.1|	1351414	1351428	AAC	14	-	4	TTG
gi|514486271|gb|KE346361.1|	1351984	1351997	AC	13	-	6	GT
gi|514486271|gb|KE346361.1|	1352026	1352038	A	12	-	12	T
gi|514486271|gb|KE346361.1|	1352450	1352462	AATGTG	12	-	2	TTCACA
gi|514486271|gb|KE346361.1|	1355261	1355290	AAAC	29	+	7	AAAC
gi|514486271|gb|KE346361.1|	1355391	1355418	A	27	+	27	A
gi|514486271|gb|KE346361.1|	1355794	1355820	A	26	-	26	T
gi|514486271|gb|KE346361.1|	1356053	1356066	AAGCCC	13	-	2	GGGCTT
gi|514486271|gb|KE346361.1|	1356367	1356382	ACTC	15	+	3	CTCA
gi|514486271|gb|KE346361.1|	1356435	1356450	A	15	-	15	T
gi|514486271|gb|KE346361.1|	1356677	1356695	ACG	18	-	6	TCG
gi|514486271|gb|KE346361.1|	1356836	1356848	AACTTG	12	-	2	AAGTTC
gi|514486271|gb|KE346361.1|	1357025	1357037	AAACC	12	+	2	CAAAC
gi|514486271|gb|KE346361.1|	1357227	1357434	AG	207	+	103	GA
gi|514486271|gb|KE346361.1|	1359739	1359751	A	12	-	12	T
gi|514486271|gb|KE346361.1|	1359834	1359846	AAGCTG	12	-	2	TCAGCT
gi|514486271|gb|KE346361.1|	1361250	1361266	A	16	-	16	T
gi|514486271|gb|KE346361.1|	1363463	1363475	AAAAAC	12	+	2	CAAAAA
gi|514486271|gb|KE346361.1|	1363474	1363488	AAAAAC	14	+	2	AAAAAC
gi|514486271|gb|KE346361.1|	1364319	1364339	AAC	20	+	6	AAC
gi|514486271|gb|KE346361.1|	1364337	1364352	A	15	+	15	A
gi|514486271|gb|KE346361.1|	1364548	1364560	AAACCC	12	+	2	CAAACC
gi|514486271|gb|KE346361.1|	1364794	1364806	AGGGCC	12	+	2	GCCAGG
gi|514486271|gb|KE346361.1|	1364987	1365001	AAC	14	-	4	TGT
gi|514486271|gb|KE346361.1|	1365494	1365507	AGC	13	+	4	AGC
gi|514486271|gb|KE346361.1|	1365645	1365665	AG	20	+	10	AG
gi|514486271|gb|KE346361.1|	1365899	1365911	AAAGAG	12	+	2	GAAAGA
gi|514486271|gb|KE346361.1|	1365925	1365949	A	24	+	24	A
gi|514486271|gb|KE346361.1|	1365951	1365963	AGC	12	-	4	CTG
gi|514486271|gb|KE346361.1|	1365974	1366004	AG	30	+	15	AG
gi|514486271|gb|KE346361.1|	1366294	1366306	A	12	+	12	A
gi|514486271|gb|KE346361.1|	1366345	1366360	ATCCC	15	-	3	GGATG
gi|514486271|gb|KE346361.1|	1366541	1366553	ACAG	12	+	3	ACAG
gi|514486271|gb|KE346361.1|	1367820	1367832	A	12	+	12	A
gi|514486271|gb|KE346361.1|	1368414	1368440	A	26	+	26	A
gi|514486271|gb|KE346361.1|	1369638	1369651	ACC	13	+	4	CCA
gi|514486271|gb|KE346361.1|	1369771	1369785	AAAAAC	14	+	2	AACAAA
gi|514486271|gb|KE346361.1|	1369816	1369843	AAAAAC	27	+	4	AAAACA
gi|514486271|gb|KE346361.1|	1370155	1370167	AACCAC	12	-	2	TGTGGT
gi|514486271|gb|KE346361.1|	1371693	1371715	AAGGAC	22	+	3	AAGGAC
gi|514486271|gb|KE346361.1|	1371932	1371944	AG	12	-	6	TC
gi|514486271|gb|KE346361.1|	1371996	1372020	AC	24	+	12	AC
gi|514486271|gb|KE346361.1|	1372157	1372171	ACG	14	+	4	GAC
gi|514486271|gb|KE346361.1|	1373185	1373205	A	20	-	20	T
gi|514486271|gb|KE346361.1|	1373200	1373212	AAAAAC	12	-	2	TTTTTG
gi|514486271|gb|KE346361.1|	1373394	1373406	ACATGC	12	-	2	TGTGCA
gi|514486271|gb|KE346361.1|	1374419	1374444	AGGATG	25	+	4	TGAGGA
gi|514486271|gb|KE346361.1|	1374547	1374571	ATC	24	-	8	TGA
gi|514486271|gb|KE346361.1|	1374848	1374860	ATCG	12	+	3	CGAT
gi|514486271|gb|KE346361.1|	1377090	1377102	AACACC	12	-	2	GGTGTT
gi|514486271|gb|KE346361.1|	1378143	1378156	ACCTGC	13	+	2	CTGCAC
gi|514486271|gb|KE346361.1|	1378162	1378175	AATC	13	-	3	GATT
gi|514486271|gb|KE346361.1|	1378258	1378271	AC	13	+	6	CA
gi|514486271|gb|KE346361.1|	1378533	1378547	ACTGAG	14	+	2	GACTGA
gi|514486271|gb|KE346361.1|	1378645	1378658	AGCATC	13	-	2	GCTGAT
gi|514486271|gb|KE346361.1|	1378736	1378756	AGC	20	-	6	CTG
gi|514486271|gb|KE346361.1|	1379069	1379082	ACACGC	13	+	2	ACGCAC
gi|514486271|gb|KE346361.1|	1380551	1380568	A	17	-	17	T
gi|514486271|gb|KE346361.1|	1380578	1380590	AAC	12	-	4	GTT
gi|514486271|gb|KE346361.1|	1380652	1380665	AATCCC	13	+	2	CAATCC
gi|514486271|gb|KE346361.1|	1381046	1381065	AG	19	-	9	TC
gi|514486271|gb|KE346361.1|	1381199	1381211	ACAGAG	12	+	2	AGACAG
gi|514486271|gb|KE346361.1|	1381536	1381548	AGCGC	12	+	2	CGCAG
gi|514486271|gb|KE346361.1|	1382641	1382654	AACAGC	13	+	2	AGCAAC
gi|514486271|gb|KE346361.1|	1383100	1383341	AG	241	+	120	AG
gi|514486271|gb|KE346361.1|	1383355	1383374	AAAAC	19	+	3	AAAAC
gi|514486271|gb|KE346361.1|	1384366	1384378	AAC	12	+	4	AAC
gi|514486271|gb|KE346361.1|	1387707	1387719	AAAAC	12	+	2	AAAAC
gi|514486271|gb|KE346361.1|	1387750	1387762	C	12	-	12	G
gi|514486271|gb|KE346361.1|	1388719	1388731	AAAGAG	12	+	2	AAAGAG
gi|514486271|gb|KE346361.1|	1388802	1388816	AAC	14	+	4	AAC
gi|514486271|gb|KE346361.1|	1388811	1388831	AAAAAC	20	+	3	AACAAA
gi|514486271|gb|KE346361.1|	1388837	1388863	AAAC	26	+	6	AACA
gi|514486271|gb|KE346361.1|	1388860	1388877	A	17	+	17	A
gi|514486271|gb|KE346361.1|	1388885	1388898	AAG	13	-	4	TCT
gi|514486271|gb|KE346361.1|	1389673	1389703	A	30	+	30	A
gi|514486271|gb|KE346361.1|	1390077	1390090	A	13	+	13	A
gi|514486271|gb|KE346361.1|	1390474	1390487	ATC	13	+	4	CAT
gi|514486271|gb|KE346361.1|	1390490	1390509	ATC	19	+	6	ATC
gi|514486271|gb|KE346361.1|	1390794	1390806	ACGAGG	12	-	2	CTCGTC
gi|514486271|gb|KE346361.1|	1390871	1390885	AG	14	+	7	AG
gi|514486271|gb|KE346361.1|	1391476	1391488	AATGAC	12	-	2	TGTCAT
gi|514486271|gb|KE346361.1|	1392347	1392359	AATAGC	12	+	2	AGCAAT
gi|514486271|gb|KE346361.1|	1392388	1392400	ACCAGC	12	-	2	TGGTGC
gi|514486271|gb|KE346361.1|	1393430	1393442	A	12	-	12	T
gi|514486271|gb|KE346361.1|	1393635	1393664	AG	29	+	14	AG
gi|514486271|gb|KE346361.1|	1393982	1394003	A	21	-	21	T
gi|514486271|gb|KE346361.1|	1394030	1394042	AGCTC	12	-	2	TGAGC
gi|514486271|gb|KE346361.1|	1394926	1394939	AATCCC	13	-	2	ATTGGG
gi|514486271|gb|KE346361.1|	1396657	1396670	AAACCG	13	-	2	GGTTTC
gi|514486271|gb|KE346361.1|	1398214	1398227	AAAAG	13	-	2	TTTTC
gi|514486271|gb|KE346361.1|	1400180	1400192	AGCGGC	12	+	2	GGCAGC
gi|514486271|gb|KE346361.1|	1401444	1401457	AGC	13	+	4	GCA
gi|514486271|gb|KE346361.1|	1402103	1402120	ATCATG	17	+	2	ATCATG
gi|514486271|gb|KE346361.1|	1402263	1402275	AAT	12	-	4	ATT
gi|514486271|gb|KE346361.1|	1402318	1402330	AGCATG	12	-	2	TGCTCA
gi|514486271|gb|KE346361.1|	1402433	1402448	AACATC	15	+	2	TCAACA
gi|514486271|gb|KE346361.1|	1402499	1402525	A	26	-	26	T
gi|514486271|gb|KE346361.1|	1403030	1403042	A	12	+	12	A
gi|514486271|gb|KE346361.1|	1403043	1403056	A	13	+	13	A
gi|514486271|gb|KE346361.1|	1404136	1404149	AAC	13	+	4	AAC
gi|514486271|gb|KE346361.1|	1404512	1404525	A	13	-	13	T
gi|514486271|gb|KE346361.1|	1404523	1404540	AAC	17	-	5	TTG
gi|514486271|gb|KE346361.1|	1404535	1404549	AAAC	14	-	3	TTGT
gi|514486271|gb|KE346361.1|	1404683	1404695	AGCTGC	12	+	2	GCAGCT
gi|514486271|gb|KE346361.1|	1404890	1404902	AAAGCC	12	-	2	CTTTGG
gi|514486271|gb|KE346361.1|	1405365	1405377	AAAAAC	12	-	2	TTTTTG
gi|514486271|gb|KE346361.1|	1407018	1407033	AG	15	+	7	AG
gi|514486271|gb|KE346361.1|	1407322	1407351	A	29	+	29	A
gi|514486271|gb|KE346361.1|	1407894	1407910	AAC	16	+	5	CAA
gi|514486271|gb|KE346361.1|	1408109	1408121	AAAAGC	12	+	2	AAAAGC
gi|514486271|gb|KE346361.1|	1408348	1408360	ACCTG	12	+	2	TGACC
gi|514486271|gb|KE346361.1|	1408559	1408573	ATC	14	-	4	TGA
gi|514486271|gb|KE346361.1|	1408602	1408614	AGGGG	12	-	2	CTCCC
gi|514486271|gb|KE346361.1|	1409024	1409043	AGC	19	-	6	CTG
gi|514486271|gb|KE346361.1|	1409100	1409112	AAATCG	12	-	2	GATTTC
gi|514486271|gb|KE346361.1|	1409186	1409198	AAGGAG	12	-	2	TCCTTC
gi|514486271|gb|KE346361.1|	1409199	1409215	AG	16	-	8	CT
gi|514486271|gb|KE346361.1|	1409276	1409302	ATC	26	+	8	ATC
gi|514486271|gb|KE346361.1|	1409307	1409323	AGGGGC	16	-	2	CCCCTG
gi|514486271|gb|KE346361.1|	1410142	1410154	AACACC	12	+	2	CACCAA
gi|514486271|gb|KE346361.1|	1411124	1411138	AAC	14	+	4	AAC
gi|514486271|gb|KE346361.1|	1413467	1413479	AGC	12	-	4	TGC
gi|514486271|gb|KE346361.1|	1414901	1414921	A	20	+	20	A
gi|514486271|gb|KE346361.1|	1415135	1415157	A	22	-	22	T
gi|514486271|gb|KE346361.1|	1415181	1415193	AAGGAG	12	-	2	TCTCCT
gi|514486271|gb|KE346361.1|	1415188	1415208	AGG	20	-	6	CTC
gi|514486271|gb|KE346361.1|	1415208	1415222	AG	14	-	7	TC
gi|514486271|gb|KE346361.1|	1415219	1415232	ACTC	13	+	3	CTCA
gi|514486271|gb|KE346361.1|	1415236	1415316	AG	80	-	40	TC
gi|514486271|gb|KE346361.1|	1415317	1415329	AG	12	-	6	CT
gi|514486271|gb|KE346361.1|	1415583	1415595	CCGG	12	+	3	GCCG
gi|514486271|gb|KE346361.1|	1416366	1416378	ACCTCG	12	+	2	CCTCGA
gi|514486271|gb|KE346361.1|	1419098	1419110	AATGGG	12	-	2	ATTCCC
gi|514486271|gb|KE346361.1|	1419202	1419218	AGGATC	16	+	2	GATCAG
gi|514486271|gb|KE346361.1|	1419284	1419296	ACTCGC	12	+	2	TCGCAC
gi|514486271|gb|KE346361.1|	1420187	1420199	AAAAAC	12	-	2	TTGTTT
gi|514486271|gb|KE346361.1|	1421381	1421393	ACGCGG	12	-	2	CGCGTC
gi|514486271|gb|KE346361.1|	1422047	1422059	AATGCG	12	+	2	ATGCGA
gi|514486271|gb|KE346361.1|	1422092	1422104	A	12	-	12	T
gi|514486271|gb|KE346361.1|	1422155	1422168	AG	13	-	6	CT
gi|514486271|gb|KE346361.1|	1422227	1422239	AG	12	-	6	TC
gi|514486271|gb|KE346361.1|	1422265	1422279	A	14	-	14	T
gi|514486271|gb|KE346361.1|	1422337	1422353	AGGGGG	16	-	2	CCCCCT
gi|514486271|gb|KE346361.1|	1422515	1422528	AACCCT	13	+	2	CTAACC
gi|514486271|gb|KE346361.1|	1422607	1422621	ACGATG	14	+	2	GATGAC
gi|514486271|gb|KE346361.1|	1423315	1423330	AC	15	-	7	TG
gi|514486271|gb|KE346361.1|	1423474	1423487	AACAGG	13	+	2	CAGGAA
gi|514486271|gb|KE346361.1|	1424087	1424099	AAAACC	12	+	2	CAAAAC
gi|514486271|gb|KE346361.1|	1424704	1424716	ACACCG	12	-	2	GTGTCG
gi|514486271|gb|KE346361.1|	1424815	1424828	AACTCC	13	+	2	TCCAAC
gi|514486271|gb|KE346361.1|	1425198	1425211	AGC	13	-	4	TGC
gi|514486271|gb|KE346361.1|	1425207	1425224	AAGC	17	-	4	TGCT
gi|514486271|gb|KE346361.1|	1427397	1427409	AAACAC	12	-	2	TTGTGT
gi|514486271|gb|KE346361.1|	1427488	1427500	AAAG	12	-	3	CTTT
gi|514486271|gb|KE346361.1|	1427547	1427560	AAT	13	-	4	TTA
gi|514486271|gb|KE346361.1|	1427776	1427788	AGCCC	12	-	2	GCTGG
gi|514486271|gb|KE346361.1|	1427840	1427854	AGC	14	-	4	CTG
gi|514486271|gb|KE346361.1|	1427885	1427900	AACAGC	15	+	2	ACAGCA
gi|514486271|gb|KE346361.1|	1428077	1428089	AGCG	12	+	3	GAGC
gi|514486271|gb|KE346361.1|	1428827	1428839	AGCTCG	12	+	2	GAGCTC
gi|514486271|gb|KE346361.1|	1430808	1430820	AACAGC	12	-	2	TTGCTG
gi|514486271|gb|KE346361.1|	1430896	1430913	AAC	17	-	5	TGT
gi|514486271|gb|KE346361.1|	1430980	1430994	AACAGC	14	-	2	TGCTGT
gi|514486271|gb|KE346361.1|	1431053	1431065	AAGAGC	12	-	2	CTTGCT
gi|514486271|gb|KE346361.1|	1432192	1432209	ATCGGC	17	+	2	GCATCG
gi|514486271|gb|KE346361.1|	1432204	1432225	AGCATC	21	+	3	GCATCA
gi|514486271|gb|KE346361.1|	1432577	1432594	A	17	-	17	T
gi|514486271|gb|KE346361.1|	1433470	1433604	AG	134	-	67	CT
gi|514486271|gb|KE346361.1|	1433639	1433654	AG	15	+	7	GA
gi|514486271|gb|KE346361.1|	1433654	1433668	AAG	14	+	4	GAA
gi|514486271|gb|KE346361.1|	1433712	1433733	A	21	+	21	A
gi|514486271|gb|KE346361.1|	1433775	1433788	ACTCGG	13	+	2	TCGGAC
gi|514486271|gb|KE346361.1|	1434226	1434244	AGCGGC	18	-	3	CTGCCG
gi|514486271|gb|KE346361.1|	1434516	1434530	AGAGCG	14	-	2	TCTCGC
gi|514486271|gb|KE346361.1|	1434671	1434684	A	13	-	13	T
gi|514486271|gb|KE346361.1|	1435105	1435125	A	20	-	20	T
gi|514486271|gb|KE346361.1|	1435127	1435142	AAAAAC	15	-	2	TTTGTT
gi|514486271|gb|KE346361.1|	1435137	1435168	A	31	-	31	T
gi|514486271|gb|KE346361.1|	1436004	1436017	AGGGCG	13	-	2	GCCCTC
gi|514486271|gb|KE346361.1|	1437211	1437223	AAGGAC	12	-	2	GTCCTT
gi|514486271|gb|KE346361.1|	1438656	1438671	AGC	15	-	5	TGC
gi|514486271|gb|KE346361.1|	1438669	1438686	CCG	17	+	5	GCC
gi|514486271|gb|KE346361.1|	1438739	1438751	ACTGCC	12	+	2	CTGCCA
gi|514486271|gb|KE346361.1|	1439270	1439285	AC	15	+	7	AC
gi|514486271|gb|KE346361.1|	1439406	1439418	AAAACG	12	+	2	AAACGA
gi|514486271|gb|KE346361.1|	1439476	1439493	AAGGAC	17	-	2	CTTGTC
gi|514486271|gb|KE346361.1|	1440223	1440236	ACCCTC	13	-	2	GGGTGA
gi|514486271|gb|KE346361.1|	1440536	1440548	ACCATC	12	-	2	ATGGTG
gi|514486271|gb|KE346361.1|	1440850	1440863	AATGC	13	+	2	CAATG
gi|514486271|gb|KE346361.1|	1440883	1440900	A	17	-	17	T
gi|514486271|gb|KE346361.1|	1441067	1441111	A	44	-	44	T
gi|514486271|gb|KE346361.1|	1441134	1441157	A	23	-	23	T
gi|514486271|gb|KE346361.1|	1441418	1441432	AC	14	+	7	CA
gi|514486271|gb|KE346361.1|	1442024	1442039	AAAC	15	+	3	AACA
gi|514486271|gb|KE346361.1|	1443212	1443243	AAC	31	-	10	TTG
gi|514486271|gb|KE346361.1|	1444854	1444868	CCG	14	-	4	CGG
gi|514486271|gb|KE346361.1|	1445031	1445044	ACGATG	13	+	2	GACGAT
gi|514486271|gb|KE346361.1|	1448314	1448326	AAAACC	12	-	2	TTTTGG
gi|514486271|gb|KE346361.1|	1448372	1448386	AAAAC	14	-	2	TTTTG
gi|514486271|gb|KE346361.1|	1448706	1448729	A	23	-	23	T
gi|514486271|gb|KE346361.1|	1449215	1449231	AGATGC	16	-	2	CATCTG
gi|514486271|gb|KE346361.1|	1451102	1451114	AAAAAC	12	+	2	AAAAAC
gi|514486271|gb|KE346361.1|	1452914	1452926	AAATAC	12	-	2	TTGTAT
gi|514486271|gb|KE346361.1|	1453096	1453108	AAGTGG	12	+	2	GTGGAA
gi|514486271|gb|KE346361.1|	1453333	1453345	AGCGGC	12	+	2	GCAGCG
gi|514486271|gb|KE346361.1|	1453628	1453641	A	13	+	13	A
gi|514486271|gb|KE346361.1|	1453659	1453676	A	17	+	17	A
gi|514486271|gb|KE346361.1|	1453677	1453689	AAAG	12	+	3	GAAA
gi|514486271|gb|KE346361.1|	1453692	1453707	AAAG	15	+	3	AAAG
gi|514486271|gb|KE346361.1|	1453744	1453756	AAT	12	+	4	TAA
gi|514486271|gb|KE346361.1|	1453800	1453834	AGC	34	-	11	GCT
gi|514486271|gb|KE346361.1|	1454485	1454502	AAAAAC	17	+	2	AAAAAC
gi|514486271|gb|KE346361.1|	1454497	1454510	A	13	+	13	A
gi|514486271|gb|KE346361.1|	1454536	1454573	A	37	-	37	T
gi|514486271|gb|KE346361.1|	1454839	1454851	A	12	-	12	T
gi|514486271|gb|KE346361.1|	1454986	1455000	A	14	-	14	T
gi|514486271|gb|KE346361.1|	1455024	1455048	AAAAAT	24	-	4	ATTTTT
gi|514486271|gb|KE346361.1|	1455160	1455173	A	13	-	13	T
gi|514486271|gb|KE346361.1|	1455242	1455258	A	16	-	16	T
gi|514486271|gb|KE346361.1|	1455346	1455358	AGCTCG	12	+	2	CTCGAG
gi|514486271|gb|KE346361.1|	1455460	1455477	AGC	17	+	5	GCA
gi|514486271|gb|KE346361.1|	1455478	1455496	ACCAGC	18	+	3	CCAGCA
gi|514486271|gb|KE346361.1|	1455500	1455514	ACCAGC	14	+	2	CACCAG
gi|514486271|gb|KE346361.1|	1455541	1455558	AGC	17	+	5	GCA
gi|514486271|gb|KE346361.1|	1455559	1455571	ACCAGC	12	+	2	CCAGCA
gi|514486271|gb|KE346361.1|	1455692	1455706	AGGCCG	14	+	2	CGAGGC
gi|514486271|gb|KE346361.1|	1456136	1456150	AGC	14	-	4	GCT
gi|514486271|gb|KE346361.1|	1456157	1456171	AGCCGC	14	-	2	GCGGCT
gi|514486271|gb|KE346361.1|	1456199	1456211	CCGCGG	12	+	2	GGCCGC
gi|514486271|gb|KE346361.1|	1456376	1456393	AGC	17	-	5	GCT
gi|514486271|gb|KE346361.1|	1456391	1456405	CCG	14	+	4	GCC
gi|514486271|gb|KE346361.1|	1456837	1456849	A	12	+	12	A
gi|514486271|gb|KE346361.1|	1456963	1456975	AGAGCG	12	-	2	CTCTCG
gi|514486271|gb|KE346361.1|	1457606	1457618	CCGCGG	12	+	2	CGGCCG
gi|514486271|gb|KE346361.1|	1459205	1459223	A	18	-	18	T
gi|514486271|gb|KE346361.1|	1459676	1459690	C	14	+	14	C
gi|514486271|gb|KE346361.1|	1459889	1459993	AAC	104	+	34	AAC
gi|514486271|gb|KE346361.1|	1461461	1461473	AGGG	12	+	3	GGGA
gi|514486271|gb|KE346361.1|	1461521	1461544	A	23	+	23	A
gi|514486271|gb|KE346361.1|	1462645	1462668	A	23	-	23	T
gi|514486271|gb|KE346361.1|	1462693	1462710	A	17	-	17	T
gi|514486271|gb|KE346361.1|	1462796	1462822	ATC	26	-	8	ATG
gi|514486271|gb|KE346361.1|	1462880	1462899	A	19	-	19	T
gi|514486271|gb|KE346361.1|	1462919	1462944	A	25	-	25	T
gi|514486271|gb|KE346361.1|	1462972	1462989	AG	17	-	8	TC
gi|514486271|gb|KE346361.1|	1462990	1463004	AG	14	-	7	TC
gi|514486271|gb|KE346361.1|	1463133	1463152	A	19	+	19	A
gi|514486271|gb|KE346361.1|	1463156	1463169	A	13	-	13	T
gi|514486271|gb|KE346361.1|	1463195	1463209	AGGGG	14	-	2	CCCTC
gi|514486271|gb|KE346361.1|	1463224	1463237	C	13	-	13	G
gi|514486271|gb|KE346361.1|	1463323	1463336	AATGTG	13	-	2	CATTCA
gi|514486271|gb|KE346361.1|	1463567	1463581	AAAAC	14	-	2	TTTTG
gi|514486271|gb|KE346361.1|	1463728	1463741	A	13	-	13	T
gi|514486271|gb|KE346361.1|	1463910	1463924	A	14	+	14	A
gi|514486271|gb|KE346361.1|	1463946	1463966	A	20	+	20	A
gi|514486271|gb|KE346361.1|	1463979	1463991	AGCCG	12	-	2	CGGCT
gi|514486271|gb|KE346361.1|	1464385	1464397	AAAAGC	12	+	2	AAAGCA
gi|514486271|gb|KE346361.1|	1464480	1464493	AAAACC	13	+	2	ACCAAA
gi|514486271|gb|KE346361.1|	1466489	1466503	AGCTCG	14	+	2	GAGCTC
gi|514486271|gb|KE346361.1|	1472404	1472418	AATGTC	14	+	2	GTCAAT
gi|514486271|gb|KE346361.1|	1474189	1474201	AACATG	12	-	2	GTTCAT
gi|514486271|gb|KE346361.1|	1475969	1475981	ACGAGG	12	+	2	ACGAGG
gi|514486271|gb|KE346361.1|	1478115	1478127	C	12	+	12	C
gi|514486271|gb|KE346361.1|	1478180	1478197	A	17	-	17	T
gi|514486271|gb|KE346361.1|	1478210	1478222	AAAAAC	12	-	2	TTTGTT
gi|514486271|gb|KE346361.1|	1478787	1478815	A	28	+	28	A
gi|514486271|gb|KE346361.1|	1478827	1478841	AAAGAG	14	+	2	GAGAAA
gi|514486271|gb|KE346361.1|	1478857	1478880	AAG	23	+	7	AAG
gi|514486271|gb|KE346361.1|	1478886	1478911	AAAG	25	+	6	AAGA
gi|514486271|gb|KE346361.1|	1480261	1480273	A	12	+	12	A
gi|514486271|gb|KE346361.1|	1480776	1480788	AGAGCG	12	+	2	GAGAGC
gi|514486271|gb|KE346361.1|	1480930	1480951	AAC	21	+	7	AAC
gi|514486271|gb|KE346361.1|	1481387	1481400	AAGCTC	13	-	2	CTTGAG
gi|514486271|gb|KE346361.1|	1481472	1481492	A	20	+	20	A
gi|514486271|gb|KE346361.1|	1481960	1481972	AG	12	-	6	CT
gi|514486271|gb|KE346361.1|	1482207	1482237	A	30	-	30	T
gi|514486271|gb|KE346361.1|	1482377	1482391	ACCCCC	14	+	2	CCACCC
gi|514486271|gb|KE346361.1|	1482429	1482464	A	35	+	35	A
gi|514486271|gb|KE346361.1|	1482856	1482870	AGC	14	-	4	CTG
gi|514486271|gb|KE346361.1|	1484803	1484820	AAG	17	+	5	AGA
gi|514486271|gb|KE346361.1|	1484821	1484836	AAGAGG	15	+	2	AGAGGA
gi|514486271|gb|KE346361.1|	1486621	1486634	AGC	13	+	4	AGC
gi|514486271|gb|KE346361.1|	1486635	1486647	AGC	12	+	4	CAG
gi|514486271|gb|KE346361.1|	1486910	1486924	ACCAGC	14	-	2	TGCTGG
gi|514486271|gb|KE346361.1|	1486919	1486931	ACC	12	-	4	TGG
gi|514486271|gb|KE346361.1|	1487212	1487238	ACAG	26	+	6	ACAG
gi|514486271|gb|KE346361.1|	1487300	1487323	AAC	23	+	7	ACA
gi|514486271|gb|KE346361.1|	1487324	1487339	AAC	15	+	5	ACA
gi|514486271|gb|KE346361.1|	1488087	1488100	A	13	+	13	A
gi|514486271|gb|KE346361.1|	1488532	1488547	ATC	15	-	5	ATG
gi|514486271|gb|KE346361.1|	1488640	1488652	A	12	-	12	T
gi|514486271|gb|KE346361.1|	1488765	1488784	A	19	-	19	T
gi|514486271|gb|KE346361.1|	1488972	1488998	A	26	-	26	T
gi|514486271|gb|KE346361.1|	1489241	1489255	AGC	14	+	4	CAG
gi|514486271|gb|KE346361.1|	1489420	1489433	A	13	+	13	A
gi|514486271|gb|KE346361.1|	1489913	1489927	AACTTC	14	-	2	GAAGTT
gi|514486271|gb|KE346361.1|	1490241	1490257	AGC	16	-	5	CTG
gi|514486271|gb|KE346361.1|	1490390	1490402	AAATGC	12	+	2	CAAATG
gi|514486271|gb|KE346361.1|	1490632	1490649	AC	17	-	8	GT
gi|514486271|gb|KE346361.1|	1490771	1490790	AGATG	19	-	3	TCTCA
gi|514486271|gb|KE346361.1|	1491372	1491386	AGC	14	-	4	TGC
gi|514486271|gb|KE346361.1|	1491395	1491410	AGC	15	-	5	CTG
gi|514486271|gb|KE346361.1|	1491419	1491437	AGC	18	-	6	CTG
gi|514486271|gb|KE346361.1|	1491667	1491682	AAAAAC	15	-	2	TTTGTT
gi|514486271|gb|KE346361.1|	1491677	1491693	A	16	-	16	T
gi|514486271|gb|KE346361.1|	1492526	1492539	ACTCT	13	+	2	TACTC
gi|514486271|gb|KE346361.1|	1494081	1494094	AAAG	13	+	3	AGAA
gi|514486271|gb|KE346361.1|	1494971	1494984	ACTGAG	13	+	2	GAGACT
gi|514486271|gb|KE346361.1|	1495187	1495202	A	15	-	15	T
gi|514486271|gb|KE346361.1|	1495409	1495427	ACG	18	+	6	CGA
gi|514486271|gb|KE346361.1|	1495422	1495437	ACGATG	15	+	2	GACGAT
gi|514486271|gb|KE346361.1|	1496626	1496638	AC	12	-	6	TG
gi|514486271|gb|KE346361.1|	1496934	1496948	AAATGG	14	-	2	CCATTT
gi|514486271|gb|KE346361.1|	1497243	1497257	AAAAAC	14	-	2	GTTTTT
gi|514486271|gb|KE346361.1|	1498700	1498714	AAGGCG	14	+	2	GAAGGC
gi|514486271|gb|KE346361.1|	1498783	1498814	AGC	31	-	10	CTG
gi|514486271|gb|KE346361.1|	1498941	1498953	ACGCTG	12	+	2	CTGACG
gi|514486271|gb|KE346361.1|	1499536	1499549	AACGCC	13	+	2	AACGCC
gi|514486271|gb|KE346361.1|	1500180	1500192	AGCCGC	12	-	2	GGCTGC
gi|514486271|gb|KE346361.1|	1500662	1500677	AACACC	15	-	2	TGGTGT
gi|514486271|gb|KE346361.1|	1500852	1500864	AAGCTC	12	-	2	GAGCTT
gi|514486271|gb|KE346361.1|	1500944	1500962	AGC	18	+	6	CAG
gi|514486271|gb|KE346361.1|	1500963	1500983	AGC	20	+	6	AGC
gi|514486271|gb|KE346361.1|	1501165	1501177	AAGCC	12	-	2	GCTTG
gi|514486271|gb|KE346361.1|	1501196	1501210	ACG	14	+	4	GAC
gi|514486271|gb|KE346361.1|	1501485	1501498	AAAAGC	13	+	2	AAGCAA
gi|514486271|gb|KE346361.1|	1501558	1501571	AAGGAG	13	+	2	AGAAGG
gi|514486271|gb|KE346361.1|	1501612	1501624	AAATGC	12	-	2	TTGCAT
gi|514486271|gb|KE346361.1|	1501710	1501722	AGGGGG	12	+	2	GGGAGG
gi|514486271|gb|KE346361.1|	1501845	1501857	AAATGC	12	-	2	TTTGCA
gi|514486271|gb|KE346361.1|	1502455	1502467	C	12	-	12	G
gi|514486271|gb|KE346361.1|	1503507	1503520	AG	13	+	6	AG
gi|514486271|gb|KE346361.1|	1504028	1504040	AACATG	12	-	2	TGTTCA
gi|514486271|gb|KE346361.1|	1504113	1504133	AGCC	20	-	5	CTGG
gi|514486271|gb|KE346361.1|	1504294	1504308	AACCCT	14	-	2	GGGTTA
gi|514486271|gb|KE346361.1|	1504469	1504482	ACTCG	13	+	2	CGACT
gi|514486271|gb|KE346361.1|	1504697	1504709	ATCGCC	12	+	2	CCATCG
gi|514486271|gb|KE346361.1|	1505162	1505177	AAGCTC	15	-	2	TTGAGC
gi|514486271|gb|KE346361.1|	1507425	1507437	ACCATC	12	+	2	TCACCA
gi|514486271|gb|KE346361.1|	1507432	1507444	ACC	12	+	4	CAC
gi|514486271|gb|KE346361.1|	1508398	1508415	CCG	17	+	5	CCG
gi|514486271|gb|KE346361.1|	1509155	1509167	AG	12	-	6	CT
gi|514486271|gb|KE346361.1|	1509206	1509225	AG	19	-	9	CT
gi|514486271|gb|KE346361.1|	1509247	1509263	ACCG	16	-	4	GTCG
gi|514486271|gb|KE346361.1|	1509910	1509922	AAAAAC	12	-	2	TGTTTT
gi|514486271|gb|KE346361.1|	1509928	1509942	AAAAC	14	-	2	TTTTG
gi|514486271|gb|KE346361.1|	1510006	1510019	AAGGTG	13	-	2	ACCTTC
gi|514486271|gb|KE346361.1|	1511173	1511185	AAGC	12	+	3	CAAG
gi|514486271|gb|KE346361.1|	1511818	1511831	AACGC	13	+	2	AACGC
gi|514486271|gb|KE346361.1|	1511841	1511871	A	30	+	30	A
gi|514486271|gb|KE346361.1|	1512272	1512284	ACAGTC	12	-	2	CTGTGA
gi|514486271|gb|KE346361.1|	1512406	1512419	AACGAG	13	-	2	CTCGTT
gi|514486271|gb|KE346361.1|	1512938	1512952	ACC	14	+	4	CCA
gi|514486271|gb|KE346361.1|	1513174	1513196	A	22	-	22	T
gi|514486271|gb|KE346361.1|	1513193	1513208	AAAC	15	-	3	TTTG
gi|514486271|gb|KE346361.1|	1514501	1514520	AGG	19	-	6	CTC
gi|514486271|gb|KE346361.1|	1515563	1515576	ACCTCC	13	+	2	CCACCT
gi|514486271|gb|KE346361.1|	1517297	1517309	AAC	12	-	4	TTG
gi|514486271|gb|KE346361.1|	1518191	1518204	AAAAC	13	+	2	ACAAA
gi|514486271|gb|KE346361.1|	1519570	1519601	AGC	31	-	10	TGC
gi|514486271|gb|KE346361.1|	1521527	1521539	AAAAAC	12	+	2	AAAAAC
gi|514486271|gb|KE346361.1|	1521544	1521560	AAAAAC	16	+	2	AAACAA
gi|514486271|gb|KE346361.1|	1521583	1521595	AATGAC	12	+	2	ACAATG
gi|514486271|gb|KE346361.1|	1521658	1521670	AAAC	12	+	3	ACAA
gi|514486271|gb|KE346361.1|	1521801	1521813	A	12	-	12	T
gi|514486271|gb|KE346361.1|	1522143	1522158	AG	15	+	7	AG
gi|514486271|gb|KE346361.1|	1522686	1522700	AAAACG	14	+	2	AAACGA
gi|514486271|gb|KE346361.1|	1522694	1522706	AAACG	12	+	2	ACGAA
gi|514486271|gb|KE346361.1|	1522713	1522734	A	21	+	21	A
gi|514486271|gb|KE346361.1|	1522934	1522947	ACTCC	13	+	2	CACTC
gi|514486271|gb|KE346361.1|	1522943	1522955	ACACC	12	+	2	CCACA
gi|514486271|gb|KE346361.1|	1523093	1523107	AGCATC	14	-	2	TGATGC
gi|514486271|gb|KE346361.1|	1523102	1523121	AGC	19	-	6	TGC
gi|514486271|gb|KE346361.1|	1523382	1523394	ACTATC	12	-	2	GATAGT
gi|514486271|gb|KE346361.1|	1524032	1524044	ACCGT	12	+	2	GTACC
gi|514486271|gb|KE346361.1|	1525774	1525789	ACG	15	-	5	TCG
gi|514486271|gb|KE346361.1|	1525784	1525801	ACGCCG	17	-	2	CGTCGG
gi|514486271|gb|KE346361.1|	1525848	1525862	AGGCGG	14	+	2	CGGAGG
gi|514486271|gb|KE346361.1|	1525937	1525951	ACCC	14	-	3	GGTG
gi|514486271|gb|KE346361.1|	1526176	1526191	AG	15	-	7	TC
gi|514486271|gb|KE346361.1|	1526317	1526364	AGAGGC	47	-	7	TCTGCC
gi|514486271|gb|KE346361.1|	1526765	1526781	AATCTC	16	+	2	TCTCAA
gi|514486271|gb|KE346361.1|	1526777	1526796	AG	19	-	9	TC
gi|514486271|gb|KE346361.1|	1526975	1527004	ACAGAG	29	+	4	AGAGAC
gi|514486271|gb|KE346361.1|	1528317	1528329	AATGCG	12	+	2	TGCGAA
gi|514486271|gb|KE346361.1|	1529214	1529227	AACAC	13	-	2	GTTGT
gi|514486271|gb|KE346361.1|	1529373	1529386	AAAAAC	13	+	2	ACAAAA
gi|514486271|gb|KE346361.1|	1529515	1529527	ACC	12	-	4	GGT
gi|514486271|gb|KE346361.1|	1529546	1529567	ACG	21	-	7	GTC
gi|514486271|gb|KE346361.1|	1529718	1529730	AGC	12	-	4	TGC
gi|514486271|gb|KE346361.1|	1530205	1530225	ACACGC	20	+	3	CACGCA
gi|514486271|gb|KE346361.1|	1530504	1530516	AAAC	12	-	3	TGTT
gi|514486271|gb|KE346361.1|	1531086	1531106	AGAGCC	20	+	3	GCCAGA
gi|514486271|gb|KE346361.1|	1531124	1531156	AC	32	-	16	TG
gi|514486271|gb|KE346361.1|	1531326	1531340	ACTG	14	-	3	TCAG
gi|514486271|gb|KE346361.1|	1531486	1531508	AACAAG	22	+	3	CAAGAA
gi|514486271|gb|KE346361.1|	1532488	1532502	AGC	14	+	4	CAG
gi|514486271|gb|KE346361.1|	1533047	1533076	A	29	+	29	A
gi|514486271|gb|KE346361.1|	1534098	1534110	AAAACC	12	+	2	CAAAAC
gi|514486271|gb|KE346361.1|	1534107	1534131	AAC	24	+	8	AAC
gi|514486271|gb|KE346361.1|	1534164	1534176	A	12	+	12	A
gi|514486271|gb|KE346361.1|	1534460	1534472	AAAAAC	12	+	2	CAAAAA
gi|514486271|gb|KE346361.1|	1535154	1535166	AGCC	12	-	3	GGCT
gi|514486271|gb|KE346361.1|	1535429	1535454	A	25	+	25	A
gi|514486271|gb|KE346361.1|	1535463	1535480	ACTGAG	17	+	2	ACTGAG
gi|514486271|gb|KE346361.1|	1535612	1535624	A	12	-	12	T
gi|514486271|gb|KE346361.1|	1535626	1535640	A	14	-	14	T
gi|514486271|gb|KE346361.1|	1536824	1536838	AGC	14	+	4	CAG
gi|514486271|gb|KE346361.1|	1536891	1536912	AAAAC	21	+	4	AACAA
gi|514486271|gb|KE346361.1|	1536909	1536931	AAAAC	22	+	4	AAACA
gi|514486271|gb|KE346361.1|	1536925	1536943	AAAC	18	+	4	AACA
gi|514486271|gb|KE346361.1|	1540501	1540515	AATGAG	14	+	2	GAATGA
gi|514486271|gb|KE346361.1|	1541317	1541329	AAATC	12	-	2	TTTGA
gi|514486271|gb|KE346361.1|	1541561	1541573	AATTCC	12	-	2	TGGAAT
gi|514486271|gb|KE346361.1|	1541609	1541622	AAATAC	13	-	2	TGTATT
gi|514486271|gb|KE346361.1|	1544263	1544275	AAAAAG	12	-	2	CTTTTT
gi|514486271|gb|KE346361.1|	1545118	1545130	ATCGCC	12	+	2	CCATCG
gi|514486271|gb|KE346361.1|	1547904	1547916	AACCTC	12	+	2	TCAACC
gi|514486271|gb|KE346361.1|	1550959	1550976	A	17	+	17	A
gi|514486271|gb|KE346361.1|	1551569	1551581	ACTCGG	12	-	2	AGTCCG
gi|514486271|gb|KE346361.1|	1554804	1554818	AGC	14	+	4	CAG
gi|514486271|gb|KE346361.1|	1554871	1554892	AAAAC	21	+	4	AACAA
gi|514486271|gb|KE346361.1|	1554889	1554911	AAAAC	22	+	4	AAACA
gi|514486271|gb|KE346361.1|	1554905	1554923	AAAC	18	+	4	AACA
gi|514486271|gb|KE346361.1|	1557957	1557969	AAC	12	+	4	ACA
gi|514486271|gb|KE346361.1|	1558801	1558814	AC	13	+	6	AC
gi|514486271|gb|KE346361.1|	1558813	1558825	A	12	+	12	A
gi|514486271|gb|KE346361.1|	1558826	1558840	A	14	+	14	A
gi|514486271|gb|KE346361.1|	1558962	1559124	AC	162	+	81	CA
gi|514486271|gb|KE346361.1|	1559132	1559155	AC	23	+	11	AC
gi|514486271|gb|KE346361.1|	1559579	1559592	AATCAG	13	-	2	TTCTGA
gi|514486271|gb|KE346361.1|	1559757	1559775	A	18	+	18	A
gi|514486271|gb|KE346361.1|	1559781	1559801	A	20	+	20	A
gi|514486271|gb|KE346361.1|	1560263	1560275	A	12	+	12	A
gi|514486271|gb|KE346361.1|	1560628	1560640	AGCGGC	12	+	2	GGCAGC
gi|514486271|gb|KE346361.1|	1562402	1562414	AATGGC	12	-	2	TGCCAT
gi|514486271|gb|KE346361.1|	1562439	1562451	AAGAGG	12	+	2	GGAAGA
gi|514486271|gb|KE346361.1|	1562615	1562627	ATGGCC	12	+	2	CATGGC
gi|514486271|gb|KE346361.1|	1563611	1563630	AAAAAG	19	+	3	AAAAGA
gi|514486271|gb|KE346361.1|	1563625	1563642	AAG	17	+	5	AAG
gi|514486271|gb|KE346361.1|	1563640	1563653	A	13	+	13	A
gi|514486271|gb|KE346361.1|	1563944	1563972	AACC	28	+	7	CCAA
gi|514486271|gb|KE346361.1|	1563971	1564046	AAAC	75	+	18	AAAC
gi|514486271|gb|KE346361.1|	1564072	1564086	AAAC	14	+	3	AAAC
gi|514486271|gb|KE346361.1|	1564105	1564132	AAAC	27	+	6	AAAC
gi|514486271|gb|KE346361.1|	1564807	1564819	AGC	12	-	4	GCT
gi|514486271|gb|KE346361.1|	1564930	1564942	AATCAG	12	-	2	CTGATT
gi|514486271|gb|KE346361.1|	1564955	1564986	AC	31	-	15	TG
gi|514486271|gb|KE346361.1|	1565166	1565178	AATGAG	12	+	2	GAATGA
gi|514486271|gb|KE346361.1|	1565223	1565235	ATC	12	-	4	ATG
gi|514486271|gb|KE346361.1|	1565231	1565252	ATCC	21	-	5	GATG
gi|514486271|gb|KE346361.1|	1565251	1565279	ATCC	28	-	7	GGAT
gi|514486271|gb|KE346361.1|	1565534	1565550	AGC	16	-	5	GCT
gi|514486271|gb|KE346361.1|	1565548	1565560	ATC	12	-	4	TGA
gi|514486271|gb|KE346361.1|	1565561	1565573	ATC	12	-	4	GAT
gi|514486271|gb|KE346361.1|	1565849	1565863	AGCTGC	14	+	2	CAGCTG
gi|514486271|gb|KE346361.1|	1567064	1567078	AGC	14	-	4	GCT
gi|514486271|gb|KE346361.1|	1567830	1567844	AG	14	-	7	CT
gi|514486271|gb|KE346361.1|	1568178	1568193	AAACC	15	-	3	TTGGT
gi|514486271|gb|KE346361.1|	1568383	1568395	ATC	12	-	4	TGA
gi|514486271|gb|KE346361.1|	1568668	1568684	AATCCC	16	+	2	CCAATC
gi|514486271|gb|KE346361.1|	1568719	1568742	ACTGCG	23	+	3	CGACTG
gi|514486271|gb|KE346361.1|	1569635	1569659	AAC	24	-	8	TTG
gi|514486271|gb|KE346361.1|	1569669	1569682	A	13	-	13	T
gi|514486271|gb|KE346361.1|	1570322	1570343	A	21	+	21	A
gi|514486271|gb|KE346361.1|	1570719	1570734	AAATGC	15	-	2	TTTGCA
gi|514486271|gb|KE346361.1|	1573436	1573448	A	12	+	12	A
gi|514486271|gb|KE346361.1|	1573661	1573687	A	26	-	26	T
gi|514486271|gb|KE346361.1|	1573931	1573947	AATGCG	16	-	2	ATTCGC
gi|514486271|gb|KE346361.1|	1574186	1574198	AAAAT	12	-	2	TTTTA
gi|514486271|gb|KE346361.1|	1574208	1574220	A	12	-	12	T
gi|514486271|gb|KE346361.1|	1574918	1574931	AAAG	13	+	3	GAAA
gi|514486271|gb|KE346361.1|	1576005	1576018	AAAAAC	13	+	2	AACAAA
gi|514486271|gb|KE346361.1|	1576021	1576033	A	12	-	12	T
gi|514486271|gb|KE346361.1|	1576117	1576133	AG	16	-	8	CT
gi|514486271|gb|KE346361.1|	1576301	1576315	A	14	-	14	T
gi|514486271|gb|KE346361.1|	1576406	1576419	AGC	13	-	4	TGC
gi|514486271|gb|KE346361.1|	1576535	1576550	AAAAAG	15	-	2	TCTTTT
gi|514486271|gb|KE346361.1|	1576806	1576824	ATCGC	18	+	3	CGCAT
gi|514486271|gb|KE346361.1|	1576838	1576851	AGGGCG	13	-	2	CTCGCC
gi|514486271|gb|KE346361.1|	1577109	1577129	AGC	20	+	6	CAG
gi|514486271|gb|KE346361.1|	1577258	1577270	AACAGC	12	+	2	ACAGCA
gi|514486271|gb|KE346361.1|	1577437	1577453	AGCGGC	16	-	2	TGCCGC
gi|514486271|gb|KE346361.1|	1577505	1577520	ACGCCG	15	+	2	CCGACG
gi|514486271|gb|KE346361.1|	1577591	1577605	CCG	14	+	4	CGC
gi|514486271|gb|KE346361.1|	1577669	1577698	AGC	29	+	9	GCA
gi|514486271|gb|KE346361.1|	1577790	1577813	ACG	23	-	7	TCG
gi|514486271|gb|KE346361.1|	1577882	1577900	ACAGGG	18	+	3	GGGACA
gi|514486271|gb|KE346361.1|	1577907	1577919	ACAGGG	12	+	2	GGACAG
gi|514486271|gb|KE346361.1|	1577947	1577960	ACGCC	13	+	2	GCCAC
gi|514486271|gb|KE346361.1|	1578246	1578275	AACAGC	29	+	4	CAGCAA
gi|514486271|gb|KE346361.1|	1578276	1578317	AACAGC	41	+	6	CAGCAA
gi|514486271|gb|KE346361.1|	1578333	1578346	AGCTGC	13	+	2	CAGCTG
gi|514486271|gb|KE346361.1|	1578444	1578463	AAGACG	19	+	3	GAAGAC
gi|514486271|gb|KE346361.1|	1578477	1578500	ACG	23	+	7	GAC
gi|514486271|gb|KE346361.1|	1579881	1579895	AAAAAC	14	-	2	TTTGTT
gi|514486271|gb|KE346361.1|	1580723	1580737	AGCCG	14	-	2	GCTCG
gi|514486271|gb|KE346361.1|	1581491	1581503	ACCGCG	12	+	2	ACCGCG
gi|514486271|gb|KE346361.1|	1581690	1581702	AGCCG	12	-	2	GCTCG
gi|514486271|gb|KE346361.1|	1582024	1582048	AAC	24	-	8	TGT
gi|514486271|gb|KE346361.1|	1582765	1582783	AAAAAT	18	-	3	TTTATT
gi|514486271|gb|KE346361.1|	1582895	1582907	ACCTCG	12	+	2	CCTCGA
gi|514486271|gb|KE346361.1|	1583078	1583090	AACACC	12	+	2	ACCAAC
gi|514486271|gb|KE346361.1|	1583228	1583242	AAAAAC	14	-	2	TTGTTT
gi|514486271|gb|KE346361.1|	1583800	1583822	A	22	+	22	A
gi|514486271|gb|KE346361.1|	1584137	1584149	A	12	-	12	T
gi|514486271|gb|KE346361.1|	1584146	1584161	AAAC	15	-	3	TTTG
gi|514486271|gb|KE346361.1|	1584290	1584303	ACG	13	+	4	ACG
gi|514486271|gb|KE346361.1|	1584546	1584560	ACGAGG	14	+	2	GAGGAC
gi|514486271|gb|KE346361.1|	1584653	1584665	AAAAAG	12	-	2	TTCTTT
gi|514486271|gb|KE346361.1|	1585436	1585448	A	12	-	12	T
gi|514486271|gb|KE346361.1|	1585810	1585822	AACCG	12	-	2	TTCGG
gi|514486271|gb|KE346361.1|	1585873	1585886	AGGG	13	-	3	CCCT
gi|514486271|gb|KE346361.1|	1585996	1586013	ACCGAG	17	-	2	CTCGGT
gi|514486271|gb|KE346361.1|	1586125	1586151	ACG	26	+	8	CGA
gi|514486271|gb|KE346361.1|	1586659	1586671	AGCGC	12	-	2	CTGCG
gi|514486271|gb|KE346361.1|	1587823	1587835	ATCCGC	12	-	2	GATGCG
gi|514486271|gb|KE346361.1|	1588086	1588108	AAAAC	22	-	4	TTGTT
gi|514486271|gb|KE346361.1|	1588655	1588672	AC	17	-	8	GT
gi|514486271|gb|KE346361.1|	1588669	1588682	ACGC	13	-	3	GTGC
gi|514486271|gb|KE346361.1|	1588793	1588805	AAAAAC	12	+	2	AAAACA
gi|514486271|gb|KE346361.1|	1588978	1588990	AAG	12	-	4	CTT
gi|514486271|gb|KE346361.1|	1590091	1590103	ACTGCC	12	+	2	ACTGCC
gi|514486271|gb|KE346361.1|	1590268	1590281	AAATG	13	+	2	AAATG
gi|514486271|gb|KE346361.1|	1590282	1590295	A	13	+	13	A
gi|514486271|gb|KE346361.1|	1590336	1590352	A	16	+	16	A
gi|514486271|gb|KE346361.1|	1590376	1590505	AG	129	+	64	AG
gi|514486271|gb|KE346361.1|	1590646	1590660	AAAAC	14	+	2	AAAAC
gi|514486271|gb|KE346361.1|	1590706	1590718	CCCGCG	12	-	2	GGCGCG
gi|514486271|gb|KE346361.1|	1590930	1590957	A	27	-	27	T
gi|514486271|gb|KE346361.1|	1591778	1591797	ACCTCC	19	+	3	ACCTCC
gi|514486271|gb|KE346361.1|	1592400	1592412	ACCGCG	12	-	2	CGCGGT
gi|514486271|gb|KE346361.1|	1592877	1592895	A	18	-	18	T
gi|514486271|gb|KE346361.1|	1593446	1593460	AGCCGC	14	-	2	GCGGCT
gi|514486271|gb|KE346361.1|	1593689	1593705	AC	16	+	8	AC
gi|514486271|gb|KE346361.1|	1593737	1593754	ATCGC	17	+	3	CGCAT
gi|514486271|gb|KE346361.1|	1594107	1594119	AAC	12	+	4	ACA
gi|514486271|gb|KE346361.1|	1594168	1594180	AGCGCC	12	+	2	CAGCGC
gi|514486271|gb|KE346361.1|	1594631	1594643	AGCTGC	12	+	2	TGCAGC
gi|514486271|gb|KE346361.1|	1595488	1595505	AAAAAC	17	+	2	AAAAAC
gi|514486271|gb|KE346361.1|	1595500	1595515	A	15	+	15	A
gi|514486271|gb|KE346361.1|	1595639	1595652	A	13	-	13	T
gi|514486271|gb|KE346361.1|	1596354	1596366	ACCACT	12	+	2	TACCAC
gi|514486271|gb|KE346361.1|	1596643	1596656	AAAAAC	13	-	2	TTTTGT
gi|514486271|gb|KE346361.1|	1596881	1596902	A	21	-	21	T
gi|514486271|gb|KE346361.1|	1597305	1597320	AG	15	+	7	GA
gi|514486271|gb|KE346361.1|	1597692	1597712	AAAAAC	20	+	3	AAAACA
gi|514486271|gb|KE346361.1|	1598826	1598840	AGATC	14	-	2	TGATC
gi|514486271|gb|KE346361.1|	1598867	1598899	A	32	-	32	T
gi|514486271|gb|KE346361.1|	1598930	1598942	AAAC	12	-	3	TTTG
gi|514486271|gb|KE346361.1|	1599106	1599122	A	16	-	16	T
gi|514486271|gb|KE346361.1|	1599301	1599313	A	12	-	12	T
gi|514486271|gb|KE346361.1|	1599546	1599559	ATCC	13	+	3	CCAT
gi|514486271|gb|KE346361.1|	1599673	1599697	A	24	-	24	T
gi|514486271|gb|KE346361.1|	1600666	1600679	AGCGCC	13	+	2	CAGCGC
gi|514486271|gb|KE346361.1|	1601805	1601818	AAGGTG	13	-	2	TCACCT
gi|514486271|gb|KE346361.1|	1603129	1603141	AAGTCC	12	+	2	CAAGTC
gi|514486271|gb|KE346361.1|	1603452	1603466	A	14	-	14	T
gi|514486271|gb|KE346361.1|	1603918	1603931	A	13	-	13	T
gi|514486271|gb|KE346361.1|	1603940	1603956	AAAC	16	-	4	TTTG
gi|514486271|gb|KE346361.1|	1604205	1604217	ATCGCC	12	+	2	TCGCCA
gi|514486271|gb|KE346361.1|	1606952	1606964	ACACCG	12	+	2	CACCGA
gi|514486271|gb|KE346361.1|	1607668	1607680	AGCCG	12	-	2	CGGCT
gi|514486271|gb|KE346361.1|	1608790	1608802	AAC	12	-	4	TTG
gi|514486271|gb|KE346361.1|	1609110	1609127	A	17	+	17	A
gi|514486271|gb|KE346361.1|	1610518	1610531	ACGCTG	13	+	2	TGACGC
gi|514486271|gb|KE346361.1|	1611783	1611797	AGC	14	+	4	CAG
gi|514486271|gb|KE346361.1|	1611918	1611930	ACGGCG	12	+	2	GACGGC
gi|514486271|gb|KE346361.1|	1613202	1613216	A	14	+	14	A
gi|514486271|gb|KE346361.1|	1614985	1615011	A	26	+	26	A
gi|514486271|gb|KE346361.1|	1615452	1615464	AG	12	-	6	CT
gi|514486271|gb|KE346361.1|	1615734	1615754	A	20	+	20	A
gi|514486271|gb|KE346361.1|	1616124	1616138	A	14	+	14	A
gi|514486271|gb|KE346361.1|	1617019	1617032	AGCTC	13	+	2	TCAGC
gi|514486271|gb|KE346361.1|	1617340	1617353	ACATCC	13	+	2	CATCCA
gi|514486271|gb|KE346361.1|	1618339	1618352	AACAGC	13	-	2	GTTGCT
gi|514486271|gb|KE346361.1|	1618736	1618748	AAGAGC	12	-	2	CTCTTG
gi|514486271|gb|KE346361.1|	1619739	1619758	AG	19	+	9	AG
gi|514486271|gb|KE346361.1|	1620054	1620069	AAACC	15	+	3	CCAAA
gi|514486271|gb|KE346361.1|	1620740	1620752	AATCTG	12	+	2	TGAATC
gi|514486271|gb|KE346361.1|	1620776	1620788	AAGCGC	12	+	2	GCAAGC
gi|514486271|gb|KE346361.1|	1621691	1621704	ACGAGG	13	+	2	GAGGAC
gi|514486271|gb|KE346361.1|	1621705	1621722	ACG	17	+	5	CGA
gi|514486271|gb|KE346361.1|	1621895	1621912	AGC	17	-	5	CTG
gi|514486271|gb|KE346361.1|	1621907	1621930	ACTGCT	23	+	3	CTGCTA
gi|514486271|gb|KE346361.1|	1622236	1622253	ACT	17	-	5	AGT
gi|514486271|gb|KE346361.1|	1622533	1622552	AACTGG	19	-	3	TCCAGT
gi|514486271|gb|KE346361.1|	1622555	1622568	AGCAGG	13	-	2	GCTCCT
gi|514486271|gb|KE346361.1|	1622580	1622592	AGCAGG	12	-	2	CTCCTG
gi|514486271|gb|KE346361.1|	1622621	1622634	ACTGCG	13	-	2	GTCGCA
gi|514486271|gb|KE346361.1|	1622783	1622795	AAAGAG	12	+	2	GAAAGA
gi|514486271|gb|KE346361.1|	1622789	1622804	AAAG	15	+	3	GAAA
gi|514486271|gb|KE346361.1|	1622843	1622860	A	17	+	17	A
gi|514486271|gb|KE346361.1|	1622856	1622869	AAAAGC	13	+	2	AAAAGC
gi|514486271|gb|KE346361.1|	1622879	1622893	AAAAAG	14	+	2	AGAAAA
gi|514486271|gb|KE346361.1|	1623093	1623109	AGCTC	16	+	3	GCTCA
gi|514486271|gb|KE346361.1|	1623720	1623736	A	16	+	16	A
gi|514486271|gb|KE346361.1|	1623755	1623776	A	21	+	21	A
gi|514486271|gb|KE346361.1|	1623781	1623799	A	18	-	18	T
gi|514486271|gb|KE346361.1|	1624594	1624613	A	19	-	19	T
gi|514486271|gb|KE346361.1|	1626037	1626049	AAAAAC	12	-	2	TTTGTT
gi|514486271|gb|KE346361.1|	1626211	1626223	CCGCG	12	+	2	GCGCC
gi|514486271|gb|KE346361.1|	1626940	1626953	ACACAT	13	-	2	TATGTG
gi|514486271|gb|KE346361.1|	1630406	1630418	AGCGGC	12	+	2	GGCAGC
gi|514486271|gb|KE346361.1|	1631313	1631326	AAAC	13	+	3	AAAC
gi|514486271|gb|KE346361.1|	1631421	1631440	AGC	19	+	6	GCA
gi|514486271|gb|KE346361.1|	1631483	1631495	AATCGC	12	-	2	TTGCGA
gi|514486271|gb|KE346361.1|	1632354	1632371	AAACG	17	+	3	AAACG
gi|514486271|gb|KE346361.1|	1632383	1632402	A	19	+	19	A
gi|514486271|gb|KE346361.1|	1632431	1632447	A	16	+	16	A
gi|514486271|gb|KE346361.1|	1632524	1632536	C	12	-	12	G
gi|514486271|gb|KE346361.1|	1632620	1632636	A	16	+	16	A
gi|514486271|gb|KE346361.1|	1632708	1632720	A	12	+	12	A
gi|514486271|gb|KE346361.1|	1632735	1632752	A	17	-	17	T
gi|514486271|gb|KE346361.1|	1633048	1633067	A	19	-	19	T
gi|514486271|gb|KE346361.1|	1633250	1633267	ACGAGG	17	-	2	TCGTCC
gi|514486271|gb|KE346361.1|	1633360	1633375	AGC	15	-	5	TGC
gi|514486271|gb|KE346361.1|	1633391	1633403	AAG	12	+	4	AAG
gi|514486271|gb|KE346361.1|	1633455	1633467	A	12	+	12	A
gi|514486271|gb|KE346361.1|	1634073	1634086	AAGATG	13	-	2	TCATCT
gi|514486271|gb|KE346361.1|	1634389	1634401	AACGGC	12	+	2	ACGGCA
gi|514486271|gb|KE346361.1|	1635728	1635741	AAAGC	13	-	2	GCTTT
gi|514486271|gb|KE346361.1|	1636104	1636117	A	13	+	13	A
gi|514486271|gb|KE346361.1|	1636131	1636160	AGC	29	-	9	GCT
gi|514486271|gb|KE346361.1|	1637033	1637055	CCG	22	-	7	GCG
gi|514486271|gb|KE346361.1|	1637053	1637067	ACC	14	-	4	GGT
gi|514486271|gb|KE346361.1|	1637246	1637267	AAAC	21	+	5	ACAA
gi|514486271|gb|KE346361.1|	1640652	1640664	AACAC	12	+	2	AACAC
gi|514486271|gb|KE346361.1|	1641282	1641296	AAAC	14	+	3	AACA
gi|514486271|gb|KE346361.1|	1642063	1642076	AATCAG	13	+	2	AGAATC
gi|514486271|gb|KE346361.1|	1642399	1642417	AGC	18	+	6	GCA
gi|514486271|gb|KE346361.1|	1642574	1642593	AC	19	+	9	AC
gi|514486271|gb|KE346361.1|	1643063	1643075	ACACTG	12	-	2	GTGTCA
gi|514486271|gb|KE346361.1|	1643311	1643330	AG	19	+	9	GA
gi|514486271|gb|KE346361.1|	1644169	1644181	AGCATC	12	-	2	TGCTGA
gi|514486271|gb|KE346361.1|	1644358	1644372	ATC	14	-	4	TGA
gi|514486271|gb|KE346361.1|	1644367	1644384	ACCATC	17	-	2	TGATGG
gi|514486271|gb|KE346361.1|	1644386	1644398	ACG	12	-	4	CGT
gi|514486271|gb|KE346361.1|	1644409	1644423	ACTCGG	14	-	2	TCCGAG
gi|514486271|gb|KE346361.1|	1644601	1644613	AAACGC	12	+	2	CGCAAA
gi|514486271|gb|KE346361.1|	1645073	1645085	AAAC	12	+	3	CAAA
gi|514486271|gb|KE346361.1|	1645333	1645346	AGCG	13	-	3	CGCT
gi|514486271|gb|KE346361.1|	1645374	1645419	A	45	+	45	A
gi|514486271|gb|KE346361.1|	1645613	1645626	A	13	-	13	T
gi|514486271|gb|KE346361.1|	1645772	1645785	A	13	+	13	A
gi|514486271|gb|KE346361.1|	1645810	1645840	AAT	30	+	10	AAT
gi|514486271|gb|KE346361.1|	1646030	1646054	AG	24	+	12	AG
gi|514486271|gb|KE346361.1|	1646192	1646207	ACTCTC	15	-	2	GAGAGT
gi|514486271|gb|KE346361.1|	1646294	1646313	ATC	19	+	6	CAT
gi|514486271|gb|KE346361.1|	1646763	1646775	ATCGCC	12	+	2	TCGCCA
gi|514486271|gb|KE346361.1|	1647097	1647111	ATCGGC	14	+	2	GCATCG
gi|514486271|gb|KE346361.1|	1647178	1647195	ACG	17	-	5	TCG
gi|514486271|gb|KE346361.1|	1647664	1647677	ATCCGG	13	+	2	ATCCGG
gi|514486271|gb|KE346361.1|	1648072	1648085	AGGCGG	13	-	2	CGCCTC
gi|514486271|gb|KE346361.1|	1648550	1648564	A	14	-	14	T
gi|514486271|gb|KE346361.1|	1649077	1649091	AAGGTG	14	-	2	CCTTCA
gi|514486271|gb|KE346361.1|	1649226	1649257	ACTC	31	+	7	TCAC
gi|514486271|gb|KE346361.1|	1650172	1650192	AAAC	20	-	5	TTTG
gi|514486271|gb|KE346361.1|	1650364	1650376	AATGTC	12	-	2	GACATT
gi|514486271|gb|KE346361.1|	1650465	1650478	A	13	-	13	T
gi|514486271|gb|KE346361.1|	1651153	1651166	AAAAAC	13	+	2	AAAAAC
gi|514486271|gb|KE346361.1|	1651690	1651702	A	12	+	12	A
gi|514486271|gb|KE346361.1|	1652017	1652031	AAC	14	+	4	ACA
gi|514486271|gb|KE346361.1|	1652154	1652166	AAATCC	12	+	2	TCCAAA
gi|514486271|gb|KE346361.1|	1652633	1652648	ACAGCT	15	-	2	AGCTGT
gi|514486271|gb|KE346361.1|	1652746	1652776	ACAGCC	30	-	5	GCTGTG
gi|514486271|gb|KE346361.1|	1652967	1652988	AC	21	-	10	TG
gi|514486271|gb|KE346361.1|	1653022	1653037	AC	15	+	7	CA
gi|514486271|gb|KE346361.1|	1653520	1653535	A	15	+	15	A
gi|514486271|gb|KE346361.1|	1654849	1654871	ACCAGC	22	+	3	AGCACC
gi|514486271|gb|KE346361.1|	1655100	1655114	AAAAT	14	+	2	AAAAT
gi|514486271|gb|KE346361.1|	1655169	1655193	AAAAT	24	+	4	AAAAT
gi|514486271|gb|KE346361.1|	1655596	1655610	AAATCC	14	-	2	TGGATT
gi|514486271|gb|KE346361.1|	1656835	1656857	A	22	+	22	A
gi|514486271|gb|KE346361.1|	1657269	1657281	ACATC	12	-	2	GTGAT
gi|514486271|gb|KE346361.1|	1657510	1657529	ACACC	19	-	3	TGGTG
gi|514486271|gb|KE346361.1|	1658412	1658424	A	12	+	12	A
gi|514486271|gb|KE346361.1|	1659503	1659520	AACACC	17	-	2	GTTGGT
gi|514486271|gb|KE346361.1|	1659708	1659727	AAAC	19	+	4	AACA
gi|514486271|gb|KE346361.1|	1659935	1659952	A	17	-	17	T
gi|514486271|gb|KE346361.1|	1660016	1660028	AAC	12	+	4	CAA
gi|514486271|gb|KE346361.1|	1660231	1660244	AAAAGG	13	-	2	TCCTTT
gi|514486271|gb|KE346361.1|	1660814	1660832	A	18	-	18	T
gi|514486271|gb|KE346361.1|	1660831	1660849	AC	18	-	9	TG
gi|514486271|gb|KE346361.1|	1661055	1661068	ATC	13	-	4	GAT
gi|514486271|gb|KE346361.1|	1661078	1661097	AGC	19	-	6	TGC
gi|514486271|gb|KE346361.1|	1661154	1661169	ACG	15	+	5	GAC
gi|514486271|gb|KE346361.1|	1662236	1662248	AGCGCG	12	+	2	CGAGCG
gi|514486271|gb|KE346361.1|	1662462	1662477	ACG	15	-	5	TCG
gi|514486271|gb|KE346361.1|	1662573	1662593	ACG	20	-	6	TCG
gi|514486271|gb|KE346361.1|	1662654	1662668	ACG	14	+	4	GAC
gi|514486271|gb|KE346361.1|	1662694	1662706	AGGCGG	12	-	2	CCTCCG
gi|514486271|gb|KE346361.1|	1663233	1663251	AGC	18	-	6	GCT
gi|514486271|gb|KE346361.1|	1663462	1663475	AGC	13	-	4	CTG
gi|514486271|gb|KE346361.1|	1663700	1663712	ACACGC	12	-	2	GCGTGT
gi|514486271|gb|KE346361.1|	1663946	1663960	A	14	-	14	T
gi|514486271|gb|KE346361.1|	1664526	1664538	AACG	12	-	3	TCGT
gi|514486271|gb|KE346361.1|	1664635	1664652	A	17	+	17	A
gi|514486271|gb|KE346361.1|	1664732	1664745	AAAAAT	13	-	2	ATTTTT
gi|514486271|gb|KE346361.1|	1664787	1664799	A	12	-	12	T
gi|514486271|gb|KE346361.1|	1664813	1664825	A	12	-	12	T
gi|514486271|gb|KE346361.1|	1664903	1664915	AGGGG	12	-	2	CCCTC
gi|514486271|gb|KE346361.1|	1665025	1665042	A	17	-	17	T
gi|514486271|gb|KE346361.1|	1665046	1665089	AAG	43	-	14	TCT
gi|514486271|gb|KE346361.1|	1665217	1665230	AGC	13	+	4	GCA
gi|514486271|gb|KE346361.1|	1665302	1665316	ATC	14	+	4	CAT
gi|514486271|gb|KE346361.1|	1665359	1665372	AACAGC	13	+	2	AGCAAC
gi|514486271|gb|KE346361.1|	1665412	1665434	AGC	22	+	7	CAG
gi|514486271|gb|KE346361.1|	1665443	1665456	AAG	13	+	4	AAG
gi|514486271|gb|KE346361.1|	1665577	1665589	AGC	12	+	4	CAG
gi|514486271|gb|KE346361.1|	1665811	1665823	ACC	12	+	4	CCA
gi|514486271|gb|KE346361.1|	1665914	1665928	AAGCGG	14	+	2	CGGAAG
gi|514486271|gb|KE346361.1|	1665945	1665962	AGCGGC	17	-	2	CGCTGC
gi|514486271|gb|KE346361.1|	1665978	1665990	AGC	12	-	4	TGC
gi|514486271|gb|KE346361.1|	1666098	1666113	AGC	15	-	5	TGC
gi|514486271|gb|KE346361.1|	1666440	1666452	AGCGGC	12	-	2	TGCCGC
gi|514486271|gb|KE346361.1|	1666502	1666516	AGC	14	-	4	CTG
gi|514486271|gb|KE346361.1|	1666531	1666543	ACTGGG	12	+	2	ACTGGG
gi|514486271|gb|KE346361.1|	1666542	1666554	AGCCGC	12	-	2	GGCTGC
gi|514486271|gb|KE346361.1|	1666774	1666787	AACAGC	13	+	2	CAGCAA
gi|514486271|gb|KE346361.1|	1666789	1666807	AACAGC	18	+	3	CAGCAA
gi|514486271|gb|KE346361.1|	1666816	1666830	AGCTGC	14	+	2	CAGCTG
gi|514486271|gb|KE346361.1|	1667178	1667192	AAC	14	+	4	CAA
gi|514486271|gb|KE346361.1|	1667187	1667205	AACAGC	18	+	3	CAACAG
gi|514486271|gb|KE346361.1|	1668609	1668624	AAAC	15	-	3	TTGT
gi|514486271|gb|KE346361.1|	1668844	1668856	AC	12	+	6	CA
gi|514486271|gb|KE346361.1|	1668947	1668959	AGG	12	-	4	TCC
gi|514486271|gb|KE346361.1|	1668973	1668986	AAAGAG	13	-	2	TTTCTC
gi|514486271|gb|KE346361.1|	1669083	1669095	A	12	-	12	T
gi|514486271|gb|KE346361.1|	1669280	1669292	A	12	-	12	T
gi|514486271|gb|KE346361.1|	1669705	1669730	A	25	+	25	A
gi|514486271|gb|KE346361.1|	1669760	1669773	AAAAAG	13	-	2	CTTTTT
gi|514486271|gb|KE346361.1|	1669786	1669813	A	27	-	27	T
gi|514486271|gb|KE346361.1|	1669919	1669931	AATCTC	12	-	2	ATTGAG
gi|514486271|gb|KE346361.1|	1670074	1670088	AAAAAG	14	-	2	TTTTTC
gi|514486271|gb|KE346361.1|	1671112	1671125	ACCTCG	13	+	2	CGACCT
gi|514486271|gb|KE346361.1|	1671894	1671906	AAGCG	12	+	2	GCGAA
gi|514486271|gb|KE346361.1|	1671945	1671963	ACAGGG	18	-	3	CTGTCC
gi|514486271|gb|KE346361.1|	1672638	1672650	AAAACC	12	-	2	TTTTGG
gi|514486271|gb|KE346361.1|	1672720	1672734	AG	14	+	7	GA
gi|514486271|gb|KE346361.1|	1673403	1673425	AACAGC	22	-	3	GCTGTT
gi|514486271|gb|KE346361.1|	1673438	1673450	AGC	12	-	4	TGC
gi|514486271|gb|KE346361.1|	1674276	1674288	ACCGCC	12	-	2	TGGCGG
gi|514486271|gb|KE346361.1|	1674335	1674348	ACGACT	13	-	2	TAGTCG
gi|514486271|gb|KE346361.1|	1677002	1677014	ACACGC	12	+	2	GCACAC
gi|514486271|gb|KE346361.1|	1677027	1677042	AAC	15	+	5	CAA
gi|514486271|gb|KE346361.1|	1677900	1677912	AACAAG	12	-	2	CTTGTT
gi|514486271|gb|KE346361.1|	1677935	1677947	AACAAG	12	+	2	AGAACA
gi|514486271|gb|KE346361.1|	1678307	1678319	AGGGCC	12	+	2	CAGGGC
gi|514486271|gb|KE346361.1|	1678804	1678817	AACAC	13	+	2	ACACA
gi|514486271|gb|KE346361.1|	1679156	1679168	ACACGG	12	-	2	GTCCGT
gi|514486271|gb|KE346361.1|	1680362	1680374	AGGCCG	12	-	2	CTCGGC
gi|514486271|gb|KE346361.1|	1680513	1680528	AGGGGC	15	+	2	GGCAGG
gi|514486271|gb|KE346361.1|	1681177	1681190	CCG	13	+	4	CCG
gi|514486271|gb|KE346361.1|	1681404	1681418	AGCGGC	14	+	2	GCAGCG
gi|514486271|gb|KE346361.1|	1681425	1681438	AGCGGC	13	+	2	GCAGCG
gi|514486271|gb|KE346361.1|	1681896	1681910	ATC	14	-	4	TGA
gi|514486271|gb|KE346361.1|	1681908	1681921	AAC	13	-	4	TGT
gi|514486271|gb|KE346361.1|	1682126	1682139	AAAAAT	13	+	2	AAATAA
gi|514486271|gb|KE346361.1|	1683283	1683298	ACACTC	15	-	2	GTGTGA
gi|514486271|gb|KE346361.1|	1683373	1683388	AGCC	15	-	3	CTGG
gi|514486271|gb|KE346361.1|	1683465	1683478	AACGC	13	-	2	TTGCG
gi|514486271|gb|KE346361.1|	1684098	1684110	ACCATC	12	+	2	TCACCA
gi|514486271|gb|KE346361.1|	1684480	1684499	AACAGC	19	-	3	GTTGCT
gi|514486271|gb|KE346361.1|	1685736	1685749	AACG	13	-	3	CGTT
gi|514486271|gb|KE346361.1|	1686367	1686379	AAATCC	12	+	2	TCCAAA
gi|514486271|gb|KE346361.1|	1686394	1686406	AAAATC	12	+	2	TCAAAA
gi|514486271|gb|KE346361.1|	1686471	1686494	A	23	-	23	T
gi|514486271|gb|KE346361.1|	1686495	1686510	A	15	-	15	T
gi|514486271|gb|KE346361.1|	1686710	1686724	AAAATC	14	-	2	TTGATT
gi|514486271|gb|KE346361.1|	1686720	1686737	A	17	-	17	T
gi|514486271|gb|KE346361.1|	1687063	1687075	ACTCTC	12	+	2	TCTCAC
gi|514486271|gb|KE346361.1|	1687099	1687114	AG	15	-	7	CT
gi|514486271|gb|KE346361.1|	1687343	1687355	AGCATG	12	-	2	CATGCT
gi|514486271|gb|KE346361.1|	1687742	1687773	AG	31	-	15	TC
gi|514486271|gb|KE346361.1|	1687774	1687861	AG	87	-	43	TC
gi|514486271|gb|KE346361.1|	1688047	1688059	AAAGCC	12	-	2	TTTGGC
gi|514486271|gb|KE346361.1|	1689226	1689238	ATCG	12	+	3	ATCG
gi|514486271|gb|KE346361.1|	1690254	1690270	AAAAAC	16	-	2	TTTTTG
gi|514486271|gb|KE346361.1|	1690569	1690590	AG	21	-	10	TC
gi|514486271|gb|KE346361.1|	1690759	1690771	A	12	-	12	T
gi|514486271|gb|KE346361.1|	1691741	1691753	ACTCGG	12	-	2	GAGTCC
gi|514486271|gb|KE346361.1|	1692463	1692484	ATC	21	-	7	TGA
gi|514486271|gb|KE346361.1|	1693043	1693064	AGC	21	-	7	GCT
gi|514486271|gb|KE346361.1|	1695380	1695394	ATC	14	-	4	GAT
gi|514486271|gb|KE346361.1|	1697074	1697088	A	14	-	14	T
gi|514486271|gb|KE346361.1|	1697100	1697114	A	14	-	14	T
gi|514486271|gb|KE346361.1|	1697115	1697127	AC	12	-	6	GT
gi|514486271|gb|KE346361.1|	1697124	1697136	AAAAC	12	-	2	TGTTT
gi|514486271|gb|KE346361.1|	1697143	1697163	AAGAC	20	-	4	TTGTC
gi|514486271|gb|KE346361.1|	1699121	1699146	CCG	25	+	8	CGC
gi|514486271|gb|KE346361.1|	1699729	1699741	AATGCC	12	+	2	CCAATG
gi|514486271|gb|KE346361.1|	1699923	1699935	A	12	+	12	A
gi|514486271|gb|KE346361.1|	1700533	1700545	AAAGG	12	+	2	AAAGG
gi|514486271|gb|KE346361.1|	1700551	1700563	AACGAC	12	+	2	CGACAA
gi|514486271|gb|KE346361.1|	1700906	1700918	AAGCTC	12	-	2	GAGCTT
gi|514486271|gb|KE346361.1|	1701086	1701099	AACAGC	13	-	2	GCTGTT
gi|514486271|gb|KE346361.1|	1701364	1701380	AATACT	16	-	2	ATTAGT
gi|514486271|gb|KE346361.1|	1701662	1701694	AGG	32	-	10	CCT
gi|514486271|gb|KE346361.1|	1701755	1701768	CCG	13	-	4	GGC
gi|514486271|gb|KE346361.1|	1701875	1701901	ACTGCT	26	+	4	CTACTG
gi|514486271|gb|KE346361.1|	1702251	1702263	ACACC	12	-	2	TGGTG
gi|514486271|gb|KE346361.1|	1702304	1702316	A	12	+	12	A
gi|514486271|gb|KE346361.1|	1703155	1703170	AAAT	15	-	3	TTTA
gi|514486271|gb|KE346361.1|	1703164	1703176	AAAAAT	12	-	2	TTATTT
gi|514486271|gb|KE346361.1|	1703334	1703350	AC	16	-	8	GT
gi|514486271|gb|KE346361.1|	1703349	1703404	AG	55	-	27	TC
gi|514486271|gb|KE346361.1|	1703461	1703473	AACAC	12	-	2	TGTTG
gi|514486271|gb|KE346361.1|	1705349	1705361	ATCCCC	12	+	2	CATCCC
gi|514486271|gb|KE346361.1|	1705829	1705846	AAAAAT	17	-	2	TTTTTA
gi|514486271|gb|KE346361.1|	1705850	1705873	A	23	-	23	T
gi|514486271|gb|KE346361.1|	1706113	1706131	AC	18	-	9	TG
gi|514486271|gb|KE346361.1|	1706246	1706258	ATCC	12	+	3	CATC
gi|514486271|gb|KE346361.1|	1707199	1707221	AGC	22	+	7	GCA
gi|514486271|gb|KE346361.1|	1707439	1707453	AAGTCC	14	+	2	CCAAGT
gi|514486271|gb|KE346361.1|	1707807	1707819	AGC	12	+	4	GCA
gi|514486271|gb|KE346361.1|	1708267	1708279	AAAGG	12	-	2	CCTTT
gi|514486271|gb|KE346361.1|	1709466	1709478	ATCCGC	12	+	2	CGCATC
gi|514486271|gb|KE346361.1|	1710556	1710569	AATATC	13	+	2	CAATAT
gi|514486271|gb|KE346361.1|	1710598	1710611	AGAGCC	13	-	2	CTGGCT
gi|514486271|gb|KE346361.1|	1710732	1710744	AGCATG	12	+	2	GCATGA
gi|514486271|gb|KE346361.1|	1710917	1710932	ACCGCC	15	-	2	GGTGGC
gi|514486271|gb|KE346361.1|	1711417	1711436	AAGG	19	+	4	GAAG
gi|514486271|gb|KE346361.1|	1711528	1711540	AAC	12	+	4	CAA
gi|514486271|gb|KE346361.1|	1711587	1711600	A	13	+	13	A
gi|514486271|gb|KE346361.1|	1711751	1711764	AGGGGG	13	-	2	CCCTCC
gi|514486271|gb|KE346361.1|	1711808	1711826	A	18	-	18	T
gi|514486271|gb|KE346361.1|	1711923	1711942	AG	19	-	9	CT
gi|514486271|gb|KE346361.1|	1712005	1712028	A	23	-	23	T
gi|514486271|gb|KE346361.1|	1712040	1712054	AAG	14	-	4	TCT
gi|514486271|gb|KE346361.1|	1712235	1712258	A	23	-	23	T
gi|514486271|gb|KE346361.1|	1712361	1712375	A	14	-	14	T
gi|514486271|gb|KE346361.1|	1713201	1713214	ACGCGT	13	+	2	CGCGTA
gi|514486271|gb|KE346361.1|	1713740	1713755	A	15	+	15	A
gi|514486271|gb|KE346361.1|	1714604	1714618	A	14	+	14	A
gi|514486271|gb|KE346361.1|	1714823	1714836	ATGCGC	13	+	2	CATGCG
gi|514486271|gb|KE346361.1|	1714898	1714910	A	12	-	12	T
gi|514486271|gb|KE346361.1|	1714911	1714930	A	19	-	19	T
gi|514486271|gb|KE346361.1|	1715019	1715034	AAGTAC	15	-	2	CTTGTA
gi|514486271|gb|KE346361.1|	1715360	1715372	ACG	12	-	4	CGT
gi|514486271|gb|KE346361.1|	1715622	1715650	ATC	28	-	9	ATG
gi|514486271|gb|KE346361.1|	1715937	1715950	ACAGC	13	+	2	GCACA
gi|514486271|gb|KE346361.1|	1716305	1716317	AGCTC	12	-	2	TGAGC
gi|514486271|gb|KE346361.1|	1716430	1716449	AGC	19	-	6	CTG
gi|514486271|gb|KE346361.1|	1716682	1716694	AAGGCG	12	-	2	CGCCTT
gi|514486271|gb|KE346361.1|	1717696	1717713	AGC	17	+	5	AGC
gi|514486271|gb|KE346361.1|	1717773	1717787	ATCGCG	14	+	2	GCGATC
gi|514486271|gb|KE346361.1|	1719252	1719264	AACCGC	12	-	2	TGCGGT
gi|514486271|gb|KE346361.1|	1719319	1719333	AGG	14	+	4	GAG
gi|514486271|gb|KE346361.1|	1719342	1719355	AACAGC	13	+	2	AACAGC
gi|514486271|gb|KE346361.1|	1719647	1719663	AATGCG	16	-	2	CATTCG
gi|514486271|gb|KE346361.1|	1720507	1720521	AAATGC	14	-	2	TTTGCA
gi|514486271|gb|KE346361.1|	1720584	1720596	ACCCAG	12	+	2	CCCAGA
gi|514486271|gb|KE346361.1|	1720604	1720619	AGATCC	15	+	2	CAGATC
gi|514486271|gb|KE346361.1|	1720614	1720628	AGCTCC	14	+	2	TCCAGC
gi|514486271|gb|KE346361.1|	1720639	1720651	AGCTGC	12	+	2	GCTGCA
gi|514486271|gb|KE346361.1|	1720733	1720747	AGC	14	+	4	CAG
gi|514486271|gb|KE346361.1|	1721900	1721914	AGC	14	-	4	TGC
gi|514486271|gb|KE346361.1|	1722448	1722463	ACG	15	+	5	CGA
gi|514486271|gb|KE346361.1|	1723110	1723122	ACCAGT	12	-	2	TACTGG
gi|514486271|gb|KE346361.1|	1723135	1723152	ACCAGT	17	-	2	ACTGGT
gi|514486271|gb|KE346361.1|	1723289	1723303	ACC	14	-	4	GTG
gi|514486271|gb|KE346361.1|	1723572	1723590	AAGAAT	18	+	3	AAGAAT
gi|514486271|gb|KE346361.1|	1723605	1723618	A	13	+	13	A
gi|514486271|gb|KE346361.1|	1723787	1723799	AAGAGG	12	+	2	GAGGAA
gi|514486271|gb|KE346361.1|	1723852	1723864	AAAAGC	12	+	2	GCAAAA
gi|514486271|gb|KE346361.1|	1724128	1724140	AAAATT	12	+	2	AAAATT
gi|514486271|gb|KE346361.1|	1724202	1724225	AACAAT	23	-	3	TTGTTA
gi|514486271|gb|KE346361.1|	1724447	1724459	AGGG	12	+	3	GGGA
gi|514486271|gb|KE346361.1|	1724524	1724537	AC	13	+	6	CA
gi|514486271|gb|KE346361.1|	1724537	1724553	AC	16	+	8	CA
gi|514486271|gb|KE346361.1|	1725276	1725291	CCCCG	15	+	3	CCCGC
gi|514486271|gb|KE346361.1|	1725705	1725724	AG	19	+	9	AG
gi|514486271|gb|KE346361.1|	1725837	1725850	AACGAG	13	+	2	GAACGA
gi|514486271|gb|KE346361.1|	1725904	1725918	AAATAC	14	+	2	AAATAC
gi|514486271|gb|KE346361.1|	1725912	1725924	AATAC	12	+	2	ATACA
gi|514486271|gb|KE346361.1|	1725944	1725974	A	30	-	30	T
gi|514486271|gb|KE346361.1|	1726670	1726689	ACG	19	-	6	CGT
gi|514486271|gb|KE346361.1|	1726845	1726858	ACCTGC	13	-	2	GGTGCA
gi|514486271|gb|KE346361.1|	1727002	1727016	ACGATG	14	-	2	CGTCAT
gi|514486271|gb|KE346361.1|	1727205	1727221	ACG	16	-	5	TCG
gi|514486271|gb|KE346361.1|	1727378	1727395	AAGCCC	17	-	2	CTTGGG
gi|514486271|gb|KE346361.1|	1727861	1727874	ACGATG	13	-	2	ATCGTC
gi|514486271|gb|KE346361.1|	1727937	1727951	AAGGGC	14	-	2	CCCTTG
gi|514486271|gb|KE346361.1|	1729939	1729951	ATCATG	12	+	2	TCATGA
gi|514486271|gb|KE346361.1|	1731963	1731975	AAAAG	12	+	2	AAGAA
gi|514486271|gb|KE346361.1|	1732145	1732157	AAGAG	12	+	2	AGAAG
gi|514486271|gb|KE346361.1|	1732186	1732207	AG	21	+	10	GA
gi|514486271|gb|KE346361.1|	1732259	1732273	A	14	+	14	A
gi|514486271|gb|KE346361.1|	1732698	1732710	ATCGGC	12	-	2	CCGATG
gi|514486271|gb|KE346361.1|	1732783	1732803	AGC	20	+	6	GCA
gi|514486271|gb|KE346361.1|	1734140	1734155	AAGGG	15	-	3	CCTTC
gi|514486271|gb|KE346361.1|	1734157	1734171	AAGGG	14	-	2	TTCCC
gi|514486271|gb|KE346361.1|	1734215	1734227	ACGACT	12	+	2	TACGAC
gi|514486271|gb|KE346361.1|	1735722	1735735	AGGGGG	13	-	2	CTCCCC
gi|514486271|gb|KE346361.1|	1735745	1735758	AAT	13	-	4	TAT
gi|514486271|gb|KE346361.1|	1736114	1736134	AAAGC	20	-	4	TTGCT
gi|514486271|gb|KE346361.1|	1736136	1736154	ACC	18	-	6	TGG
gi|514486271|gb|KE346361.1|	1737864	1737879	AAAAG	15	+	3	AAAAG
gi|514486271|gb|KE346361.1|	1739002	1739019	AG	17	+	8	AG
gi|514486271|gb|KE346361.1|	1739022	1739035	AG	13	+	6	AG
gi|514486271|gb|KE346361.1|	1739154	1739166	AACTCC	12	-	2	TTGGAG
gi|514486271|gb|KE346361.1|	1739642	1739657	A	15	+	15	A
gi|514486271|gb|KE346361.1|	1739677	1739689	AAACAC	12	-	2	GTGTTT
gi|514486271|gb|KE346361.1|	1739745	1739762	AAAC	17	+	4	ACAA
gi|514486271|gb|KE346361.1|	1739785	1739797	AAACTG	12	-	2	TTTCAG
gi|514486271|gb|KE346361.1|	1739810	1739826	ACC	16	-	5	GGT
gi|514486271|gb|KE346361.1|	1740006	1740026	AGC	20	+	6	CAG
gi|514486271|gb|KE346361.1|	1740326	1740346	AGAGCC	20	+	3	GAGCCA
gi|514486271|gb|KE346361.1|	1740374	1740388	AACAGC	14	-	2	TGCTGT
gi|514486271|gb|KE346361.1|	1740524	1740537	AC	13	-	6	GT
gi|514486271|gb|KE346361.1|	1740750	1740772	AAAAAG	22	+	3	AAAGAA
gi|514486271|gb|KE346361.1|	1740809	1740826	A	17	+	17	A
gi|514486271|gb|KE346361.1|	1741589	1741601	AAAAC	12	+	2	AAACA
gi|514486271|gb|KE346361.1|	1741641	1741653	AGC	12	+	4	CAG
gi|514486271|gb|KE346361.1|	1741862	1741874	A	12	+	12	A
gi|514486271|gb|KE346361.1|	1742311	1742324	AGG	13	+	4	GGA
gi|514486271|gb|KE346361.1|	1742526	1742540	AAAC	14	+	3	AACA
gi|514486271|gb|KE346361.1|	1743138	1743157	ACC	19	-	6	TGG
gi|514486271|gb|KE346361.1|	1743163	1743175	AACAAT	12	+	2	TAACAA
gi|514486271|gb|KE346361.1|	1743207	1743230	A	23	-	23	T
gi|514486271|gb|KE346361.1|	1743403	1743420	AAT	17	+	5	AAT
gi|514486271|gb|KE346361.1|	1743429	1743446	AAAAAT	17	+	2	AAAAAT
gi|514486271|gb|KE346361.1|	1743451	1743464	A	13	-	13	T
gi|514486271|gb|KE346361.1|	1743659	1743671	AAGC	12	+	3	AGCA
gi|514486271|gb|KE346361.1|	1743918	1743932	AACCCT	14	+	2	CCTAAC
gi|514486271|gb|KE346361.1|	1744033	1744046	A	13	-	13	T
gi|514486271|gb|KE346361.1|	1744058	1744083	A	25	-	25	T
gi|514486271|gb|KE346361.1|	1744283	1744298	A	15	+	15	A
gi|514486271|gb|KE346361.1|	1744307	1744320	A	13	+	13	A
gi|514486271|gb|KE346361.1|	1744315	1744340	AAAAAG	25	+	4	AAAAAG
gi|514486271|gb|KE346361.1|	1744470	1744482	AAGCAG	12	+	2	AGCAGA
gi|514486271|gb|KE346361.1|	1744546	1744562	AAT	16	+	5	ATA
gi|514486271|gb|KE346361.1|	1744614	1744626	A	12	+	12	A
gi|514486271|gb|KE346361.1|	1744717	1744741	A	24	-	24	T
gi|514486271|gb|KE346361.1|	1744847	1744859	AATCGC	12	+	2	GCAATC
gi|514486271|gb|KE346361.1|	1744872	1744884	ATCC	12	+	3	CATC
gi|514486271|gb|KE346361.1|	1745026	1745043	AATG	17	-	4	TCAT
gi|514486271|gb|KE346361.1|	1746840	1746853	A	13	-	13	T
gi|514486271|gb|KE346361.1|	1747340	1747354	AAC	14	-	4	TTG
gi|514486271|gb|KE346361.1|	1748422	1748434	ATGCC	12	+	2	ATGCC
gi|514486271|gb|KE346361.1|	1749616	1749630	AACGCG	14	-	2	TCGCGT
gi|514486271|gb|KE346361.1|	1749640	1749652	AAGCGG	12	-	2	GCTTCC
gi|514486271|gb|KE346361.1|	1751446	1751461	AGC	15	-	5	TGC
gi|514486271|gb|KE346361.1|	1751651	1751663	AAGC	12	-	3	CTTG
gi|514486271|gb|KE346361.1|	1751832	1751847	AATGC	15	-	3	GCATT
gi|514486271|gb|KE346361.1|	1751853	1751873	AATGC	20	-	4	CATTG
gi|514486271|gb|KE346361.1|	1751890	1751902	ATC	12	+	4	CAT
gi|514486271|gb|KE346361.1|	1751940	1751954	ATCGGC	14	-	2	GCCGAT
gi|514486271|gb|KE346361.1|	1751949	1751972	AGCATC	23	-	3	GATGCT
gi|514486271|gb|KE346361.1|	1752143	1752204	AAGCAC	61	+	10	AGCACA
gi|514486271|gb|KE346361.1|	1753354	1753366	AATGAC	12	+	2	AATGAC
gi|514486271|gb|KE346361.1|	1755300	1755317	ACCCC	17	-	3	GGTGG
gi|514486271|gb|KE346361.1|	1755365	1755380	AACTG	15	+	3	AACTG
gi|514486271|gb|KE346361.1|	1755462	1755475	AAC	13	+	4	ACA
gi|514486271|gb|KE346361.1|	1756160	1756172	ACGGCG	12	-	2	GCCGTC
gi|514486271|gb|KE346361.1|	1756200	1756217	ACCAGC	17	+	2	CAGCAC
gi|514486271|gb|KE346361.1|	1759255	1759268	AAGCCC	13	-	2	GGCTTG
gi|514486271|gb|KE346361.1|	1761149	1761161	AAGAGC	12	+	2	CAAGAG
gi|514486271|gb|KE346361.1|	1762167	1762179	AGCGCG	12	-	2	GCTCGC
gi|514486271|gb|KE346361.1|	1762677	1762689	ACC	12	+	4	CAC
gi|514486271|gb|KE346361.1|	1763080	1763093	AAGCTC	13	-	2	GAGCTT
gi|514486271|gb|KE346361.1|	1763417	1763429	AAGTCC	12	-	2	GACTTG
gi|514486271|gb|KE346361.1|	1763866	1763878	ACGGCG	12	+	2	GACGGC
gi|514486271|gb|KE346361.1|	1764101	1764126	AGC	25	+	8	GCA
gi|514486271|gb|KE346361.1|	1764375	1764400	AGATGC	25	+	4	ATGCAG
gi|514486271|gb|KE346361.1|	1764398	1764416	ACG	18	+	6	GAC
gi|514486271|gb|KE346361.1|	1764419	1764432	ACGCAG	13	+	2	GCAGAC
gi|514486271|gb|KE346361.1|	1764428	1764443	ACG	15	+	5	GAC
gi|514486271|gb|KE346361.1|	1764715	1764728	ACG	13	+	4	CGA
gi|514486271|gb|KE346361.1|	1764954	1764968	AAG	14	+	4	AAG
gi|514486271|gb|KE346361.1|	1764966	1764981	A	15	+	15	A
gi|514486271|gb|KE346361.1|	1765023	1765035	AAAAAC	12	+	2	AAAAAC
gi|514486271|gb|KE346361.1|	1765076	1765092	AAAAAC	16	+	2	AAAACA
gi|514486271|gb|KE346361.1|	1765095	1765108	A	13	+	13	A
gi|514486271|gb|KE346361.1|	1765153	1765166	A	13	+	13	A
gi|514486271|gb|KE346361.1|	1765200	1765220	AAC	20	+	6	CAA
gi|514486271|gb|KE346361.1|	1765215	1765230	AACAGC	15	+	2	CAACAG
gi|514486271|gb|KE346361.1|	1765239	1765251	AAC	12	+	4	CAA
gi|514486271|gb|KE346361.1|	1765256	1765273	AAG	17	+	5	AAG
gi|514486271|gb|KE346361.1|	1767018	1767030	AGGCGC	12	-	2	TGCGCC
gi|514486271|gb|KE346361.1|	1767692	1767704	AAC	12	+	4	CAA
gi|514486271|gb|KE346361.1|	1768355	1768369	AAGAGG	14	-	2	TCTTCC
gi|514486271|gb|KE346361.1|	1768612	1768641	ACG	29	+	9	CGA
gi|514486271|gb|KE346361.1|	1768964	1768977	AGCCGC	13	-	2	GCTGCG
gi|514486271|gb|KE346361.1|	1769215	1769227	ACGCCG	12	+	2	CGACGC
gi|514486271|gb|KE346361.1|	1769543	1769569	AGCAGG	26	+	4	GCAGGA
gi|514486271|gb|KE346361.1|	1769630	1769649	ACG	19	-	6	TCG
gi|514486271|gb|KE346361.1|	1769848	1769863	AGC	15	+	5	AGC
gi|514486271|gb|KE346361.1|	1770114	1770128	A	14	+	14	A
gi|514486271|gb|KE346361.1|	1770129	1770141	AAAG	12	+	3	AGAA
gi|514486271|gb|KE346361.1|	1771428	1771440	AGCCG	12	-	2	GCTCG
gi|514486271|gb|KE346361.1|	1771560	1771581	A	21	+	21	A
gi|514486271|gb|KE346361.1|	1771583	1771595	AGATCG	12	+	2	TCGAGA
gi|514486271|gb|KE346361.1|	1771594	1771606	A	12	+	12	A
gi|514486271|gb|KE346361.1|	1773023	1773035	A	12	+	12	A
gi|514486271|gb|KE346361.1|	1773096	1773108	AAGC	12	+	3	AAGC
gi|514486271|gb|KE346361.1|	1773636	1773659	A	23	-	23	T
gi|514486271|gb|KE346361.1|	1773739	1773755	AACGGC	16	+	2	GCAACG
gi|514486271|gb|KE346361.1|	1773766	1773778	AACCAC	12	-	2	TGGTTG
gi|514486271|gb|KE346361.1|	1773786	1773799	AAGTCC	13	-	2	CTTGGA
gi|514486271|gb|KE346361.1|	1773975	1773991	A	16	+	16	A
gi|514486271|gb|KE346361.1|	1774027	1774040	AGG	13	-	4	TCC
gi|514486271|gb|KE346361.1|	1774169	1774181	AG	12	+	6	AG
gi|514486271|gb|KE346361.1|	1774258	1774270	AAAG	12	-	3	TTCT
gi|514486271|gb|KE346361.1|	1774720	1774732	ACGCCG	12	-	2	CGGCGT
gi|514486271|gb|KE346361.1|	1776424	1776436	AACCC	12	+	2	CCCAA
gi|514486271|gb|KE346361.1|	1776586	1776599	AAGCGC	13	-	2	GCGCTT
gi|514486271|gb|KE346361.1|	1776796	1776813	ACAGCC	17	-	2	GTGGCT
gi|514486271|gb|KE346361.1|	1778352	1778365	AATC	13	+	3	CAAT
gi|514486271|gb|KE346361.1|	1779741	1779753	A	12	-	12	T
gi|514486271|gb|KE346361.1|	1780205	1780219	AAAAT	14	-	2	TTTTA
gi|514486271|gb|KE346361.1|	1780218	1780232	AAAAT	14	-	2	TTTTA
gi|514486271|gb|KE346361.1|	1780284	1780301	AAC	17	+	5	AAC
gi|514486271|gb|KE346361.1|	1780449	1780463	AAAAAT	14	-	2	TTTTAT
gi|514486271|gb|KE346361.1|	1780870	1780882	CCCCCG	12	-	2	CGGGGG
gi|514486271|gb|KE346361.1|	1781008	1781024	AAAAC	16	-	3	TTGTT
gi|514486271|gb|KE346361.1|	1781087	1781102	AAATCC	15	+	2	CCAAAT
gi|514486271|gb|KE346361.1|	1781513	1781530	AGGCCG	17	-	2	CCTCGG
gi|514486271|gb|KE346361.1|	1783537	1783550	AATGGC	13	-	2	ATTGCC
gi|514486271|gb|KE346361.1|	1784194	1784206	AAAACC	12	-	2	TTTTGG
gi|514486271|gb|KE346361.1|	1784409	1784424	A	15	-	15	T
gi|514486271|gb|KE346361.1|	1784916	1784945	AAAC	29	-	7	TGTT
gi|514486271|gb|KE346361.1|	1785660	1785672	ACGCTG	12	-	2	GCGTCA
gi|514486271|gb|KE346361.1|	1786246	1786258	AAAC	12	-	3	GTTT
gi|514486271|gb|KE346361.1|	1786564	1786584	AGC	20	-	6	GCT
gi|514486271|gb|KE346361.1|	1786594	1786616	AGC	22	-	7	GCT
gi|514486271|gb|KE346361.1|	1786705	1786717	AGC	12	-	4	GCT
gi|514486271|gb|KE346361.1|	1787239	1787255	AAC	16	-	5	TTG
gi|514486271|gb|KE346361.1|	1787570	1787582	AAAAC	12	-	2	TTTGT
gi|514486271|gb|KE346361.1|	1787598	1787612	AAAAC	14	-	2	TTTTG
gi|514486271|gb|KE346361.1|	1789243	1789258	AC	15	-	7	TG
gi|514486271|gb|KE346361.1|	1790356	1790368	AAGTCC	12	-	2	ACTTGG
gi|514486271|gb|KE346361.1|	1790468	1790489	AG	21	+	10	GA
gi|514486271|gb|KE346361.1|	1790883	1790896	A	13	+	13	A
gi|514486271|gb|KE346361.1|	1791818	1791831	AGC	13	+	4	CAG
gi|514486271|gb|KE346361.1|	1791826	1791838	AGCGGC	12	+	2	GCAGCG
gi|514486271|gb|KE346361.1|	1792336	1792350	AAACC	14	-	2	TTTGG
gi|514486271|gb|KE346361.1|	1792415	1792427	AGC	12	+	4	AGC
gi|514486271|gb|KE346361.1|	1792617	1792641	A	24	+	24	A
gi|514486271|gb|KE346361.1|	1792929	1792941	AAAAAC	12	+	2	CAAAAA
gi|514486271|gb|KE346361.1|	1822583	1822595	A	12	-	12	T
gi|514486271|gb|KE346361.1|	1822616	1822655	AC	39	-	19	TG
gi|514486271|gb|KE346361.1|	1823787	1823799	AAAAAG	12	-	2	CTTTTT
gi|514486271|gb|KE346361.1|	1824240	1824252	AACTTC	12	-	2	AAGTTG
gi|514486271|gb|KE346361.1|	1824719	1824736	AAC	17	-	5	GTT
gi|514486271|gb|KE346361.1|	1824907	1824946	AC	39	-	19	TG
gi|514486271|gb|KE346361.1|	1826077	1826089	AAAAAG	12	-	2	CTTTTT
gi|514486271|gb|KE346361.1|	1826516	1826528	AAACAG	12	-	2	CTGTTT
gi|514486271|gb|KE346361.1|	1827476	1827488	AAAGTG	12	+	2	AAGTGA
gi|514486271|gb|KE346361.1|	1827663	1827675	AAACCC	12	+	2	CAAACC
gi|514486271|gb|KE346361.1|	1832914	1832926	ACATCT	12	+	2	TCTACA
gi|514486271|gb|KE346361.1|	1834347	1834363	AAGATG	16	+	2	GATGAA
gi|514486271|gb|KE346361.1|	1837537	1837550	AACAGC	13	+	2	CAGCAA
gi|514486271|gb|KE346361.1|	1838367	1838385	ACG	18	+	6	CGA
gi|514486271|gb|KE346361.1|	1838695	1838708	AGAGCG	13	+	2	AGAGCG
gi|514486271|gb|KE346361.1|	1839031	1839046	AGGGGG	15	+	2	GGGGAG
gi|514486271|gb|KE346361.1|	1839427	1839439	AAG	12	+	4	GAA
gi|514486271|gb|KE346361.1|	1839795	1839812	AAGTCC	17	+	2	TCCAAG
gi|514486271|gb|KE346361.1|	1840466	1840478	A	12	-	12	T
gi|514486271|gb|KE346361.1|	1840692	1840704	ATCCCC	12	+	2	TCCCCA
gi|514486271|gb|KE346361.1|	1841160	1841174	ACCACT	14	-	2	GTGGTA
gi|514486271|gb|KE346361.1|	1841341	1841353	AGCGCG	12	+	2	CGAGCG
gi|514486271|gb|KE346361.1|	1841459	1841476	ACGATC	17	-	2	CGTGAT
gi|514486271|gb|KE346361.1|	1841483	1841498	AGAGCG	15	+	2	GAGCGA
gi|514486271|gb|KE346361.1|	1841557	1841585	AGC	28	-	9	TGC
gi|514486271|gb|KE346361.1|	1841636	1841653	ACGCTC	17	-	2	CGTGAG
gi|514486271|gb|KE346361.1|	1841982	1841995	ATCGCG	13	+	2	GCGATC
gi|514486271|gb|KE346361.1|	1842072	1842084	CCGCG	12	+	2	CGCCG
gi|514486271|gb|KE346361.1|	1842196	1842208	AACGGG	12	-	2	CCCGTT
gi|514486271|gb|KE346361.1|	1842293	1842307	AATGGG	14	-	2	TTCCCA
gi|514486271|gb|KE346361.1|	1843816	1843832	AATCAG	16	+	2	AATCAG
gi|514486271|gb|KE346361.1|	1843858	1843877	AACAGC	19	+	3	CAGCAA
gi|514486271|gb|KE346361.1|	1844265	1844288	AAC	23	+	7	CAA
gi|514486271|gb|KE346361.1|	1844297	1844310	AAC	13	+	4	ACA
gi|514486271|gb|KE346361.1|	1844403	1844416	AATCC	13	+	2	AATCC
gi|514486271|gb|KE346361.1|	1844583	1844596	AAATC	13	+	2	CAAAT
gi|514486271|gb|KE346361.1|	1844904	1844916	AAGTGG	12	+	2	AAGTGG
gi|514486271|gb|KE346361.1|	1845046	1845059	AAAAC	13	+	2	AAACA
gi|514486271|gb|KE346361.1|	1845987	1846024	AG	37	+	18	AG
gi|514486271|gb|KE346361.1|	1846777	1846789	ACCCCC	12	+	2	ACCCCC
gi|514486271|gb|KE346361.1|	1846938	1846951	ACCC	13	+	3	CCAC
gi|514486271|gb|KE346361.1|	1847359	1847373	AAGGGG	14	-	2	TTCCCC
gi|514486271|gb|KE346361.1|	1847590	1847602	AACTTC	12	-	2	AAGTTG
gi|514486271|gb|KE346361.1|	1849259	1849277	A	18	-	18	T
gi|514486271|gb|KE346361.1|	1849303	1849315	ATCGCG	12	+	2	TCGCGA
gi|514486271|gb|KE346361.1|	1849356	1849371	AG	15	-	7	TC
gi|514486271|gb|KE346361.1|	1849679	1849697	A	18	+	18	A
gi|514486271|gb|KE346361.1|	1849801	1849814	AC	13	+	6	AC
gi|514486271|gb|KE346361.1|	1852075	1852091	ACG	16	-	5	CGT
gi|514486271|gb|KE346361.1|	1852099	1852112	AAGATG	13	-	2	CTTCAT
gi|514486271|gb|KE346361.1|	1852452	1852464	AACGGC	12	-	2	GCCGTT
gi|514486271|gb|KE346361.1|	1853740	1853772	AC	32	+	16	CA
gi|514486271|gb|KE346361.1|	1854471	1854483	ACTG	12	-	3	TCAG
gi|514486271|gb|KE346361.1|	1854777	1854798	A	21	+	21	A
gi|514486271|gb|KE346361.1|	1855255	1855267	AAGCCC	12	-	2	CTTGGG
gi|514486271|gb|KE346361.1|	1855299	1855311	AAGAGC	12	-	2	TTGCTC
gi|514486271|gb|KE346361.1|	1855759	1855786	AGC	27	+	9	CAG
gi|514486271|gb|KE346361.1|	1856659	1856675	AGCTCC	16	+	2	GCTCCA
gi|514486271|gb|KE346361.1|	1856680	1856692	AGC	12	+	4	CAG
gi|514486271|gb|KE346361.1|	1856791	1856816	AGC	25	+	8	CAG
gi|514486271|gb|KE346361.1|	1857112	1857127	AACACC	15	-	2	TGGTGT
gi|514486271|gb|KE346361.1|	1857480	1857498	ACCAGC	18	+	3	GCACCA
gi|514486271|gb|KE346361.1|	1857510	1857522	ACCAGC	12	+	2	GCACCA
gi|514486271|gb|KE346361.1|	1857718	1857737	AGCAGG	19	-	3	CTCCTG
gi|514486271|gb|KE346361.1|	1857814	1857826	AGCCCG	12	-	2	CGGGCT
gi|514486271|gb|KE346361.1|	1857823	1857838	AGC	15	-	5	GCT
gi|514486271|gb|KE346361.1|	1857965	1857977	AAAC	12	-	3	TGTT
gi|514486271|gb|KE346361.1|	1858024	1858043	A	19	+	19	A
gi|514486271|gb|KE346361.1|	1858194	1858206	A	12	+	12	A
gi|514486271|gb|KE346361.1|	1858447	1858462	AAAAG	15	-	3	TTTTC
gi|514486271|gb|KE346361.1|	1858595	1858617	ACCGAG	22	+	3	GACCGA
gi|514486271|gb|KE346361.1|	1859157	1859181	ATC	24	-	8	TGA
gi|514486271|gb|KE346361.1|	1859341	1859358	ACCGAG	17	+	2	GACCGA
gi|514486271|gb|KE346361.1|	1859353	1859376	ACCGCG	23	+	3	GACCGC
gi|514486271|gb|KE346361.1|	1859393	1859406	ACCGAG	13	+	2	GAGACC
gi|514486271|gb|KE346361.1|	1859530	1859550	AAGCCG	20	+	3	CGAAGC
gi|514486271|gb|KE346361.1|	1859554	1859577	AGCCGC	23	+	3	CGCAGC
gi|514486271|gb|KE346361.1|	1859604	1859616	AGAGCG	12	-	2	CTCTCG
gi|514486271|gb|KE346361.1|	1859942	1859955	ACAGTC	13	-	2	TGACTG
gi|514486271|gb|KE346361.1|	1860351	1860365	AG	14	-	7	TC
gi|514486271|gb|KE346361.1|	1861298	1861317	A	19	-	19	T
gi|514486271|gb|KE346361.1|	1861906	1861919	AAGGCC	13	+	2	GCCAAG
gi|514486271|gb|KE346361.1|	1862096	1862110	A	14	+	14	A
gi|514486271|gb|KE346361.1|	1862579	1862591	ACCTCG	12	-	2	GGTCGA
gi|514486271|gb|KE346361.1|	1862750	1862767	AAAAAG	17	+	2	AAAAAG
gi|514486271|gb|KE346361.1|	1864124	1864138	AC	14	-	7	TG
gi|514486271|gb|KE346361.1|	1864375	1864394	A	19	-	19	T
gi|514486271|gb|KE346361.1|	1865345	1865388	ACC	43	-	14	GGT
gi|514486271|gb|KE346361.1|	1865789	1865808	AGGG	19	-	4	CCCT
gi|514486271|gb|KE346361.1|	1865816	1865828	AACCTC	12	+	2	TCAACC
gi|514486271|gb|KE346361.1|	1866256	1866271	A	15	-	15	T
gi|514486271|gb|KE346361.1|	1867356	1867442	AC	86	-	43	GT
gi|514486271|gb|KE346361.1|	1867639	1867653	AGCTGC	14	+	2	GCTGCA
gi|514486271|gb|KE346361.1|	1867931	1867943	AAGGTC	12	+	2	TCAAGG
gi|514486271|gb|KE346361.1|	1868418	1868432	AAAC	14	+	3	CAAA
gi|514486271|gb|KE346361.1|	1869634	1869646	AACCTC	12	+	2	CAACCT
gi|514486271|gb|KE346361.1|	1869883	1869895	ACATCC	12	+	2	CACATC
gi|514486271|gb|KE346361.1|	1870321	1870338	AGCGC	17	-	3	GCTGC
gi|514486271|gb|KE346361.1|	1870334	1870347	CCGCG	13	+	2	GCGCC
gi|514486271|gb|KE346361.1|	1870997	1871010	ACG	13	-	4	GTC
gi|514486271|gb|KE346361.1|	1871615	1871627	AGATGG	12	+	2	ATGGAG
gi|514486271|gb|KE346361.1|	1872642	1872654	AAAAC	12	-	2	TTTGT
gi|514486271|gb|KE346361.1|	1873017	1873031	AGC	14	+	4	AGC
gi|514486271|gb|KE346361.1|	1875818	1875889	AAAC	71	+	17	AAAC
gi|514486271|gb|KE346361.1|	1875886	1875901	A	15	+	15	A
gi|514486271|gb|KE346361.1|	1876279	1876293	AAAGTC	14	-	2	ACTTTG
gi|514486271|gb|KE346361.1|	1876570	1876582	AAGCCC	12	+	2	CAAGCC
gi|514486271|gb|KE346361.1|	1877039	1877051	AAGGAC	12	+	2	ACAAGG
gi|514486271|gb|KE346361.1|	1878888	1878901	ACGCCC	13	-	2	GGGCGT
gi|514486271|gb|KE346361.1|	1879099	1879111	AACAC	12	+	2	AACAC
gi|514486271|gb|KE346361.1|	1879274	1879288	AAC	14	+	4	AAC
gi|514486271|gb|KE346361.1|	1879901	1879917	AAC	16	+	5	ACA
gi|514486271|gb|KE346361.1|	1880531	1880552	AATG	21	+	5	GAAT
gi|514486271|gb|KE346361.1|	1880856	1880868	A	12	-	12	T
gi|514486271|gb|KE346361.1|	1880936	1880956	A	20	-	20	T
gi|514486271|gb|KE346361.1|	1881091	1881111	A	20	+	20	A
gi|514486271|gb|KE346361.1|	1881208	1881220	ACACGC	12	+	2	CGCACA
gi|514486271|gb|KE346361.1|	1881279	1881291	AAAGC	12	+	2	AGCAA
gi|514486271|gb|KE346361.1|	1881315	1881332	A	17	+	17	A
gi|514486271|gb|KE346361.1|	1881544	1881561	AAAAAG	17	+	2	AAAAAG
gi|514486271|gb|KE346361.1|	1881556	1881569	A	13	+	13	A
gi|514486271|gb|KE346361.1|	1882009	1882021	A	12	-	12	T
gi|514486271|gb|KE346361.1|	1882025	1882044	AAAAAT	19	-	3	TATTTT
gi|514486271|gb|KE346361.1|	1882126	1882140	AC	14	-	7	TG
gi|514486271|gb|KE346361.1|	1882636	1882648	ACATG	12	+	2	TGACA
gi|514486271|gb|KE346361.1|	1883030	1883042	AAAAG	12	-	2	TTTTC
gi|514486271|gb|KE346361.1|	1883640	1883652	AAAAAC	12	-	2	GTTTTT
gi|514486271|gb|KE346361.1|	1883746	1883759	AAAAGC	13	-	2	TTTTGC
gi|514486271|gb|KE346361.1|	1883810	1883828	A	18	-	18	T
gi|514486271|gb|KE346361.1|	1883932	1883944	AGGGGG	12	+	2	GGGGGA
gi|514486271|gb|KE346361.1|	1884071	1884089	A	18	-	18	T
gi|514486271|gb|KE346361.1|	1884155	1884167	ACCTCG	12	+	2	TCGACC
gi|514486271|gb|KE346361.1|	1884367	1884379	ACGGCG	12	-	2	CCGTCG
gi|514486271|gb|KE346361.1|	1884579	1884591	ATC	12	-	4	ATG
gi|514486271|gb|KE346361.1|	1884710	1884728	A	18	-	18	T
gi|514486271|gb|KE346361.1|	1884979	1885001	A	22	-	22	T
gi|514486271|gb|KE346361.1|	1885017	1885029	AAAG	12	-	3	TTTC
gi|514486271|gb|KE346361.1|	1885158	1885171	AGCGC	13	-	2	GCGCT
gi|514486271|gb|KE346361.1|	1887617	1887629	AGCGCG	12	+	2	GAGCGC
gi|514486271|gb|KE346361.1|	1888118	1888132	AGAGGG	14	-	2	CTCTCC
gi|514486271|gb|KE346361.1|	1888434	1888449	AACGAC	15	+	2	AACGAC
gi|514486271|gb|KE346361.1|	1888444	1888459	AAC	15	+	5	ACA
gi|514486271|gb|KE346361.1|	1890008	1890023	AC	15	+	7	CA
gi|514486271|gb|KE346361.1|	1890067	1890082	AAAAAC	15	+	2	AAAACA
gi|514486271|gb|KE346361.1|	1890208	1890220	ACGCG	12	+	2	GACGC
gi|514486271|gb|KE346361.1|	1890288	1890303	AG	15	+	7	AG
gi|514486271|gb|KE346361.1|	1890406	1890425	AG	19	+	9	AG
gi|514486271|gb|KE346361.1|	1890446	1890469	AG	23	+	11	GA
gi|514486271|gb|KE346361.1|	1890552	1890564	AAAAAC	12	+	2	AACAAA
gi|514486271|gb|KE346361.1|	1890566	1890580	A	14	+	14	A
gi|514486271|gb|KE346361.1|	1890804	1890829	A	25	-	25	T
gi|514486271|gb|KE346361.1|	1891137	1891152	AACAC	15	-	3	TGTTG
gi|514486271|gb|KE346361.1|	1891812	1891824	AAC	12	+	4	CAA
gi|514486271|gb|KE346361.1|	1891835	1891847	AAAAAG	12	+	2	GAAAAA
gi|514486271|gb|KE346361.1|	1891873	1891890	A	17	+	17	A
gi|514486271|gb|KE346361.1|	1892079	1892093	AAAC	14	+	3	CAAA
gi|514486271|gb|KE346361.1|	1892131	1892143	AAAC	12	+	3	ACAA
gi|514486271|gb|KE346361.1|	1892760	1892784	AAG	24	+	8	GAA
gi|514486271|gb|KE346361.1|	1893443	1893460	AACAGC	17	-	2	TGTTGC
gi|514486271|gb|KE346361.1|	1894675	1894711	AGC	36	-	12	CTG
gi|514486271|gb|KE346361.1|	1894737	1894756	AAC	19	-	6	GTT
gi|514486271|gb|KE346361.1|	1894757	1894771	AAC	14	-	4	TGT
gi|514486271|gb|KE346361.1|	1894769	1894786	AGC	17	-	5	TGC
gi|514486271|gb|KE346361.1|	1895460	1895472	AC	12	+	6	CA
gi|514486271|gb|KE346361.1|	1895641	1895665	A	24	+	24	A
gi|514486271|gb|KE346361.1|	1895690	1895708	AAAAAT	18	+	3	AAAAAT
gi|514486271|gb|KE346361.1|	1895917	1895929	AACGAG	12	+	2	AACGAG
gi|514486271|gb|KE346361.1|	1895993	1896015	A	22	+	22	A
gi|514486271|gb|KE346361.1|	1896342	1896354	ACCC	12	-	3	GGGT
gi|514486271|gb|KE346361.1|	1896422	1896435	A	13	+	13	A
gi|514486271|gb|KE346361.1|	1896440	1896452	A	12	+	12	A
gi|514486271|gb|KE346361.1|	1896545	1896571	A	26	-	26	T
gi|514486271|gb|KE346361.1|	1896731	1896743	A	12	+	12	A
gi|514486271|gb|KE346361.1|	1896738	1896751	AAAAAG	13	+	2	AAAAAG
gi|514486271|gb|KE346361.1|	1896751	1896765	A	14	-	14	T
gi|514486271|gb|KE346361.1|	1896846	1896858	AAAAGC	12	+	2	AAGCAA
gi|514486271|gb|KE346361.1|	1896973	1897028	A	55	-	55	T
gi|514486271|gb|KE346361.1|	1897315	1897335	AGG	20	+	6	GAG
gi|514486271|gb|KE346361.1|	1897330	1897344	AAGAGG	14	+	2	GAGGAA
gi|514486271|gb|KE346361.1|	1897382	1897395	A	13	+	13	A
gi|514486271|gb|KE346361.1|	1897514	1897526	AAAAG	12	+	2	AAGAA
gi|514486271|gb|KE346361.1|	1898041	1898054	AATGTC	13	-	2	TGACAT
gi|514486271|gb|KE346361.1|	1898081	1898130	AGC	49	+	16	GCA
gi|514486271|gb|KE346361.1|	1898680	1898697	ACAG	17	+	4	CAGA
gi|514486271|gb|KE346361.1|	1899336	1899354	AGC	18	+	6	AGC
gi|514486271|gb|KE346361.1|	1899733	1899755	A	22	+	22	A
gi|514486271|gb|KE346361.1|	1900208	1900235	A	27	+	27	A
gi|514486271|gb|KE346361.1|	1900895	1900907	AACGGC	12	+	2	GCAACG
gi|514486271|gb|KE346361.1|	1901776	1901790	AATGC	14	+	2	CAATG
gi|514486271|gb|KE346361.1|	1902583	1902597	AGAGGC	14	+	2	GGCAGA
gi|514486271|gb|KE346361.1|	1902869	1902881	ACGCCC	12	+	2	CCACGC
gi|514486271|gb|KE346361.1|	1903088	1903105	AAGGAC	17	-	2	TCCTTG
gi|514486271|gb|KE346361.1|	1903111	1903135	AAGGAG	24	-	4	CTCCTT
gi|514486271|gb|KE346361.1|	1903136	1903149	AAGGAG	13	-	2	TCCTTC
gi|514486271|gb|KE346361.1|	1903398	1903428	AG	30	+	15	AG
gi|514486271|gb|KE346361.1|	1903743	1903757	A	14	+	14	A
gi|514486271|gb|KE346361.1|	1904016	1904028	AATGTC	12	+	2	TGTCAA
gi|514486271|gb|KE346361.1|	1904723	1904742	AGC	19	-	6	GCT
gi|514486271|gb|KE346361.1|	1905730	1905742	AAACAC	12	+	2	CAAACA
gi|514486271|gb|KE346361.1|	1906280	1906292	AAGTCC	12	+	2	CCAAGT
gi|514486271|gb|KE346361.1|	1907498	1907514	AGC	16	-	5	GCT
gi|514486271|gb|KE346361.1|	1907509	1907523	AACAGC	14	-	2	TGCTGT
gi|514486271|gb|KE346361.1|	1907893	1907907	AG	14	+	7	AG
gi|514486271|gb|KE346361.1|	1907902	1907914	AGAGGG	12	+	2	GAGAGG
gi|514486271|gb|KE346361.1|	1909236	1909253	A	17	+	17	A
gi|514486271|gb|KE346361.1|	1909248	1909263	AAAAAC	15	+	2	AAAAAC
gi|514486271|gb|KE346361.1|	1909520	1909532	ACGTCC	12	-	2	TGGACG
gi|514486271|gb|KE346361.1|	1909814	1909826	ATCCCC	12	-	2	GGATGG
gi|514486271|gb|KE346361.1|	1911152	1911164	AGC	12	-	4	GCT
gi|514486271|gb|KE346361.1|	1911162	1911175	AAG	13	-	4	CTT
gi|514486271|gb|KE346361.1|	1911867	1911879	ACCCC	12	-	2	GTGGG
gi|514486271|gb|KE346361.1|	1912715	1912728	ACTGAG	13	-	2	TCTCAG
gi|514486271|gb|KE346361.1|	1913148	1913160	AACAAG	12	+	2	ACAAGA
gi|514486271|gb|KE346361.1|	1913515	1913549	ATC	34	-	11	ATG
gi|514486271|gb|KE346361.1|	1913574	1913587	ACGAGG	13	+	2	GACGAG
gi|514486271|gb|KE346361.1|	1913898	1913910	AGCG	12	-	3	GCTC
gi|514486271|gb|KE346361.1|	1914194	1914207	AAACAC	13	-	2	TTTGTG
gi|514486271|gb|KE346361.1|	1914202	1914219	AC	17	-	8	TG
gi|514486271|gb|KE346361.1|	1914448	1914460	AAATTG	12	+	2	TTGAAA
gi|514486271|gb|KE346361.1|	1914913	1914925	AATATC	12	-	2	ATTGAT
gi|514486271|gb|KE346361.1|	1915762	1915776	AAGG	14	-	3	TTCC
gi|514486271|gb|KE346361.1|	1916733	1916745	ACGATG	12	+	2	CGATGA
gi|514486271|gb|KE346361.1|	1917376	1917388	AACAC	12	+	2	AACAC
gi|514486271|gb|KE346361.1|	1917425	1917438	AAAGTC	13	+	2	TCAAAG
gi|514486271|gb|KE346361.1|	1917899	1917911	AAAGCC	12	-	2	GGCTTT
gi|514486271|gb|KE346361.1|	1918252	1918268	AAAACC	16	-	2	TTGGTT
gi|514486271|gb|KE346361.1|	1918895	1918909	AACATC	14	-	2	TGATGT
gi|514486271|gb|KE346361.1|	1919394	1919409	A	15	+	15	A
gi|514486271|gb|KE346361.1|	1921395	1921407	ATGC	12	+	3	ATGC
gi|514486271|gb|KE346361.1|	1921521	1921533	AAAAAC	12	-	2	TTTTGT
gi|514486271|gb|KE346361.1|	1921832	1921848	AAAC	16	+	4	AAAC
gi|514486271|gb|KE346361.1|	1921851	1921865	AAAAC	14	+	2	AAAAC
gi|514486271|gb|KE346361.1|	1922474	1922487	AG	13	+	6	AG
gi|514486271|gb|KE346361.1|	1924008	1924020	A	12	+	12	A
gi|514486271|gb|KE346361.1|	1924970	1924982	AAAATG	12	-	2	TTTTCA
gi|514486271|gb|KE346361.1|	1925936	1925949	ACC	13	+	4	ACC
gi|514486271|gb|KE346361.1|	1926726	1926738	AGCGGC	12	-	2	TGCCGC
gi|514486271|gb|KE346361.1|	1926744	1926756	AATCGC	12	-	2	CGATTG
gi|514486271|gb|KE346361.1|	1927646	1927659	A	13	-	13	T
gi|514486271|gb|KE346361.1|	1927676	1927697	A	21	-	21	T
gi|514486271|gb|KE346361.1|	1927953	1927965	ATC	12	+	4	TCA
gi|514486271|gb|KE346361.1|	1927993	1928005	A	12	-	12	T
gi|514486271|gb|KE346361.1|	1928791	1928803	AACGAG	12	-	2	TCTCGT
gi|514486271|gb|KE346361.1|	1929125	1929137	AACGTC	12	+	2	GTCAAC
gi|514486271|gb|KE346361.1|	1929310	1929331	A	21	-	21	T
gi|514486271|gb|KE346361.1|	1929630	1929643	AAACAG	13	-	2	TGTTTC
gi|514486271|gb|KE346361.1|	1930011	1930023	AGC	12	-	4	TGC
gi|514486271|gb|KE346361.1|	1930827	1930839	AAAACG	12	+	2	GAAAAC
gi|514486271|gb|KE346361.1|	1931291	1931305	A	14	-	14	T
gi|514486271|gb|KE346361.1|	1931301	1931313	AAAAG	12	-	2	TTTTC
gi|514486271|gb|KE346361.1|	1931452	1931464	ACCGCC	12	+	2	CCGCCA
gi|514486271|gb|KE346361.1|	1934519	1934533	AACGGC	14	+	2	CAACGG
gi|514486271|gb|KE346361.1|	1935119	1935131	AAAAC	12	+	2	CAAAA
gi|514486271|gb|KE346361.1|	1936120	1936132	AAAC	12	+	3	CAAA
gi|514486271|gb|KE346361.1|	1936757	1936770	ACCTCC	13	+	2	TCCACC
gi|514486271|gb|KE346361.1|	1937860	1937872	AAGCGC	12	+	2	GCAAGC
gi|514486271|gb|KE346361.1|	1938890	1938908	A	18	+	18	A
gi|514486271|gb|KE346361.1|	1938910	1938927	A	17	+	17	A
gi|514486271|gb|KE346361.1|	1938933	1938947	AAAC	14	+	3	AACA
gi|514486271|gb|KE346361.1|	1940035	1940049	ACTCGG	14	-	2	GTCCGA
gi|514486271|gb|KE346361.1|	1940235	1940250	AAAAAT	15	+	2	AAATAA
gi|514486271|gb|KE346361.1|	1940287	1940306	A	19	-	19	T
gi|514486271|gb|KE346361.1|	1940326	1940350	AG	24	-	12	TC
gi|514486271|gb|KE346361.1|	1940360	1940375	AAAGAG	15	-	2	TCTTTC
gi|514486271|gb|KE346361.1|	1940603	1940615	AAGAGT	12	+	2	AGAGTA
gi|514486271|gb|KE346361.1|	1940892	1940905	AGCAGG	13	-	2	TCCTGC
gi|514486271|gb|KE346361.1|	1940921	1940935	AGC	14	-	4	CTG
gi|514486271|gb|KE346361.1|	1940966	1940978	ACCGCC	12	+	2	CACCGC
gi|514486271|gb|KE346361.1|	1942969	1942981	AAACTC	12	+	2	CTCAAA
gi|514486271|gb|KE346361.1|	1944844	1944904	AGC	60	+	20	CAG
gi|514486271|gb|KE346361.1|	1944950	1944965	AGCAGG	15	+	2	CAGGAG
gi|514486271|gb|KE346361.1|	1944960	1944985	AGC	25	+	8	AGC
gi|514486271|gb|KE346361.1|	1944983	1944997	AAC	14	+	4	CAA
gi|514486271|gb|KE346361.1|	1945166	1945179	AATCGC	13	-	2	TTGCGA
gi|514486271|gb|KE346361.1|	1948110	1948122	AGC	12	+	4	CAG
gi|514486271|gb|KE346361.1|	1948141	1948155	AGC	14	-	4	CTG
gi|514486271|gb|KE346361.1|	1948941	1948953	AAC	12	-	4	TTG
gi|514486271|gb|KE346361.1|	1949744	1949758	AGC	14	+	4	GCA
gi|514486271|gb|KE346361.1|	1949869	1949889	AGCGGC	20	-	3	CGCTGC
gi|514486271|gb|KE346361.1|	1950468	1950522	AAAAGC	54	+	9	AAGCAA
gi|514486271|gb|KE346361.1|	1950715	1950730	AAGCAG	15	-	2	CTGCTT
gi|514486271|gb|KE346361.1|	1950731	1950743	AGC	12	-	4	TGC
gi|514486271|gb|KE346361.1|	1952240	1952252	ACTCG	12	-	2	CGAGT
gi|514486271|gb|KE346361.1|	1952810	1952823	AAGGTC	13	-	2	CCTTGA
gi|514486271|gb|KE346361.1|	1953743	1953764	ACCAGC	21	-	3	TGGTGC
gi|514486271|gb|KE346361.1|	1954912	1954924	AAATC	12	-	2	GATTT
gi|514486271|gb|KE346361.1|	1955327	1955339	AAGTAC	12	+	2	CAAGTA
gi|514486271|gb|KE346361.1|	1956843	1956857	AAAG	14	+	3	AAAG
gi|514486271|gb|KE346361.1|	1957274	1957286	AGGCG	12	-	2	CCTCG
gi|514486271|gb|KE346361.1|	1957506	1957521	AAAAAC	15	-	2	TTTGTT
gi|514486271|gb|KE346361.1|	1957593	1957610	ACGC	17	+	4	CACG
gi|514486271|gb|KE346361.1|	1957703	1957725	AG	22	-	11	TC
gi|514486271|gb|KE346361.1|	1957908	1957920	AGGG	12	-	3	CCCT
gi|514486271|gb|KE346361.1|	1958062	1958082	A	20	-	20	T
gi|514486271|gb|KE346361.1|	1958216	1958235	A	19	-	19	T
gi|514486271|gb|KE346361.1|	1958570	1958582	CCG	12	-	4	GCG
gi|514486271|gb|KE346361.1|	1959033	1959051	A	18	+	18	A
gi|514486271|gb|KE346361.1|	1959096	1959109	AAAGAG	13	-	2	TCTCTT
gi|514486271|gb|KE346361.1|	1959465	1959479	A	14	-	14	T
gi|514486271|gb|KE346361.1|	1959488	1959500	A	12	-	12	T
gi|514486271|gb|KE346361.1|	1960020	1960047	AGAGGG	27	-	4	TCTCCC
gi|514486271|gb|KE346361.1|	1960568	1960581	AAGGGC	13	+	2	CAAGGG
gi|514486271|gb|KE346361.1|	1960767	1960781	AACAGC	14	+	2	CAACAG
gi|514486271|gb|KE346361.1|	1960785	1960799	AGC	14	+	4	CAG
gi|514486271|gb|KE346361.1|	1960878	1960892	AGCGGC	14	-	2	GCCGCT
gi|514486271|gb|KE346361.1|	1961288	1961303	AGC	15	+	5	GCA
gi|514486271|gb|KE346361.1|	1961298	1961310	AACAGC	12	+	2	CAGCAA
gi|514486271|gb|KE346361.1|	1961756	1961768	AAAAG	12	+	2	AAGAA
gi|514486271|gb|KE346361.1|	1961849	1961863	ACG	14	-	4	CGT
gi|514486271|gb|KE346361.1|	1961980	1961993	AACGAC	13	-	2	TCGTTG
gi|514486271|gb|KE346361.1|	1962060	1962073	A	13	-	13	T
gi|514486271|gb|KE346361.1|	1962360	1962372	AAAAAC	12	-	2	TTTTTG
gi|514486271|gb|KE346361.1|	1962545	1962557	AGG	12	-	4	CCT
gi|514486271|gb|KE346361.1|	1962787	1962801	AAC	14	+	4	AAC
gi|514486271|gb|KE346361.1|	1963023	1963040	AAC	17	-	5	TTG
gi|514486271|gb|KE346361.1|	1963455	1963467	AACTCC	12	+	2	TCCAAC
gi|514486271|gb|KE346361.1|	1965721	1965733	ACCATG	12	-	2	TCATGG
gi|514486271|gb|KE346361.1|	1966256	1966268	AGCTCG	12	+	2	CGAGCT
gi|514486271|gb|KE346361.1|	1966297	1966310	ACACTG	13	+	2	ACACTG
gi|514486271|gb|KE346361.1|	1966420	1966434	AAAC	14	-	3	TTGT
gi|514486271|gb|KE346361.1|	1966435	1966447	AAAC	12	-	3	TTTG
gi|514486271|gb|KE346361.1|	1966448	1966463	AAAC	15	-	3	TTGT
gi|514486271|gb|KE346361.1|	1970204	1970239	AG	35	-	17	TC
gi|514486271|gb|KE346361.1|	1970240	1970423	AG	183	-	91	TC
gi|514486271|gb|KE346361.1|	1970467	1970481	ACGCCG	14	-	2	CGGCGT
gi|514486271|gb|KE346361.1|	1970499	1970515	AGC	16	+	5	AGC
gi|514486271|gb|KE346361.1|	1970664	1970677	AGC	13	+	4	CAG
gi|514486271|gb|KE346361.1|	1970714	1970727	AGCTGC	13	+	2	GCAGCT
gi|514486271|gb|KE346361.1|	1970728	1970745	AGC	17	+	5	AGC
gi|514486271|gb|KE346361.1|	1971452	1971473	ACC	21	-	7	TGG
gi|514486271|gb|KE346361.1|	1971657	1971669	A	12	-	12	T
gi|514486271|gb|KE346361.1|	1971827	1971840	AAAAAC	13	-	2	TTTTGT
gi|514486271|gb|KE346361.1|	1971835	1971847	AAC	12	-	4	TTG
gi|514486271|gb|KE346361.1|	1972009	1972024	AAAC	15	-	3	TTTG
gi|514486271|gb|KE346361.1|	1972037	1972050	AAAACG	13	-	2	TTTTCG
gi|514486271|gb|KE346361.1|	1972305	1972319	ACG	14	-	4	TCG
gi|514486271|gb|KE346361.1|	1972522	1972534	AAAAAC	12	-	2	TGTTTT
gi|514486271|gb|KE346361.1|	1972636	1972648	ACAGAG	12	-	2	TGTCTC
gi|514486271|gb|KE346361.1|	1972737	1972749	ACG	12	-	4	CGT
gi|514486271|gb|KE346361.1|	1973501	1973534	AG	33	-	16	CT
gi|514486271|gb|KE346361.1|	1973756	1973772	AGC	16	-	5	GCT
gi|514486271|gb|KE346361.1|	1973909	1973921	AGCATG	12	-	2	TGCTCA
gi|514486271|gb|KE346361.1|	1974731	1974743	A	12	-	12	T
gi|514486271|gb|KE346361.1|	1974788	1974801	A	13	-	13	T
gi|514486271|gb|KE346361.1|	1974803	1974816	A	13	-	13	T
gi|514486271|gb|KE346361.1|	1974978	1974990	ACAGGC	12	+	2	GGCACA
gi|514486271|gb|KE346361.1|	1975313	1975329	ACC	16	+	5	CCA
gi|514486271|gb|KE346361.1|	1975924	1975979	AGC	55	+	18	AGC
gi|514486271|gb|KE346361.1|	1975993	1976007	CCGGCG	14	+	2	CCGGCG
gi|514486271|gb|KE346361.1|	1976297	1976314	ACCGCC	17	+	2	CCACCG
gi|514486271|gb|KE346361.1|	1976309	1976327	ACC	18	+	6	CCA
gi|514486271|gb|KE346361.1|	1977599	1977614	AGC	15	+	5	GCA
gi|514486271|gb|KE346361.1|	1978077	1978089	AACACG	12	-	2	TTCGTG
gi|514486271|gb|KE346361.1|	1978383	1978396	AAATTG	13	+	2	AAATTG
gi|514486271|gb|KE346361.1|	1978397	1978410	A	13	-	13	T
gi|514486271|gb|KE346361.1|	1978966	1978978	AAC	12	-	4	TTG
gi|514486271|gb|KE346361.1|	1979335	1979355	ATC	20	-	6	TGA
gi|514486271|gb|KE346361.1|	1980246	1980258	AG	12	-	6	TC
gi|514486271|gb|KE346361.1|	1980397	1980415	A	18	+	18	A
gi|514486271|gb|KE346361.1|	1980623	1980642	A	19	-	19	T
gi|514486271|gb|KE346361.1|	1980815	1980828	A	13	-	13	T
gi|514486271|gb|KE346361.1|	1980852	1980868	A	16	-	16	T
gi|514486271|gb|KE346361.1|	1981182	1981194	A	12	-	12	T
gi|514486271|gb|KE346361.1|	1981240	1981254	AAAG	14	+	3	GAAA
gi|514486271|gb|KE346361.1|	1981442	1981454	ACACGG	12	-	2	CCGTGT
gi|514486271|gb|KE346361.1|	1981719	1981732	AAC	13	+	4	ACA
gi|514486271|gb|KE346361.1|	1981959	1981972	ACGCCC	13	-	2	TGGGCG
gi|514486271|gb|KE346361.1|	1982594	1982613	ACGCG	19	+	3	CGACG
gi|514486271|gb|KE346361.1|	1982705	1982717	C	12	+	12	C
gi|514486271|gb|KE346361.1|	1982995	1983008	AG	13	+	6	GA
gi|514486271|gb|KE346361.1|	1983186	1983198	AG	12	+	6	AG
gi|514486271|gb|KE346361.1|	1983434	1983452	A	18	+	18	A
gi|514486271|gb|KE346361.1|	1984224	1984240	AAG	16	-	5	CTT
gi|514486271|gb|KE346361.1|	1984573	1984593	A	20	-	20	T
gi|514486271|gb|KE346361.1|	1986010	1986022	AAAAC	12	-	2	TTTTG
gi|514486271|gb|KE346361.1|	1986134	1986151	AAAAG	17	-	3	TTCTT
gi|514486271|gb|KE346361.1|	1986162	1986178	AAAAG	16	-	3	TTCTT
gi|514486271|gb|KE346361.1|	1986281	1986295	AAAAT	14	-	2	TTTTA
gi|514486271|gb|KE346361.1|	1986302	1986314	A	12	-	12	T
gi|514486271|gb|KE346361.1|	1986312	1986329	AAT	17	-	5	TTA
gi|514486271|gb|KE346361.1|	1986367	1986379	AAAAAC	12	-	2	TTTTGT
gi|514486271|gb|KE346361.1|	1986451	1986463	A	12	-	12	T
gi|514486271|gb|KE346361.1|	1986484	1986496	AAG	12	-	4	CTT
gi|514486271|gb|KE346361.1|	1986629	1986647	A	18	-	18	T
gi|514486271|gb|KE346361.1|	1986797	1986809	A	12	+	12	A
gi|514486271|gb|KE346361.1|	1986871	1986884	AAAAAT	13	-	2	TTTATT
gi|514486271|gb|KE346361.1|	1987098	1987121	ACAGAG	23	-	3	TCTCTG
gi|514486271|gb|KE346361.1|	1987522	1987534	AGCGCC	12	-	2	GCTGGC
gi|514486271|gb|KE346361.1|	1987931	1987944	AAG	13	-	4	CTT
gi|514486271|gb|KE346361.1|	1987951	1987968	AAG	17	-	5	TCT
gi|514486271|gb|KE346361.1|	1989398	1989422	AGC	24	+	8	GCA
gi|514486271|gb|KE346361.1|	1989417	1989429	AACAGC	12	+	2	CAGCAA
gi|514486271|gb|KE346361.1|	1989653	1989665	ACACC	12	+	2	CACAC
gi|514486271|gb|KE346361.1|	1990770	1990782	AAAAC	12	+	2	CAAAA
gi|514486271|gb|KE346361.1|	1990795	1990813	A	18	+	18	A
gi|514486271|gb|KE346361.1|	1990875	1990889	ACCC	14	-	3	TGGG
gi|514486271|gb|KE346361.1|	1990987	1991003	AGCATC	16	+	2	AGCATC
gi|514486271|gb|KE346361.1|	1991074	1991201	AC	127	+	63	CA
gi|514486271|gb|KE346361.1|	1992113	1992125	ACCGCC	12	+	2	GCCACC
gi|514486271|gb|KE346361.1|	1992135	1992147	AGC	12	+	4	GCA
gi|514486271|gb|KE346361.1|	1992142	1992156	AACAGC	14	+	2	CAGCAA
gi|514486271|gb|KE346361.1|	1992202	1992215	ACC	13	-	4	GGT
gi|514486271|gb|KE346361.1|	1992947	1992959	A	12	-	12	T
gi|514486271|gb|KE346361.1|	1992977	1992989	AATC	12	-	3	GATT
gi|514486271|gb|KE346361.1|	1993242	1993256	AAAAAG	14	-	2	TTTTTC
gi|514486271|gb|KE346361.1|	1993276	1993288	AAAGAG	12	-	2	TTTCTC
gi|514486271|gb|KE346361.1|	1993408	1993427	AAAAG	19	-	3	TTTTC
gi|514486271|gb|KE346361.1|	1993571	1993584	AAAGAG	13	+	2	AAAGAG
gi|514486271|gb|KE346361.1|	1993605	1993617	A	12	-	12	T
gi|514486271|gb|KE346361.1|	1993612	1993635	AAAAAG	23	-	3	TTTTTC
gi|514486271|gb|KE346361.1|	1993808	1993820	A	12	-	12	T
gi|514486271|gb|KE346361.1|	1993823	1993836	AAAAG	13	-	2	TTTCT
gi|514486271|gb|KE346361.1|	1993832	1993844	A	12	-	12	T
gi|514486271|gb|KE346361.1|	1994065	1994077	A	12	-	12	T
gi|514486271|gb|KE346361.1|	1994123	1994136	A	13	-	13	T
gi|514486271|gb|KE346361.1|	1994141	1994153	AAAGAG	12	-	2	TCTCTT
gi|514486271|gb|KE346361.1|	1994193	1994205	AAGAGC	12	-	2	CTCTTG
gi|514486271|gb|KE346361.1|	1994319	1994343	A	24	+	24	A
gi|514486271|gb|KE346361.1|	1994410	1994422	AAAG	12	-	3	TCTT
gi|514486271|gb|KE346361.1|	1994426	1994440	AAG	14	-	4	TTC
gi|514486271|gb|KE346361.1|	1994559	1994572	AAAAGC	13	-	2	TTTTGC
gi|514486271|gb|KE346361.1|	1994585	1994606	A	21	-	21	T
gi|514486271|gb|KE346361.1|	1995322	1995334	ATGGCC	12	+	2	CATGGC
gi|514486271|gb|KE346361.1|	1995723	1995744	A	21	+	21	A
gi|514486271|gb|KE346361.1|	1996066	1996078	A	12	+	12	A
gi|514486271|gb|KE346361.1|	1996757	1996776	A	19	-	19	T
gi|514486271|gb|KE346361.1|	1997258	1997272	ACAGAG	14	-	2	TCTCTG
gi|514486271|gb|KE346361.1|	1997522	1997534	AAAAAT	12	+	2	AAATAA
gi|514486271|gb|KE346361.1|	1997696	1997710	ACG	14	-	4	TCG
gi|514486271|gb|KE346361.1|	1998095	1998107	ACACGC	12	-	2	TGTGCG
gi|514486271|gb|KE346361.1|	1998880	1998909	ACTGAG	29	+	4	AGACTG
gi|514486271|gb|KE346361.1|	1999237	1999254	AAAATG	17	-	2	TTTTCA
gi|514486271|gb|KE346361.1|	1999348	1999366	AAG	18	-	6	CTT
gi|514486271|gb|KE346361.1|	1999444	1999459	AACCCC	15	+	2	CAACCC
gi|514486271|gb|KE346361.1|	1999548	1999573	A	25	-	25	T
gi|514486271|gb|KE346361.1|	1999578	1999594	A	16	-	16	T
gi|514486271|gb|KE346361.1|	1999643	1999667	AAG	24	-	8	CTT
gi|514486271|gb|KE346361.1|	1999788	1999817	A	29	+	29	A
gi|514486271|gb|KE346361.1|	1999966	1999979	CCCCCG	13	-	2	GGCGGG
gi|514486271|gb|KE346361.1|	1999991	2000007	AC	16	-	8	TG
gi|514486271|gb|KE346361.1|	2000310	2000322	AAGGGG	12	-	2	TTCCCC
gi|514486271|gb|KE346361.1|	2000703	2000715	AGATGG	12	+	2	GAGATG
gi|514486271|gb|KE346361.1|	2001688	2001710	A	22	+	22	A
gi|514486271|gb|KE346361.1|	2002211	2002224	A	13	-	13	T
gi|514486271|gb|KE346361.1|	2002225	2002240	A	15	-	15	T
gi|514486271|gb|KE346361.1|	2002292	2002304	AGAGC	12	-	2	CTGCT
gi|514486271|gb|KE346361.1|	2002615	2002630	AACCCT	15	-	2	TTAGGG
gi|514486271|gb|KE346361.1|	2002935	2002947	A	12	-	12	T
gi|514486271|gb|KE346361.1|	2002977	2002996	A	19	-	19	T
gi|514486271|gb|KE346361.1|	2003139	2003154	A	15	+	15	A
gi|514486271|gb|KE346361.1|	2003174	2003186	AAGG	12	-	3	TCCT
gi|514486271|gb|KE346361.1|	2003311	2003331	A	20	+	20	A
gi|514486271|gb|KE346361.1|	2004445	2004457	A	12	-	12	T
gi|514486271|gb|KE346361.1|	2004511	2004527	AAG	16	-	5	TCT
gi|514486271|gb|KE346361.1|	2004739	2004753	A	14	-	14	T
gi|514486271|gb|KE346361.1|	2004755	2004771	A	16	-	16	T
gi|514486271|gb|KE346361.1|	2004974	2004987	AAAC	13	-	3	TGTT
gi|514486271|gb|KE346361.1|	2005168	2005180	A	12	+	12	A
gi|514486271|gb|KE346361.1|	2006698	2006710	AGCATC	12	+	2	CATCAG
gi|514486271|gb|KE346361.1|	2006832	2006844	AACAAG	12	-	2	TTCTTG
gi|514486271|gb|KE346361.1|	2008135	2008147	AAAC	12	+	3	AAAC
gi|514486271|gb|KE346361.1|	2008148	2008161	A	13	+	13	A
gi|514486271|gb|KE346361.1|	2008162	2008175	A	13	+	13	A
gi|514486271|gb|KE346361.1|	2008836	2008852	AAC	16	+	5	CAA
gi|514486271|gb|KE346361.1|	2008853	2008878	A	25	+	25	A
gi|514486271|gb|KE346361.1|	2009068	2009108	A	40	+	40	A
gi|514486271|gb|KE346361.1|	2009136	2009159	AAAAAT	23	+	3	AAAAAT
gi|514486271|gb|KE346361.1|	2009160	2009182	AAAAAT	22	+	3	AAAAAT
gi|514486271|gb|KE346361.1|	2009341	2009355	A	14	+	14	A
gi|514486271|gb|KE346361.1|	2009442	2009455	ACCCCC	13	-	2	GGGGGT
gi|514486271|gb|KE346361.1|	2009518	2009533	AAGGGC	15	-	2	GCCCTT
gi|514486271|gb|KE346361.1|	2009569	2009586	A	17	-	17	T
gi|514486271|gb|KE346361.1|	2009587	2009599	A	12	-	12	T
gi|514486271|gb|KE346361.1|	2009816	2009829	ACAGC	13	-	2	TGCTG
gi|514486271|gb|KE346361.1|	2009868	2009880	AC	12	-	6	GT
gi|514486271|gb|KE346361.1|	2009886	2009901	AATGAC	15	+	2	ATGACA
gi|514486271|gb|KE346361.1|	2011023	2011040	AAAAAT	17	-	2	TTTTTA
gi|514486271|gb|KE346361.1|	2011291	2011305	AGGGGC	14	+	2	GGGGCA
gi|514486271|gb|KE346361.1|	2011423	2011445	A	22	+	22	A
gi|514486271|gb|KE346361.1|	2011471	2011485	AAAAAT	14	-	2	TTATTT
gi|514486271|gb|KE346361.1|	2011490	2011502	A	12	-	12	T
gi|514486271|gb|KE346361.1|	2013105	2013120	A	15	-	15	T
gi|514486271|gb|KE346361.1|	2013121	2013133	AAAAAC	12	-	2	GTTTTT
gi|514486271|gb|KE346361.1|	2013390	2013402	AAGGCG	12	+	2	GCGAAG
gi|514486271|gb|KE346361.1|	2013873	2013899	A	26	-	26	T
gi|514486271|gb|KE346361.1|	2014596	2014613	AAC	17	-	5	TTG
gi|514486271|gb|KE346361.1|	2015446	2015458	CCG	12	+	4	CGC
gi|514486271|gb|KE346361.1|	2017351	2017368	AGC	17	-	5	TGC
gi|514486271|gb|KE346361.1|	2018002	2018014	ACATGG	12	+	2	CATGGA
gi|514486271|gb|KE346361.1|	2018270	2018282	AAAGAC	12	-	2	TTTGTC
gi|514486271|gb|KE346361.1|	2019934	2019949	ACG	15	+	5	CGA
gi|514486271|gb|KE346361.1|	2021081	2021097	AAAAC	16	-	3	TTTTG
gi|514486271|gb|KE346361.1|	2022473	2022496	AGC	23	+	7	AGC
gi|514486271|gb|KE346361.1|	2022763	2022792	AACAGC	29	-	4	TGCTGT
gi|514486271|gb|KE346361.1|	2022790	2022806	AGCATC	16	-	2	TGCTGA
gi|514486271|gb|KE346361.1|	2023351	2023364	AACAGC	13	-	2	GTTGCT
gi|514486271|gb|KE346361.1|	2023359	2023373	AGC	14	-	4	TGC
gi|514486271|gb|KE346361.1|	2023626	2023640	AAGCAG	14	+	2	GCAGAA
gi|514486271|gb|KE346361.1|	2023946	2023962	ACCAGT	16	-	2	TGGTAC
gi|514486271|gb|KE346361.1|	2024002	2024019	CCG	17	+	5	CGC
gi|514486271|gb|KE346361.1|	2024095	2024107	ACCAGC	12	+	2	CAGCAC
gi|514486271|gb|KE346361.1|	2024317	2024330	A	13	+	13	A
gi|514486271|gb|KE346361.1|	2024336	2024353	A	17	+	17	A
gi|514486271|gb|KE346361.1|	2024515	2024529	AC	14	+	7	AC
gi|514486271|gb|KE346361.1|	2024844	2024856	CCGCGG	12	+	2	GCGGCC
gi|514486271|gb|KE346361.1|	2025235	2025252	AC	17	-	8	GT
gi|514486271|gb|KE346361.1|	2025292	2025304	AACGAC	12	+	2	CGACAA
gi|514486271|gb|KE346361.1|	2025563	2025577	AACAGC	14	-	2	TGTTGC
gi|514486271|gb|KE346361.1|	2025666	2025678	ACACAT	12	+	2	ACACAT
gi|514486271|gb|KE346361.1|	2025673	2025689	ACATCC	16	+	2	CACATC
gi|514486271|gb|KE346361.1|	2025962	2025975	AAGAGG	13	-	2	TCTTCC
gi|514486271|gb|KE346361.1|	2026054	2026082	A	28	-	28	T
gi|514486271|gb|KE346361.1|	2026285	2026299	AAAAT	14	-	2	TTTTA
gi|514486271|gb|KE346361.1|	2026297	2026311	AAAAT	14	-	2	TTTTA
gi|514486271|gb|KE346361.1|	2026305	2026323	AAAAAT	18	-	3	TATTTT
gi|514486271|gb|KE346361.1|	2026317	2026338	AAAAT	21	-	4	TATTT
gi|514486271|gb|KE346361.1|	2026423	2026445	A	22	+	22	A
gi|514486271|gb|KE346361.1|	2026462	2026475	ACGGAG	13	-	2	CCGTCT
gi|514486271|gb|KE346361.1|	2026482	2026497	ACAGAG	15	-	2	CTGTCT
gi|514486271|gb|KE346361.1|	2026558	2026574	AG	16	-	8	TC
gi|514486271|gb|KE346361.1|	2026597	2026610	A	13	-	13	T
gi|514486271|gb|KE346361.1|	2026632	2026652	A	20	+	20	A
gi|514486271|gb|KE346361.1|	2026810	2026824	AAAACG	14	+	2	AACGAA
gi|514486271|gb|KE346361.1|	2027068	2027092	A	24	-	24	T
gi|514486271|gb|KE346361.1|	2027113	2027125	AAAGAG	12	-	2	TCTTTC
gi|514486271|gb|KE346361.1|	2027190	2027203	AGGGGG	13	+	2	GGGGGA
gi|514486271|gb|KE346361.1|	2027340	2027356	AATG	16	-	4	ATTC
gi|514486271|gb|KE346361.1|	2027733	2027747	AGGCGG	14	-	2	CCTCCG
gi|514486271|gb|KE346361.1|	2027835	2027847	AAGGCC	12	+	2	CAAGGC
gi|514486271|gb|KE346361.1|	2027860	2027872	AAGCAG	12	+	2	AAGCAG
gi|514486271|gb|KE346361.1|	2028151	2028163	ACACTC	12	-	2	GTGTGA
gi|514486271|gb|KE346361.1|	2028310	2028322	AAGCAC	12	+	2	ACAAGC
gi|514486271|gb|KE346361.1|	2029315	2029327	AGGATC	12	+	2	GATCAG
gi|514486271|gb|KE346361.1|	2029396	2029408	AAAAC	12	-	2	TTTGT
gi|514486271|gb|KE346361.1|	2029412	2029425	AAATGC	13	-	2	GCATTT
gi|514486271|gb|KE346361.1|	2029616	2029633	ACTCTC	17	-	2	GAGAGT
gi|514486271|gb|KE346361.1|	2029641	2029656	ACTCTC	15	-	2	GAGTGA
gi|514486271|gb|KE346361.1|	2029928	2029947	AAG	19	+	6	AGA
gi|514486271|gb|KE346361.1|	2032122	2032136	AGC	14	-	4	TGC
gi|514486271|gb|KE346361.1|	2032242	2032256	A	14	+	14	A
gi|514486271|gb|KE346361.1|	2032260	2032274	A	14	+	14	A
gi|514486271|gb|KE346361.1|	2032571	2032585	AATG	14	-	3	CATT
gi|514486271|gb|KE346361.1|	2033116	2033134	A	18	-	18	T
gi|514486271|gb|KE346361.1|	2034152	2034166	AAGACC	14	-	2	CTTGGT
gi|514486271|gb|KE346361.1|	2034715	2034729	AAAAGG	14	-	2	TTTTCC
gi|514486271|gb|KE346361.1|	2034868	2034882	A	14	-	14	T
gi|514486271|gb|KE346361.1|	2034983	2034998	AGC	15	+	5	CAG
gi|514486271|gb|KE346361.1|	2035020	2035047	AGC	27	+	9	AGC
gi|514486271|gb|KE346361.1|	2036142	2036155	AACAGC	13	+	2	AACAGC
gi|514486271|gb|KE346361.1|	2036150	2036166	AGC	16	+	5	CAG
gi|514486271|gb|KE346361.1|	2037099	2037116	ATC	17	+	5	TCA
gi|514486271|gb|KE346361.1|	2038584	2038598	AAC	14	-	4	TGT
gi|514486271|gb|KE346361.1|	2039464	2039482	AATCTC	18	-	3	GATTGA
gi|514486271|gb|KE346361.1|	2039481	2039495	A	14	+	14	A
gi|514486271|gb|KE346361.1|	2039800	2039813	AAAACC	13	+	2	AAAACC
gi|514486271|gb|KE346361.1|	2039859	2039871	AAAC	12	+	3	AAAC
gi|514486271|gb|KE346361.1|	2040453	2040465	AAAAAC	12	+	2	CAAAAA
gi|514486271|gb|KE346361.1|	2040481	2040493	AACACC	12	+	2	AACACC
gi|514486271|gb|KE346361.1|	2040826	2040838	AACAGC	12	-	2	TTGCTG
gi|514486271|gb|KE346361.1|	2041345	2041357	AATACC	12	+	2	ACCAAT
gi|514486271|gb|KE346361.1|	2041369	2041385	AAAAGC	16	+	2	CAAAAG
gi|514486271|gb|KE346361.1|	2041386	2041403	AAAAGC	17	+	2	CAAAAG
gi|514486271|gb|KE346361.1|	2041398	2041426	AAAACC	28	+	4	CAAAAC
gi|514486271|gb|KE346361.1|	2041674	2041686	AAGCCC	12	-	2	CTTGGG
gi|514486271|gb|KE346361.1|	2041744	2041756	AAGCCC	12	-	2	GGCTTG
gi|514486271|gb|KE346361.1|	2042103	2042116	AGCGGC	13	+	2	GGCAGC
gi|514486271|gb|KE346361.1|	2042963	2042976	AACCCC	13	-	2	GGTTGG
gi|514486271|gb|KE346361.1|	2043184	2043196	AAAAAC	12	-	2	TTTTTG
gi|514486271|gb|KE346361.1|	2043408	2043420	AAGGAC	12	+	2	GACAAG
gi|514486271|gb|KE346361.1|	2043417	2043432	AAG	15	+	5	AAG
gi|514486271|gb|KE346361.1|	2043452	2043466	ACATCT	14	+	2	CATCTA
gi|514486271|gb|KE346361.1|	2043779	2043791	AAAAAC	12	+	2	AAAAAC
gi|514486271|gb|KE346361.1|	2045009	2045049	AG	40	+	20	AG
gi|514486271|gb|KE346361.1|	2046268	2046280	ACAGC	12	+	2	CAGCA
gi|514486271|gb|KE346361.1|	2047594	2047606	ACCGCC	12	+	2	CCACCG
gi|514486271|gb|KE346361.1|	2053346	2053361	AGC	15	-	5	TGC
gi|514486271|gb|KE346361.1|	2053379	2053394	AGC	15	-	5	TGC
gi|514486271|gb|KE346361.1|	2054216	2054242	A	26	+	26	A
gi|514486271|gb|KE346361.1|	2054372	2054395	AAAC	23	+	5	AAAC
gi|514486271|gb|KE346361.1|	2055278	2055293	A	15	+	15	A
gi|514486271|gb|KE346361.1|	2055496	2055513	AC	17	+	8	CA
gi|514486271|gb|KE346361.1|	2056026	2056045	AAC	19	-	6	GTT
gi|514486271|gb|KE346361.1|	2056207	2056219	ACGGCT	12	-	2	GCCGTA
gi|514486271|gb|KE346361.1|	2057118	2057145	A	27	+	27	A
gi|514486271|gb|KE346361.1|	2057420	2057435	AATGGC	15	+	2	CAATGG
gi|514486271|gb|KE346361.1|	2057560	2057573	ACTCTC	13	-	2	GAGTGA
gi|514486271|gb|KE346361.1|	2057656	2057668	AGGGGG	12	-	2	TCCCCC
gi|514486271|gb|KE346361.1|	2057672	2057685	AAAC	13	+	3	CAAA
gi|514486271|gb|KE346361.1|	2057743	2057755	AAC	12	-	4	TTG
gi|514486271|gb|KE346361.1|	2057933	2057946	AG	13	+	6	AG
gi|514486271|gb|KE346361.1|	2057979	2057993	AACTC	14	-	2	GTTGA
gi|514486271|gb|KE346361.1|	2058089	2058101	AGAGCG	12	+	2	CGAGAG
gi|514486271|gb|KE346361.1|	2058277	2058291	AGCG	14	+	3	CGAG
gi|514486271|gb|KE346361.1|	2058466	2058478	AAAAGG	12	+	2	AAGGAA
gi|514486271|gb|KE346361.1|	2058475	2058492	AAG	17	+	5	GAA
gi|514486271|gb|KE346361.1|	2058564	2058577	AAGCTC	13	+	2	AGCTCA
gi|514486271|gb|KE346361.1|	2059116	2059133	AC	17	+	8	AC
gi|514486271|gb|KE346361.1|	2059362	2059374	AAAATC	12	+	2	ATCAAA
gi|514486271|gb|KE346361.1|	2060446	2060460	CCCG	14	-	3	GGCG
gi|514486271|gb|KE346361.1|	2060796	2060823	AAACG	27	-	5	TCGTT
gi|514486271|gb|KE346361.1|	2060826	2060843	AAACG	17	-	3	TCGTT
gi|514486271|gb|KE346361.1|	2062403	2062428	AAAC	25	-	6	TTGT
gi|514486271|gb|KE346361.1|	2062519	2062532	AATGTC	13	-	2	ACATTG
gi|514486271|gb|KE346361.1|	2062531	2062543	AACTGC	12	+	2	AACTGC
gi|514486271|gb|KE346361.1|	2062740	2062755	A	15	-	15	T
gi|514486271|gb|KE346361.1|	2063805	2063819	AGCGCG	14	+	2	AGCGCG
gi|514486271|gb|KE346361.1|	2063957	2063969	AAAAAC	12	+	2	AAAACA
gi|514486271|gb|KE346361.1|	2064215	2064229	A	14	-	14	T
gi|514486271|gb|KE346361.1|	2064815	2064834	CCG	19	+	6	GCC
gi|514486271|gb|KE346361.1|	2065046	2065063	AGCCGG	17	-	2	GCTCCG
gi|514486271|gb|KE346361.1|	2065119	2065137	ACCACG	18	-	3	GGTCGT
gi|514486271|gb|KE346361.1|	2065138	2065152	ACCACG	14	-	2	GTCGTG
gi|514486271|gb|KE346361.1|	2065218	2065233	AGCATC	15	-	2	CTGATG
gi|514486271|gb|KE346361.1|	2065302	2065314	ACCATC	12	-	2	GTGATG
gi|514486271|gb|KE346361.1|	2065318	2065363	ATC	45	-	15	TGA
gi|514486271|gb|KE346361.1|	2065534	2065551	AG	17	+	8	AG
gi|514486271|gb|KE346361.1|	2065658	2065671	AG	13	+	6	AG
gi|514486271|gb|KE346361.1|	2065674	2065688	AG	14	+	7	GA
gi|514486271|gb|KE346361.1|	2065706	2065718	AGAGG	12	+	2	GAGGA
gi|514486271|gb|KE346361.1|	2065827	2065841	AACATC	14	-	2	TGATGT
gi|514486271|gb|KE346361.1|	2065836	2065855	AAC	19	-	6	TGT
gi|514486271|gb|KE346361.1|	2065956	2065968	AAACTC	12	-	2	AGTTTG
gi|514486271|gb|KE346361.1|	2066558	2066576	ACTGAG	18	-	3	CTCAGT
gi|514486271|gb|KE346361.1|	2067520	2067533	AAAAAG	13	-	2	CTTTTT
gi|514486271|gb|KE346361.1|	2067714	2067732	ACG	18	+	6	CGA
gi|514486271|gb|KE346361.1|	2067808	2067825	ACG	17	+	5	GAC
gi|514486271|gb|KE346361.1|	2069065	2069088	A	23	-	23	T
gi|514486271|gb|KE346361.1|	2069655	2069674	A	19	-	19	T
gi|514486271|gb|KE346361.1|	2069675	2069693	A	18	-	18	T
gi|514486271|gb|KE346361.1|	2069688	2069701	AAAAAC	13	-	2	TTTTTG
gi|514486271|gb|KE346361.1|	2069889	2069901	AAAG	12	-	3	TCTT
gi|514486271|gb|KE346361.1|	2069901	2069914	AGAGGC	13	-	2	CCTCTG
gi|514486271|gb|KE346361.1|	2070352	2070365	ACACGC	13	+	2	ACACGC
gi|514486271|gb|KE346361.1|	2070730	2070745	ACCGCC	15	-	2	GCGGTG
gi|514486271|gb|KE346361.1|	2070752	2070793	AAC	41	+	13	CAA
gi|514486271|gb|KE346361.1|	2071383	2071396	AAT	13	+	4	AAT
gi|514486271|gb|KE346361.1|	2071537	2071552	AGCGGC	15	-	2	GCCGCT
gi|514486271|gb|KE346361.1|	2071609	2071624	AG	15	-	7	CT
gi|514486271|gb|KE346361.1|	2071689	2071701	A	12	-	12	T
gi|514486271|gb|KE346361.1|	2071864	2071879	A	15	+	15	A
gi|514486271|gb|KE346361.1|	2071907	2071919	A	12	+	12	A
gi|514486271|gb|KE346361.1|	2072120	2072135	A	15	-	15	T
gi|514486271|gb|KE346361.1|	2072156	2072172	AAAG	16	-	4	CTTT
gi|514486271|gb|KE346361.1|	2072356	2072370	A	14	-	14	T
gi|514486271|gb|KE346361.1|	2072384	2072396	AAAAG	12	-	2	TCTTT
gi|514486271|gb|KE346361.1|	2072620	2072632	AGGGG	12	-	2	TCCCC
gi|514486271|gb|KE346361.1|	2072692	2072707	AGCGGC	15	-	2	CGCTGC
gi|514486271|gb|KE346361.1|	2073390	2073405	ACGGGC	15	-	2	GTGCCC
gi|514486271|gb|KE346361.1|	2073668	2073680	CCCCCG	12	+	2	CCCGCC
gi|514486271|gb|KE346361.1|	2074252	2074264	AAAAAT	12	+	2	AAAAAT
gi|514486271|gb|KE346361.1|	2074337	2074350	AAACAC	13	-	2	TGTTTG
gi|514486271|gb|KE346361.1|	2074424	2074448	A	24	-	24	T
gi|514486271|gb|KE346361.1|	2074445	2074472	AAAC	27	-	6	TTTG
gi|514486271|gb|KE346361.1|	2076688	2076701	AACTGC	13	-	2	TGCAGT
gi|514486271|gb|KE346361.1|	2081677	2081691	AAAAG	14	-	2	TTTCT
gi|514486271|gb|KE346361.1|	2082520	2082537	A	17	-	17	T
gi|514486271|gb|KE346361.1|	2082532	2082544	AAAAAC	12	-	2	TTTTTG
gi|514486271|gb|KE346361.1|	2082601	2082618	ACACCC	17	+	2	CACACC
gi|514486271|gb|KE346361.1|	2082862	2082876	A	14	+	14	A
gi|514486271|gb|KE346361.1|	2083548	2083561	AAAAAC	13	+	2	ACAAAA
gi|514486271|gb|KE346361.1|	2083556	2083582	A	26	+	26	A
gi|514486271|gb|KE346361.1|	2083626	2083638	AATCC	12	+	2	AATCC
gi|514486271|gb|KE346361.1|	2085005	2085022	AGC	17	-	5	TGC
gi|514486271|gb|KE346361.1|	2085042	2085056	ACC	14	-	4	GGT
gi|514486271|gb|KE346361.1|	2085485	2085498	ACCGGC	13	-	2	CGGTGC
gi|514486271|gb|KE346361.1|	2086104	2086131	A	27	+	27	A
gi|514486271|gb|KE346361.1|	2086494	2086506	AGC	12	-	4	CTG
gi|514486271|gb|KE346361.1|	2087083	2087095	AAAAAC	12	-	2	TTTTTG
gi|514486271|gb|KE346361.1|	2087341	2087367	A	26	+	26	A
gi|514486271|gb|KE346361.1|	2087401	2087419	A	18	-	18	T
gi|514486271|gb|KE346361.1|	2087490	2087513	AC	23	-	11	GT
gi|514486271|gb|KE346361.1|	2087545	2087559	AAC	14	-	4	TTG
gi|514486271|gb|KE346361.1|	2087561	2087573	A	12	-	12	T
gi|514486271|gb|KE346361.1|	2087709	2087721	AGAGCG	12	-	2	CTCTCG
gi|514486271|gb|KE346361.1|	2089261	2089274	AATGAC	13	+	2	ACAATG
gi|514486271|gb|KE346361.1|	2089330	2089342	AAAGCG	12	+	2	GAAAGC
gi|514486271|gb|KE346361.1|	2089800	2089812	CCCCG	12	+	2	GCCCC
gi|514486271|gb|KE346361.1|	2089957	2089970	A	13	-	13	T
gi|514486271|gb|KE346361.1|	2090447	2090471	ATC	24	+	8	TCA
gi|514486271|gb|KE346361.1|	2090880	2090892	AAGGTC	12	-	2	TGACCT
gi|514486271|gb|KE346361.1|	2094408	2094421	AATGAC	13	+	2	ACAATG
gi|514486271|gb|KE346361.1|	2094477	2094489	AAAGCG	12	+	2	GAAAGC
gi|514486271|gb|KE346361.1|	2094947	2094959	CCCCG	12	+	2	GCCCC
gi|514486271|gb|KE346361.1|	2095104	2095117	A	13	-	13	T
gi|514486271|gb|KE346361.1|	2095594	2095618	ATC	24	+	8	TCA
gi|514486271|gb|KE346361.1|	2096027	2096039	AAGGTC	12	-	2	TGACCT
gi|514486271|gb|KE346361.1|	2096860	2096879	AGC	19	-	6	CTG
gi|514486271|gb|KE346361.1|	2097371	2097383	ACTGCC	12	+	2	CCACTG
gi|514486271|gb|KE346361.1|	2097420	2097432	AGCGGC	12	+	2	CAGCGG
gi|514486271|gb|KE346361.1|	2097739	2097752	ACTGCG	13	+	2	CTGCGA
gi|514486271|gb|KE346361.1|	2098316	2098335	AAC	19	+	6	CAA
gi|514486271|gb|KE346361.1|	2098593	2098622	ATC	29	+	9	TCA
gi|514486271|gb|KE346361.1|	2098632	2098646	ATC	14	-	4	ATG
gi|514486271|gb|KE346361.1|	2100118	2100132	AGCGCG	14	-	2	TCGCGC
gi|514486271|gb|KE346361.1|	2100139	2100151	AAGACC	12	-	2	GTCTTG
gi|514486271|gb|KE346361.1|	2100247	2100259	ACGATG	12	-	2	TCGTCA
gi|514486271|gb|KE346361.1|	2100343	2100355	ACG	12	-	4	TCG
gi|514486271|gb|KE346361.1|	2100477	2100489	AAGGAG	12	-	2	CTCCTT
gi|514486271|gb|KE346361.1|	2101351	2101367	ACG	16	-	5	GTC
gi|514486271|gb|KE346361.1|	2101552	2101569	AAAAGC	17	+	2	CAAAAG
gi|514486271|gb|KE346361.1|	2101633	2101645	AACCC	12	-	2	GTTGG
gi|514486271|gb|KE346361.1|	2101866	2101879	AG	13	-	6	TC
gi|514486271|gb|KE346361.1|	2101936	2101948	AGAT	12	+	3	AGAT
gi|514486271|gb|KE346361.1|	2103560	2103573	AAAAAC	13	+	2	AACAAA
gi|514486271|gb|KE346361.1|	2104130	2104142	ACGTCG	12	+	2	TCGACG
gi|514486271|gb|KE346361.1|	2104981	2104993	AAGAAT	12	-	2	TATTCT
gi|514486271|gb|KE346361.1|	2105148	2105161	CCG	13	+	4	GCC
gi|514486271|gb|KE346361.1|	2105397	2105410	ACAGAG	13	+	2	AGACAG
gi|514486271|gb|KE346361.1|	2105404	2105418	ACAG	14	+	3	GACA
gi|514486271|gb|KE346361.1|	2105423	2105436	AG	13	+	6	AG
gi|514486271|gb|KE346361.1|	2105634	2105661	A	27	-	27	T
gi|514486271|gb|KE346361.1|	2105657	2105673	AAAACC	16	-	2	TTTTGG
gi|514486271|gb|KE346361.1|	2105750	2105765	ACC	15	-	5	GGT
gi|514486271|gb|KE346361.1|	2105777	2105790	AACCAC	13	-	2	GTGGTT
gi|514486271|gb|KE346361.1|	2106224	2106240	AAG	16	-	5	TTC
gi|514486271|gb|KE346361.1|	2106681	2106694	AGCGGC	13	+	2	GCGGCA
gi|514486271|gb|KE346361.1|	2107196	2107219	AG	23	-	11	CT
gi|514486271|gb|KE346361.1|	2108894	2108910	AAC	16	-	5	TTG
gi|514486271|gb|KE346361.1|	2109214	2109227	A	13	-	13	T
gi|514486271|gb|KE346361.1|	2109243	2109267	A	24	-	24	T
gi|514486271|gb|KE346361.1|	2109495	2109507	ATCCC	12	+	2	CCCAT
gi|514486271|gb|KE346361.1|	2109842	2109912	AAC	70	+	23	CAA
gi|514486271|gb|KE346361.1|	2111424	2111437	AAGCAC	13	-	2	TTGTGC
gi|514486271|gb|KE346361.1|	2111683	2111695	AAGCGG	12	-	2	TTCCGC
gi|514486271|gb|KE346361.1|	2112236	2112248	CCCCCG	12	+	2	GCCCCC
gi|514486271|gb|KE346361.1|	2114567	2114584	AAAACT	17	-	2	GTTTTA
gi|514486271|gb|KE346361.1|	2115151	2115163	A	12	+	12	A
gi|514486271|gb|KE346361.1|	2116313	2116325	AGGCGC	12	-	2	CTGCGC
gi|514486271|gb|KE346361.1|	2117281	2117294	AACAGC	13	-	2	GTTGCT
gi|514486271|gb|KE346361.1|	2117349	2117363	AGC	14	-	4	TGC
gi|514486271|gb|KE346361.1|	2117361	2117378	AAC	17	-	5	TGT
gi|514486271|gb|KE346361.1|	2117376	2117411	AGC	35	-	11	TGC
gi|514486271|gb|KE346361.1|	2117436	2117448	AACAGC	12	-	2	TTGCTG
gi|514486271|gb|KE346361.1|	2117838	2117852	AACAGC	14	-	2	TGTTGC
gi|514486271|gb|KE346361.1|	2117925	2117942	AACAGC	17	-	2	TGTTGC
gi|514486271|gb|KE346361.1|	2117952	2117966	AGC	14	-	4	TGC
gi|514486271|gb|KE346361.1|	2117976	2117988	AAC	12	-	4	TGT
gi|514486271|gb|KE346361.1|	2118480	2118494	ATC	14	-	4	GAT
gi|514486271|gb|KE346361.1|	2118719	2118738	AAGGAC	19	+	3	GGACAA
gi|514486271|gb|KE346361.1|	2118746	2118758	AGGCCG	12	+	2	CGAGGC
gi|514486271|gb|KE346361.1|	2118824	2118849	ACG	25	+	8	CGA
gi|514486271|gb|KE346361.1|	2118915	2118927	AGC	12	-	4	TGC
gi|514486271|gb|KE346361.1|	2119178	2119190	AACC	12	-	3	TTGG
gi|514486271|gb|KE346361.1|	2119374	2119387	AGAGGG	13	+	2	GAGGGA
gi|514486271|gb|KE346361.1|	2119569	2119584	AAG	15	+	5	GAA
gi|514486271|gb|KE346361.1|	2119915	2119929	AACCGC	14	+	2	CAACCG
gi|514486271|gb|KE346361.1|	2119971	2119984	AG	13	+	6	AG
gi|514486271|gb|KE346361.1|	2120117	2120145	AAAAAT	28	+	4	AAAATA
gi|514486271|gb|KE346361.1|	2120176	2120198	A	22	-	22	T
gi|514486271|gb|KE346361.1|	2120379	2120395	AC	16	+	8	CA
gi|514486271|gb|KE346361.1|	2120394	2120415	A	21	+	21	A
gi|514486271|gb|KE346361.1|	2120581	2120600	A	19	-	19	T
gi|514486271|gb|KE346361.1|	2120797	2120818	AAAAT	21	+	4	AAAAT
gi|514486271|gb|KE346361.1|	2120840	2120854	A	14	+	14	A
gi|514486271|gb|KE346361.1|	2121706	2121719	AAGGCC	13	-	2	CTTGGC
gi|514486271|gb|KE346361.1|	2122449	2122461	AGGATC	12	-	2	TCCTGA
gi|514486271|gb|KE346361.1|	2122604	2122616	AGCGGC	12	-	2	CGCTGC
gi|514486271|gb|KE346361.1|	2126401	2126414	ACC	13	+	4	CAC
gi|514486271|gb|KE346361.1|	2127663	2127677	AGCAGG	14	+	2	AGGAGC
gi|514486271|gb|KE346361.1|	2127721	2127752	AGC	31	+	10	GCA
gi|514486271|gb|KE346361.1|	2128356	2128375	A	19	-	19	T
gi|514486271|gb|KE346361.1|	2128485	2128498	AGAGAT	13	+	2	AGATAG
gi|514486271|gb|KE346361.1|	2128495	2128510	AGAGAT	15	+	2	AGATAG
gi|514486271|gb|KE346361.1|	2128609	2128622	A	13	+	13	A
gi|514486271|gb|KE346361.1|	2128834	2128849	AAAC	15	-	3	TTTG
gi|514486271|gb|KE346361.1|	2129632	2129644	AAGCTC	12	-	2	AGCTTG
gi|514486271|gb|KE346361.1|	2130556	2130568	AAC	12	-	4	GTT
gi|514486271|gb|KE346361.1|	2131014	2131029	AGC	15	+	5	GCA
gi|514486271|gb|KE346361.1|	2131048	2131060	ACATC	12	-	2	TGTGA
gi|514486271|gb|KE346361.1|	2131472	2131484	AAAAAC	12	-	2	TTGTTT
gi|514486271|gb|KE346361.1|	2131608	2131621	AATGCC	13	-	2	GGCATT
gi|514486271|gb|KE346361.1|	2131649	2131661	AGC	12	-	4	TGC
gi|514486271|gb|KE346361.1|	2131834	2131846	AACGGG	12	+	2	GGAACG
gi|514486271|gb|KE346361.1|	2131858	2131876	ATC	18	+	6	TCA
gi|514486271|gb|KE346361.1|	2133326	2133339	AGG	13	+	4	GGA
gi|514486271|gb|KE346361.1|	2133340	2133413	AGG	73	+	24	AGG
gi|514486271|gb|KE346361.1|	2133418	2133464	AGG	46	+	15	AGG
gi|514486271|gb|KE346361.1|	2134951	2134963	AACATC	12	-	2	ATGTTG
gi|514486271|gb|KE346361.1|	2135328	2135342	ACCTCC	14	-	2	GGAGGT
gi|514486271|gb|KE346361.1|	2137019	2137031	AAGGTC	12	+	2	GGTCAA
gi|514486271|gb|KE346361.1|	2137125	2137137	AAC	12	-	4	TGT
gi|514486271|gb|KE346361.1|	2137143	2137157	AAC	14	-	4	TGT
gi|514486271|gb|KE346361.1|	2137161	2137181	AAC	20	-	6	TGT
gi|514486271|gb|KE346361.1|	2137404	2137417	AATGCC	13	+	2	AATGCC
gi|514486271|gb|KE346361.1|	2137964	2137977	AGCTCG	13	+	2	GCTCGA
gi|514486271|gb|KE346361.1|	2139305	2139318	CCCCG	13	-	2	GGCGG
gi|514486271|gb|KE346361.1|	2139441	2139453	AAGGTC	12	+	2	GGTCAA
gi|514486271|gb|KE346361.1|	2139915	2139940	A	25	+	25	A
gi|514486271|gb|KE346361.1|	2140839	2140858	AGCGGC	19	-	3	CCGCTG
gi|514486271|gb|KE346361.1|	2141114	2141126	ACAGGG	12	+	2	GACAGG
gi|514486271|gb|KE346361.1|	2141707	2141722	AAAGAG	15	+	2	GAAAGA
gi|514486271|gb|KE346361.1|	2141745	2141758	A	13	+	13	A
gi|514486271|gb|KE346361.1|	2142212	2142224	ACCTGC	12	+	2	CCTGCA
gi|514486271|gb|KE346361.1|	2142255	2142268	AAG	13	-	4	TCT
gi|514486271|gb|KE346361.1|	2143675	2143688	AGAGCG	13	+	2	CGAGAG
gi|514486271|gb|KE346361.1|	2143873	2143899	AGG	26	+	8	GAG
gi|514486271|gb|KE346361.1|	2144130	2144143	AAGTGG	13	+	2	GTGGAA
gi|514486271|gb|KE346361.1|	2144657	2144669	AGG	12	+	4	GGA
gi|514486271|gb|KE346361.1|	2144760	2144772	AGCTGC	12	+	2	TGCAGC
gi|514486271|gb|KE346361.1|	2146203	2146215	AAGCGC	12	+	2	AAGCGC
gi|514486271|gb|KE346361.1|	2146850	2146862	ACGCCG	12	-	2	CGTCGG
gi|514486271|gb|KE346361.1|	2147201	2147217	AAAAAC	16	-	2	TTTTTG
gi|514486271|gb|KE346361.1|	2147892	2147904	AATGCC	12	+	2	TGCCAA
gi|514486271|gb|KE346361.1|	2148684	2148701	AGG	17	-	5	CCT
gi|514486271|gb|KE346361.1|	2148790	2148804	ATCATG	14	+	2	ATGATC
gi|514486271|gb|KE346361.1|	2149246	2149269	ACCG	23	-	5	GGTC
gi|514486271|gb|KE346361.1|	2149578	2149595	AG	17	+	8	AG
gi|514486271|gb|KE346361.1|	2150088	2150103	ATCGCC	15	+	2	TCGCCA
gi|514486271|gb|KE346361.1|	2150369	2150399	A	30	+	30	A
gi|514486271|gb|KE346361.1|	2150556	2150569	AGGGGG	13	+	2	GGGGGA
gi|514486271|gb|KE346361.1|	2150647	2150664	AGCATC	17	-	2	TGATGC
gi|514486271|gb|KE346361.1|	2150847	2150859	ATC	12	+	4	CAT
gi|514486271|gb|KE346361.1|	2151232	2151245	AATGTC	13	-	2	TGACAT
gi|514486271|gb|KE346361.1|	2151298	2151311	C	13	-	13	G
gi|514486271|gb|KE346361.1|	2153835	2153848	AAAAG	13	-	2	TTTCT
gi|514486271|gb|KE346361.1|	2154469	2154483	AACG	14	+	3	CGAA
gi|514486271|gb|KE346361.1|	2155405	2155417	AAAGGC	12	+	2	GCAAAG
gi|514486271|gb|KE346361.1|	2156560	2156577	AGC	17	-	5	TGC
gi|514486271|gb|KE346361.1|	2156584	2156598	AGC	14	-	4	TGC
gi|514486271|gb|KE346361.1|	2157394	2157408	CCG	14	-	4	GCG
gi|514486271|gb|KE346361.1|	2158188	2158201	AGC	13	-	4	CTG
gi|514486271|gb|KE346361.1|	2158302	2158314	ACCTCG	12	+	2	GACCTC
gi|514486271|gb|KE346361.1|	2158975	2158989	AGCCGC	14	+	2	GCCGCA
gi|514486271|gb|KE346361.1|	2159634	2159649	AGCGGC	15	-	2	GCCGCT
gi|514486271|gb|KE346361.1|	2160007	2160019	ACCAGC	12	+	2	CCAGCA
gi|514486271|gb|KE346361.1|	2160655	2160670	AAC	15	-	5	TGT
gi|514486271|gb|KE346361.1|	2160671	2160687	AACAGC	16	-	2	GTTGCT
gi|514486271|gb|KE346361.1|	2161182	2161195	ACG	13	-	4	GTC
gi|514486271|gb|KE346361.1|	2163295	2163312	AAC	17	+	5	CAA
gi|514486271|gb|KE346361.1|	2163584	2163605	A	21	+	21	A
gi|514486271|gb|KE346361.1|	2163796	2163814	A	18	+	18	A
gi|514486271|gb|KE346361.1|	2163827	2163841	A	14	-	14	T
gi|514486271|gb|KE346361.1|	2164191	2164203	AAAAT	12	+	2	AATAA
gi|514486271|gb|KE346361.1|	2164197	2164209	AAAAAT	12	+	2	ATAAAA
gi|514486271|gb|KE346361.1|	2164203	2164219	AAAAT	16	+	3	ATAAA
gi|514486271|gb|KE346361.1|	2164225	2164238	A	13	+	13	A
gi|514486271|gb|KE346361.1|	2164248	2164260	AATTC	12	-	2	TTGAA
gi|514486271|gb|KE346361.1|	2164275	2164311	AG	36	+	18	GA
gi|514486271|gb|KE346361.1|	2164418	2164431	AAGCTC	13	+	2	CAAGCT
gi|514486271|gb|KE346361.1|	2165069	2165081	A	12	-	12	T
gi|514486271|gb|KE346361.1|	2165105	2165117	AACGCC	12	+	2	GCCAAC
gi|514486271|gb|KE346361.1|	2165564	2165576	AAAG	12	-	3	CTTT
gi|514486271|gb|KE346361.1|	2165779	2165791	AGGGGG	12	-	2	CTCCCC
gi|514486271|gb|KE346361.1|	2166014	2166026	AAGCAC	12	-	2	TGTGCT
gi|514486271|gb|KE346361.1|	2166112	2166131	A	19	-	19	T
gi|514486271|gb|KE346361.1|	2166182	2166195	AG	13	-	6	TC
gi|514486271|gb|KE346361.1|	2166357	2166370	AGAGCG	13	-	2	CGCTCT
gi|514486271|gb|KE346361.1|	2167571	2167585	AACAGC	14	-	2	TGTTGC
gi|514486271|gb|KE346361.1|	2169446	2169461	AAC	15	-	5	TTG
gi|514486271|gb|KE346361.1|	2169664	2169676	AAAAC	12	+	2	AAAAC
gi|514486271|gb|KE346361.1|	2170568	2170585	AAAAAT	17	-	2	TTTTTA
gi|514486271|gb|KE346361.1|	2170699	2170725	ACTC	26	+	6	TCAC
gi|514486271|gb|KE346361.1|	2170726	2170757	ACTC	31	+	7	CTCA
gi|514486271|gb|KE346361.1|	2170758	2170777	ACTC	19	+	4	CTCA
gi|514486271|gb|KE346361.1|	2170771	2170785	ACTCTC	14	+	2	TCACTC
gi|514486271|gb|KE346361.1|	2171253	2171269	AG	16	+	8	GA
gi|514486271|gb|KE346361.1|	2171365	2171377	AGCAGG	12	+	2	GGAGCA
gi|514486271|gb|KE346361.1|	2171507	2171520	A	13	-	13	T
gi|514486271|gb|KE346361.1|	2171554	2171569	A	15	-	15	T
gi|514486271|gb|KE346361.1|	2171571	2171586	AAAC	15	-	3	TTGT
gi|514486271|gb|KE346361.1|	2171637	2171650	AAATAG	13	-	2	CTATTT
gi|514486271|gb|KE346361.1|	2173580	2173592	AGATGC	12	-	2	TCTGCA
gi|514486271|gb|KE346361.1|	2174494	2174509	ACGCTG	15	-	2	AGCGTC
gi|514486271|gb|KE346361.1|	2174771	2174783	ACGGCG	12	-	2	CGTCGC
gi|514486271|gb|KE346361.1|	2175271	2175284	AC	13	+	6	CA
gi|514486271|gb|KE346361.1|	2175364	2175385	ATCGC	21	-	4	TGCGA
gi|514486271|gb|KE346361.1|	2176209	2176227	A	18	+	18	A
gi|514486271|gb|KE346361.1|	2179511	2179536	AAC	25	-	8	GTT
gi|514486271|gb|KE346361.1|	2179532	2179544	AACCGC	12	-	2	GTTGCG
gi|514486271|gb|KE346361.1|	2179614	2179631	ACTCTG	17	-	2	GTCAGA
gi|514486271|gb|KE346361.1|	2182891	2182909	AGC	18	+	6	GCA
gi|514486271|gb|KE346361.1|	2183093	2183105	AAAAAC	12	+	2	AACAAA
gi|514486271|gb|KE346361.1|	2183151	2183164	AAGAAT	13	+	2	AGAATA
gi|514486271|gb|KE346361.1|	2183361	2183374	A	13	+	13	A
gi|514486271|gb|KE346361.1|	2183409	2183421	AC	12	+	6	CA
gi|514486271|gb|KE346361.1|	2183549	2183563	AGGGG	14	-	2	CTCCC
gi|514486271|gb|KE346361.1|	2183599	2183614	CCG	15	-	5	GGC
gi|514486271|gb|KE346361.1|	2183719	2183739	AGC	20	+	6	AGC
gi|514486271|gb|KE346361.1|	2183961	2183974	A	13	+	13	A
gi|514486271|gb|KE346361.1|	2184112	2184124	AAACAG	12	+	2	GAAACA
gi|514486271|gb|KE346361.1|	2184838	2184850	ATC	12	+	4	CAT
gi|514486271|gb|KE346361.1|	2185314	2185326	AGCGCC	12	-	2	CTGGCG
gi|514486271|gb|KE346361.1|	2185489	2185501	ACGCCG	12	+	2	CGACGC
gi|514486271|gb|KE346361.1|	2185554	2185567	AAAAAC	13	-	2	TGTTTT
gi|514486271|gb|KE346361.1|	2186417	2186430	AAT	13	+	4	AAT
gi|514486271|gb|KE346361.1|	2186470	2186487	AGAGGG	17	+	2	GAGAGG
gi|514486271|gb|KE346361.1|	2186650	2186666	AGC	16	+	5	AGC
gi|514486271|gb|KE346361.1|	2186733	2186762	ACC	29	+	9	ACC
gi|514486271|gb|KE346361.1|	2187514	2187526	AAAGCC	12	-	2	GCTTTG
gi|514486271|gb|KE346361.1|	2187589	2187604	ATCGGC	15	+	2	GCATCG
gi|514486271|gb|KE346361.1|	2187653	2187666	A	13	+	13	A
gi|514486271|gb|KE346361.1|	2188317	2188329	AATTCC	12	-	2	TTGGAA
gi|514486271|gb|KE346361.1|	2188683	2188697	AAC	14	-	4	TTG
gi|514486271|gb|KE346361.1|	2190264	2190279	ACGGC	15	+	3	CACGG
gi|514486271|gb|KE346361.1|	2190332	2190344	AAC	12	-	4	TTG
gi|514486271|gb|KE346361.1|	2190528	2190540	A	12	+	12	A
gi|514486271|gb|KE346361.1|	2191634	2191653	A	19	+	19	A
gi|514486271|gb|KE346361.1|	2191687	2191717	AAAC	30	+	7	AAAC
gi|514486271|gb|KE346361.1|	2192898	2192910	AATCG	12	-	2	CGATT
gi|514486271|gb|KE346361.1|	2192984	2192996	AAAC	12	+	3	CAAA
gi|514486271|gb|KE346361.1|	2193002	2193015	AAAC	13	+	3	AACA
gi|514486271|gb|KE346361.1|	2193781	2193793	ACTGCT	12	+	2	ACTGCT
gi|514486271|gb|KE346361.1|	2193823	2193836	AGCGGC	13	-	2	GCCGCT
gi|514486271|gb|KE346361.1|	2194483	2194498	AAGGAG	15	+	2	AAGGAG
gi|514486271|gb|KE346361.1|	2194551	2194566	ACACC	15	+	3	CCACA
gi|514486271|gb|KE346361.1|	2194888	2194908	AAC	20	-	6	TGT
gi|514486271|gb|KE346361.1|	2194988	2195023	A	35	+	35	A
gi|514486271|gb|KE346361.1|	2195060	2195097	A	37	-	37	T
gi|514486271|gb|KE346361.1|	2195115	2195128	AAG	13	-	4	CTT
gi|514486271|gb|KE346361.1|	2195134	2195146	AAC	12	-	4	TTG
gi|514486271|gb|KE346361.1|	2195510	2195523	AGGGGG	13	-	2	TCCCCC
gi|514486271|gb|KE346361.1|	2195560	2195576	ACACAT	16	+	2	CACATA
gi|514486271|gb|KE346361.1|	2195929	2195949	A	20	-	20	T
gi|514486271|gb|KE346361.1|	2196282	2196295	AAAAAC	13	+	2	AACAAA
gi|514486271|gb|KE346361.1|	2196665	2196677	AAGGTC	12	-	2	CCTTGA
gi|514486271|gb|KE346361.1|	2197047	2197059	AACTTG	12	+	2	CTTGAA
gi|514486271|gb|KE346361.1|	2197734	2197746	ACCG	12	-	3	GTCG
gi|514486271|gb|KE346361.1|	2198776	2198832	A	56	+	56	A
gi|514486271|gb|KE346361.1|	2201845	2201858	A	13	-	13	T
gi|514486271|gb|KE346361.1|	2202575	2202587	ACGCT	12	+	2	CTACG
gi|514486271|gb|KE346361.1|	2202999	2203011	AACATC	12	-	2	ATGTTG
gi|514486271|gb|KE346361.1|	2204186	2204200	AAAAC	14	+	2	AAAAC
gi|514486271|gb|KE346361.1|	2204554	2204566	ACCC	12	-	3	GTGG
gi|514486271|gb|KE346361.1|	2204834	2204856	A	22	+	22	A
gi|514486271|gb|KE346361.1|	2204942	2204955	A	13	-	13	T
gi|514486271|gb|KE346361.1|	2205105	2205131	A	26	-	26	T
gi|514486271|gb|KE346361.1|	2205205	2205241	AC	36	+	18	CA
gi|514486271|gb|KE346361.1|	2205334	2205348	A	14	-	14	T
gi|514486271|gb|KE346361.1|	2205510	2205523	A	13	-	13	T
gi|514486271|gb|KE346361.1|	2205784	2205805	A	21	+	21	A
gi|514486271|gb|KE346361.1|	2205847	2205859	AAGGGG	12	-	2	CCTTCC
gi|514486271|gb|KE346361.1|	2207503	2207516	AAGGCC	13	+	2	GCCAAG
gi|514486271|gb|KE346361.1|	2208021	2208033	AAAAC	12	+	2	AAACA
gi|514486271|gb|KE346361.1|	2208057	2208071	AAAAAC	14	+	2	AACAAA
gi|514486271|gb|KE346361.1|	2209472	2209518	AGC	46	+	15	CAG
gi|514486271|gb|KE346361.1|	2209854	2209866	AGCGCG	12	-	2	CGCTCG
gi|514486271|gb|KE346361.1|	2210196	2210210	ATC	14	-	4	TGA
gi|514486271|gb|KE346361.1|	2210421	2210434	ATCGCC	13	-	2	GGCGAT
gi|514486271|gb|KE346361.1|	2210590	2210602	AGC	12	-	4	GCT
gi|514486271|gb|KE346361.1|	2211575	2211592	A	17	+	17	A
gi|514486271|gb|KE346361.1|	2211593	2211605	AAAC	12	+	3	CAAA
gi|514486271|gb|KE346361.1|	2211605	2211619	AAAAC	14	+	2	AAAAC
gi|514486271|gb|KE346361.1|	2212080	2212123	AAG	43	+	14	AAG
gi|514486271|gb|KE346361.1|	2212146	2212163	A	17	-	17	T
gi|514486271|gb|KE346361.1|	2212172	2212196	A	24	-	24	T
gi|514486271|gb|KE346361.1|	2212232	2212247	AG	15	-	7	TC
gi|514486271|gb|KE346361.1|	2212314	2212333	ACC	19	+	6	CAC
gi|514486271|gb|KE346361.1|	2212328	2212341	ACCC	13	+	3	CCAC
gi|514486271|gb|KE346361.1|	2212358	2212370	AGC	12	-	4	GCT
gi|514486271|gb|KE346361.1|	2212945	2212957	AGCTC	12	+	2	AGCTC
gi|514486271|gb|KE346361.1|	2214243	2214256	ACCGCC	13	-	2	GGCGGT
gi|514486271|gb|KE346361.1|	2214475	2214487	A	12	-	12	T
gi|514486271|gb|KE346361.1|	2217042	2217177	AC	135	-	67	GT
gi|514486271|gb|KE346361.1|	2217429	2217456	AGC	27	-	9	CTG
gi|514486271|gb|KE346361.1|	2217653	2217665	AGATG	12	+	2	GATGA
gi|514486271|gb|KE346361.1|	2217732	2217745	AATCGC	13	-	2	TTGCGA
gi|514486271|gb|KE346361.1|	2217759	2217771	ACGCAG	12	-	2	TGCGTC
gi|514486271|gb|KE346361.1|	2218064	2218079	A	15	-	15	T
gi|514486271|gb|KE346361.1|	2218164	2218177	ACACG	13	+	2	CGACA
gi|514486271|gb|KE346361.1|	2218216	2218232	AC	16	+	8	CA
gi|514486271|gb|KE346361.1|	2218395	2218407	AGGCG	12	+	2	AGGCG
gi|514486271|gb|KE346361.1|	2218403	2218428	ACGAG	25	+	5	CGAGA
gi|514486271|gb|KE346361.1|	2218829	2218845	AGC	16	+	5	CAG
gi|514486271|gb|KE346361.1|	2218959	2218971	AAAG	12	-	3	TTTC
gi|514486271|gb|KE346361.1|	2219015	2219030	A	15	-	15	T
gi|514486271|gb|KE346361.1|	2219058	2219078	A	20	-	20	T
gi|514486271|gb|KE346361.1|	2219112	2219124	AAACGC	12	-	2	TTTGCG
gi|514486271|gb|KE346361.1|	2219192	2219216	ATC	24	+	8	TCA
gi|514486271|gb|KE346361.1|	2219277	2219289	A	12	-	12	T
gi|514486271|gb|KE346361.1|	2219722	2219734	AATGTC	12	-	2	ATTGAC
gi|514486271|gb|KE346361.1|	2220622	2220636	ACGAGG	14	-	2	TCCTCG
gi|514486271|gb|KE346361.1|	2220751	2220763	CCGCGG	12	+	2	GCCGCG
gi|514486271|gb|KE346361.1|	2222049	2222065	AAAAAG	16	-	2	TTTTTC
gi|514486271|gb|KE346361.1|	2222066	2222079	AAAAAG	13	-	2	TTTTTC
gi|514486271|gb|KE346361.1|	2222074	2222086	AAACAG	12	-	2	TTTCTG
gi|514486271|gb|KE346361.1|	2223493	2223505	AAGAG	12	+	2	GAGAA
gi|514486271|gb|KE346361.1|	2223975	2223987	AAAGCC	12	+	2	AAAGCC
gi|514486271|gb|KE346361.1|	2224443	2224456	AAAAC	13	+	2	CAAAA
gi|514486271|gb|KE346361.1|	2225192	2225204	AACCAG	12	+	2	AACCAG
gi|514486271|gb|KE346361.1|	2227466	2227481	AC	15	+	7	CA
gi|514486271|gb|KE346361.1|	2227541	2227553	AACC	12	-	3	GTTG
gi|514486271|gb|KE346361.1|	2227564	2227577	AGGGG	13	+	2	GGGAG
gi|514486271|gb|KE346361.1|	2227947	2227960	AAAC	13	+	3	ACAA
gi|514486271|gb|KE346361.1|	2228380	2228403	A	23	+	23	A
gi|514486271|gb|KE346361.1|	2229638	2229651	AAAC	13	+	3	AACA
gi|514486271|gb|KE346361.1|	2229659	2229675	AAAAC	16	+	3	AAACA
gi|514486271|gb|KE346361.1|	2230438	2230456	A	18	+	18	A
gi|514486271|gb|KE346361.1|	2230755	2230767	AGATGC	12	+	2	GCAGAT
gi|514486271|gb|KE346361.1|	2231642	2231654	AAACTC	12	-	2	GTTTGA
gi|514486271|gb|KE346361.1|	2231800	2231815	ACCCCC	15	-	2	GTGGGG
gi|514486271|gb|KE346361.1|	2232163	2232175	AAGTG	12	+	2	AGTGA
gi|514486271|gb|KE346361.1|	2232266	2232288	AGCATG	22	-	3	TGCTCA
gi|514486271|gb|KE346361.1|	2232300	2232314	CCG	14	-	4	GGC
gi|514486271|gb|KE346361.1|	2232654	2232668	ACTC	14	-	3	GAGT
gi|514486271|gb|KE346361.1|	2232953	2232969	AGAGGG	16	+	2	GAGAGG
gi|514486271|gb|KE346361.1|	2233014	2233028	AGC	14	+	4	AGC
gi|514486271|gb|KE346361.1|	2233301	2233319	AGGGGG	18	+	3	GGAGGG
gi|514486271|gb|KE346361.1|	2234228	2234242	A	14	-	14	T
gi|514486271|gb|KE346361.1|	2234359	2234374	AAAGAC	15	-	2	TGTCTT
gi|514486271|gb|KE346361.1|	2234413	2234425	AG	12	-	6	CT
gi|514486271|gb|KE346361.1|	2234437	2234449	ATC	12	-	4	GAT
gi|514486271|gb|KE346361.1|	2234584	2234597	AGCAGG	13	-	2	CCTGCT
gi|514486271|gb|KE346361.1|	2235535	2235558	A	23	-	23	T
gi|514486271|gb|KE346361.1|	2235589	2235601	AAAAC	12	-	2	TTTGT
gi|514486271|gb|KE346361.1|	2235854	2235868	AGAGAT	14	+	2	AGAGAT
gi|514486271|gb|KE346361.1|	2236124	2236138	ACTC	14	-	3	GAGT
gi|514486271|gb|KE346361.1|	2236199	2236213	AAAAAT	14	-	2	TTTTAT
gi|514486271|gb|KE346361.1|	2236369	2236381	A	12	-	12	T
gi|514486271|gb|KE346361.1|	2236840	2236852	A	12	-	12	T
gi|514486271|gb|KE346361.1|	2237308	2237323	ACCTCC	15	+	2	CTCCAC
gi|514486271|gb|KE346361.1|	2237394	2237411	AAC	17	+	5	CAA
gi|514486271|gb|KE346361.1|	2237528	2237543	ACT	15	+	5	ACT
gi|514486271|gb|KE346361.1|	2237538	2237552	ACTGCT	14	+	2	CTACTG
gi|514486271|gb|KE346361.1|	2237594	2237606	AAGAGG	12	-	2	CTCTTC
gi|514486271|gb|KE346361.1|	2239042	2239055	AAAAC	13	-	2	TTTTG
gi|514486271|gb|KE346361.1|	2239212	2239224	C	12	-	12	G
gi|514486271|gb|KE346361.1|	2239295	2239311	A	16	-	16	T
gi|514486271|gb|KE346361.1|	2239645	2239658	AGC	13	+	4	GCA
gi|514486271|gb|KE346361.1|	2241436	2241450	AGC	14	+	4	GCA
gi|514486271|gb|KE346361.1|	2241451	2241471	ACG	20	+	6	GAC
gi|514486271|gb|KE346361.1|	2241557	2241569	ACGCTC	12	-	2	GCGTGA
gi|514486271|gb|KE346361.1|	2241679	2241693	AAC	14	+	4	CAA
gi|514486271|gb|KE346361.1|	2241840	2241852	ACCGCG	12	-	2	TCGCGG
gi|514486271|gb|KE346361.1|	2243068	2243083	AAAC	15	-	3	TTTG
gi|514486271|gb|KE346361.1|	2243220	2243232	AAAC	12	+	3	AAAC
gi|514486271|gb|KE346361.1|	2243233	2243245	AAAAC	12	+	2	AACAA
gi|514486271|gb|KE346361.1|	2243351	2243363	C	12	+	12	C
gi|514486271|gb|KE346361.1|	2244096	2244108	ACCGAG	12	-	2	TCTCGG
gi|514486271|gb|KE346361.1|	2244616	2244628	AC	12	+	6	AC
gi|514486271|gb|KE346361.1|	2244754	2244770	AAC	16	+	5	AAC
gi|514486271|gb|KE346361.1|	2244777	2244791	AAC	14	+	4	CAA
gi|514486271|gb|KE346361.1|	2244860	2244872	AACTGC	12	+	2	CTGCAA
gi|514486271|gb|KE346361.1|	2245475	2245493	AAAAC	18	+	3	AAAAC
gi|514486271|gb|KE346361.1|	2245487	2245501	AAAC	14	+	3	AACA
gi|514486271|gb|KE346361.1|	2245498	2245514	A	16	+	16	A
gi|514486271|gb|KE346361.1|	2245668	2245681	AGGGG	13	-	2	CCCCT
gi|514486271|gb|KE346361.1|	2245686	2245698	CCG	12	+	4	CCG
gi|514486271|gb|KE346361.1|	2246591	2246603	AGC	12	-	4	GCT
gi|514486271|gb|KE346361.1|	2247033	2247051	CCG	18	+	6	GCC
gi|514486271|gb|KE346361.1|	2247059	2247076	AGCAGG	17	-	2	CTCCTG
gi|514486271|gb|KE346361.1|	2247210	2247223	ACCAGC	13	+	2	ACCAGC
gi|514486271|gb|KE346361.1|	2247218	2247231	AGC	13	+	4	CAG
gi|514486271|gb|KE346361.1|	2247478	2247497	ACCGCG	19	+	3	CGACCG
gi|514486271|gb|KE346361.1|	2247628	2247641	AAC	13	+	4	AAC
gi|514486271|gb|KE346361.1|	2247860	2247872	ACTCGG	12	+	2	TCGGAC
gi|514486271|gb|KE346361.1|	2249136	2249148	ACATCC	12	-	2	ATGTGG
gi|514486271|gb|KE346361.1|	2249436	2249460	A	24	+	24	A
gi|514486271|gb|KE346361.1|	2250244	2250258	AAC	14	-	4	TTG
gi|514486271|gb|KE346361.1|	2250869	2250882	AG	13	+	6	AG
gi|514486271|gb|KE346361.1|	2250996	2251008	ACCTCC	12	-	2	TGGAGG
gi|514486271|gb|KE346361.1|	2251185	2251203	ACG	18	-	6	GTC
gi|514486271|gb|KE346361.1|	2251283	2251299	AGC	16	-	5	GCT
gi|514486271|gb|KE346361.1|	2251468	2251488	ACCTGC	20	+	3	GCACCT
gi|514486271|gb|KE346361.1|	2251608	2251621	AGG	13	-	4	TCC
gi|514486271|gb|KE346361.1|	2251887	2251900	ACAGT	13	+	2	GTACA
gi|514486271|gb|KE346361.1|	2252834	2252850	AAC	16	-	5	GTT
gi|514486271|gb|KE346361.1|	2253623	2253636	AAAAAC	13	-	2	TTTGTT
gi|514486271|gb|KE346361.1|	2254048	2254061	AAGGGG	13	-	2	CTTCCC
gi|514486271|gb|KE346361.1|	2254125	2254139	ACGAGG	14	+	2	GAGGAC
gi|514486271|gb|KE346361.1|	2254456	2254469	AGCGGC	13	+	2	GCAGCG
gi|514486271|gb|KE346361.1|	2254545	2254557	ACCACG	12	-	2	CGTGGT
gi|514486271|gb|KE346361.1|	2254597	2254611	AAC	14	-	4	TGT
gi|514486271|gb|KE346361.1|	2255502	2255514	AACTGC	12	-	2	AGTTGC
gi|514486271|gb|KE346361.1|	2255727	2255748	ACTCTC	21	+	3	CTCACT
gi|514486271|gb|KE346361.1|	2256346	2256359	A	13	+	13	A
gi|514486271|gb|KE346361.1|	2257449	2257468	AGC	19	+	6	GCA
gi|514486271|gb|KE346361.1|	2257592	2257611	AGC	19	+	6	AGC
gi|514486271|gb|KE346361.1|	2258146	2258164	AACGG	18	+	3	AACGG
gi|514486271|gb|KE346361.1|	2258297	2258309	AATGC	12	+	2	CAATG
gi|514486271|gb|KE346361.1|	2258383	2258396	AAAG	13	-	3	TTTC
gi|514486271|gb|KE346361.1|	2258515	2258531	AG	16	-	8	TC
gi|514486271|gb|KE346361.1|	2258612	2258637	A	25	-	25	T
gi|514486271|gb|KE346361.1|	2258779	2258792	AACATC	13	+	2	CATCAA
gi|514486271|gb|KE346361.1|	2258843	2258864	A	21	+	21	A
gi|514486271|gb|KE346361.1|	2258877	2258913	A	36	+	36	A
gi|514486271|gb|KE346361.1|	2259267	2259304	AG	37	-	18	TC
gi|514486271|gb|KE346361.1|	2261146	2261159	ATC	13	-	4	GAT
gi|514486271|gb|KE346361.1|	2261392	2261405	CCG	13	+	4	GCC
gi|514486271|gb|KE346361.1|	2261438	2261452	AGC	14	+	4	AGC
gi|514486271|gb|KE346361.1|	2262246	2262258	AGGGGG	12	-	2	TCCCCC
gi|514486271|gb|KE346361.1|	2262954	2262966	AAAGCG	12	+	2	GAAAGC
gi|514486271|gb|KE346361.1|	2263497	2263510	AC	13	-	6	GT
gi|514486271|gb|KE346361.1|	2264139	2264153	ACTG	14	+	3	ACTG
gi|514486271|gb|KE346361.1|	2264323	2264335	AAGGGG	12	-	2	CTTCCC
gi|514486271|gb|KE346361.1|	2264366	2264392	A	26	-	26	T
gi|514486271|gb|KE346361.1|	2264556	2264568	AAGCTC	12	-	2	GCTTGA
gi|514486271|gb|KE346361.1|	2264602	2264615	AAACTC	13	+	2	AACTCA
gi|514486271|gb|KE346361.1|	2265147	2265166	AAC	19	-	6	GTT
gi|514486271|gb|KE346361.1|	2265161	2265211	AACAGC	50	-	8	TGTTGC
gi|514486271|gb|KE346361.1|	2265206	2265220	AGC	14	-	4	TGC
gi|514486271|gb|KE346361.1|	2266046	2266058	AG	12	-	6	CT
gi|514486271|gb|KE346361.1|	2266236	2266249	AACAC	13	+	2	ACAAC
gi|514486271|gb|KE346361.1|	2266510	2266524	AAAACC	14	+	2	AACCAA
gi|514486271|gb|KE346361.1|	2267807	2267819	A	12	+	12	A
gi|514486271|gb|KE346361.1|	2268088	2268103	AAC	15	+	5	ACA
gi|514486271|gb|KE346361.1|	2268130	2268142	AAAAAC	12	+	2	AAAAAC
gi|514486271|gb|KE346361.1|	2268276	2268289	ACGAGT	13	+	2	GTACGA
gi|514486271|gb|KE346361.1|	2269036	2269048	C	12	-	12	G
gi|514486271|gb|KE346361.1|	2269220	2269237	A	17	+	17	A
gi|514486271|gb|KE346361.1|	2269267	2269282	A	15	-	15	T
gi|514486271|gb|KE346361.1|	2270982	2270994	ACTCC	12	-	2	GAGTG
gi|514486271|gb|KE346361.1|	2271061	2271073	ACGGGG	12	-	2	CCGTCC
gi|514486271|gb|KE346361.1|	2271198	2271225	A	27	-	27	T
gi|514486271|gb|KE346361.1|	2271703	2271720	ATCC	17	-	4	TGGA
gi|514486271|gb|KE346361.1|	2272015	2272031	ATCGGC	16	+	2	TCGGCA
gi|514486271|gb|KE346361.1|	2272416	2272433	A	17	+	17	A
gi|514486271|gb|KE346361.1|	2273638	2273655	AAAAC	17	-	3	TTTGT
gi|514486271|gb|KE346361.1|	2273649	2273663	AAAC	14	-	3	TTGT
gi|514486271|gb|KE346361.1|	2273747	2273759	AATCC	12	+	2	AATCC
gi|514486271|gb|KE346361.1|	2273779	2273791	AAAG	12	-	3	TCTT
gi|514486271|gb|KE346361.1|	2274331	2274343	ACCTCC	12	+	2	CCTCCA
gi|514486271|gb|KE346361.1|	2274477	2274500	A	23	+	23	A
gi|514486271|gb|KE346361.1|	2274518	2274575	A	57	-	57	T
gi|514486271|gb|KE346361.1|	2274785	2274800	CCG	15	+	5	GCC
gi|514486271|gb|KE346361.1|	2274986	2275003	AAC	17	-	5	TTG
gi|514486271|gb|KE346361.1|	2275400	2275412	AAACAC	12	-	2	TGTGTT
gi|514486271|gb|KE346361.1|	2276172	2276184	ACGGCG	12	+	2	GCGACG
gi|514486271|gb|KE346361.1|	2276446	2276461	ACGCTG	15	+	2	GCTGAC
gi|514486271|gb|KE346361.1|	2277645	2277657	AGATGC	12	+	2	TGCAGA
gi|514486271|gb|KE346361.1|	2279584	2279596	AAAAAG	12	+	2	GAAAAA
gi|514486271|gb|KE346361.1|	2279591	2279607	AAAAAC	16	+	2	AAAAAC
gi|514486271|gb|KE346361.1|	2279703	2279718	AC	15	+	7	CA
gi|514486271|gb|KE346361.1|	2279736	2279748	AC	12	+	6	AC
gi|514486271|gb|KE346361.1|	2279757	2279770	AC	13	+	6	CA
gi|514486271|gb|KE346361.1|	2280089	2280105	AG	16	-	8	TC
gi|514486271|gb|KE346361.1|	2280106	2280122	AG	16	-	8	CT
gi|514486271|gb|KE346361.1|	2280171	2280183	AAGGGC	12	+	2	GGCAAG
gi|514486271|gb|KE346361.1|	2280283	2280298	AAAC	15	-	3	TTGT
gi|514486271|gb|KE346361.1|	2280545	2280560	AAG	15	+	5	AAG
gi|514486271|gb|KE346361.1|	2280561	2280573	A	12	+	12	A
gi|514486271|gb|KE346361.1|	2280581	2280594	AAG	13	+	4	AGA
gi|514486271|gb|KE346361.1|	2280597	2280609	AAAAAG	12	+	2	AAAAAG
gi|514486271|gb|KE346361.1|	2281002	2281015	ACAT	13	-	3	ATGT
gi|514486271|gb|KE346361.1|	2281340	2281353	ACGGCG	13	-	2	CGCCGT
gi|514486271|gb|KE346361.1|	2281559	2281572	ACC	13	-	4	GTG
gi|514486271|gb|KE346361.1|	2281747	2281760	AAATTG	13	+	2	AATTGA
gi|514486271|gb|KE346361.1|	2281772	2281789	A	17	+	17	A
gi|514486271|gb|KE346361.1|	2282060	2282072	C	12	-	12	G
gi|514486271|gb|KE346361.1|	2282522	2282535	AACACC	13	-	2	TTGGTG
gi|514486271|gb|KE346361.1|	2283079	2283091	AAAAAC	12	-	2	TTGTTT
gi|514486271|gb|KE346361.1|	2283299	2283333	AAAC	34	+	8	AAAC
gi|514486271|gb|KE346361.1|	2284434	2284446	ACCGAG	12	+	2	CCGAGA
gi|514486271|gb|KE346361.1|	2284629	2284641	AAGC	12	+	3	AAGC
gi|514486271|gb|KE346361.1|	2285890	2285904	AACGC	14	-	2	GCGTT
gi|514486271|gb|KE346361.1|	2287374	2287387	ACTGC	13	-	2	CAGTG
gi|514486271|gb|KE346361.1|	2287723	2287737	AAATC	14	-	2	GATTT
gi|514486271|gb|KE346361.1|	2287774	2287786	AAAGAC	12	-	2	TCTTTG
gi|514486271|gb|KE346361.1|	2287799	2287818	A	19	-	19	T
gi|514486271|gb|KE346361.1|	2288028	2288047	ACTCTC	19	+	3	CTCACT
gi|514486271|gb|KE346361.1|	2288127	2288148	ACTGCC	21	-	3	GGCAGT
gi|514486271|gb|KE346361.1|	2288366	2288383	CCG	17	-	5	CGG
gi|514486271|gb|KE346361.1|	2289123	2289149	AGC	26	+	8	CAG
gi|514486271|gb|KE346361.1|	2289150	2289164	AACAGC	14	+	2	CAGCAA
gi|514486271|gb|KE346361.1|	2289408	2289420	ACGCG	12	+	2	CGACG
gi|514486271|gb|KE346361.1|	2289417	2289430	AGCGC	13	+	2	GCGCA
gi|514486271|gb|KE346361.1|	2289955	2289969	AC	14	-	7	TG
gi|514486271|gb|KE346361.1|	2290803	2290815	AACAGC	12	-	2	GTTGCT
gi|514486271|gb|KE346361.1|	2290814	2290827	AAAAAG	13	-	2	TTTCTT
gi|514486271|gb|KE346361.1|	2291333	2291442	AC	109	+	54	AC
gi|514486271|gb|KE346361.1|	2292597	2292617	ATC	20	-	6	ATG
gi|514486271|gb|KE346361.1|	2292816	2292833	AGC	17	-	5	CTG
gi|514486271|gb|KE346361.1|	2292828	2292849	AGCAGG	21	-	3	CTGCTC
gi|514486271|gb|KE346361.1|	2293271	2293312	ACTC	41	+	10	CTCA
gi|514486271|gb|KE346361.1|	2293563	2293575	AAGCAG	12	-	2	CTGCTT
gi|514486271|gb|KE346361.1|	2295222	2295236	ACCTCG	14	-	2	GTCGAG
gi|514486271|gb|KE346361.1|	2295504	2295516	AATC	12	-	3	TGAT
gi|514486271|gb|KE346361.1|	2295530	2295547	AAAAAC	17	-	2	TTTTTG
gi|514486271|gb|KE346361.1|	2295610	2295626	AACAGC	16	-	2	GTTGCT
gi|514486271|gb|KE346361.1|	2297056	2297070	AAAAAC	14	+	2	AAACAA
gi|514486271|gb|KE346361.1|	2297171	2297185	AG	14	+	7	AG
gi|514486271|gb|KE346361.1|	2297186	2297200	AG	14	+	7	GA
gi|514486271|gb|KE346361.1|	2297705	2297728	A	23	+	23	A
gi|514486271|gb|KE346361.1|	2297725	2297741	AAAGC	16	+	3	AAAGC
gi|514486271|gb|KE346361.1|	2297995	2298016	AAGG	21	+	5	GGAA
gi|514486271|gb|KE346361.1|	2298020	2298032	A	12	+	12	A
gi|514486271|gb|KE346361.1|	2298989	2299001	ACC	12	+	4	ACC
gi|514486271|gb|KE346361.1|	2299181	2299201	ATC	20	-	6	TGA
gi|514486271|gb|KE346361.1|	2299253	2299267	AGC	14	-	4	TGC
gi|514486271|gb|KE346361.1|	2299262	2299274	AGCATC	12	-	2	TGCTGA
gi|514486271|gb|KE346361.1|	2299485	2299505	AGC	20	-	6	TGC
gi|514486271|gb|KE346361.1|	2299516	2299541	ATC	25	-	8	GAT
gi|514486271|gb|KE346361.1|	2299770	2299782	AACAAG	12	+	2	AACAAG
gi|514486271|gb|KE346361.1|	2300501	2300513	AAGAGG	12	+	2	GAGGAA
gi|514486271|gb|KE346361.1|	2300655	2300667	ACACAT	12	-	2	ATGTGT
gi|514486271|gb|KE346361.1|	2300778	2300823	ATC	45	+	15	ATC
gi|514486271|gb|KE346361.1|	2301052	2301076	AG	24	+	12	GA
gi|514486271|gb|KE346361.1|	2301160	2301172	ATC	12	+	4	CAT
gi|514486271|gb|KE346361.1|	2301367	2301379	AGC	12	+	4	GCA
gi|514486271|gb|KE346361.1|	2301464	2301484	AGCCCC	20	+	3	CCCCAG
gi|514486271|gb|KE346361.1|	2301658	2301671	AACACC	13	+	2	CCAACA
gi|514486271|gb|KE346361.1|	2301940	2301958	ACCAGC	18	-	3	TGGTGC
gi|514486271|gb|KE346361.1|	2302176	2302190	ACCGCT	14	-	2	GCGGTA
gi|514486271|gb|KE346361.1|	2302494	2302512	ACG	18	+	6	ACG
gi|514486271|gb|KE346361.1|	2302916	2302933	AGG	17	+	5	GGA
gi|514486271|gb|KE346361.1|	2304386	2304398	ACGCCG	12	-	2	GTCGGC
gi|514486271|gb|KE346361.1|	2304964	2304981	AAGTGC	17	+	2	AGTGCA
gi|514486271|gb|KE346361.1|	2304997	2305010	AGC	13	-	4	TGC
gi|514486271|gb|KE346361.1|	2305166	2305179	AC	13	+	6	CA
gi|514486271|gb|KE346361.1|	2305180	2305194	AC	14	+	7	CA
gi|514486271|gb|KE346361.1|	2305890	2305907	AAG	17	-	5	TTC
gi|514486271|gb|KE346361.1|	2306117	2306141	AGC	24	-	8	CTG
gi|514486271|gb|KE346361.1|	2306247	2306259	ACTGC	12	-	2	TGCAG
gi|514486271|gb|KE346361.1|	2306399	2306421	A	22	+	22	A
gi|514486271|gb|KE346361.1|	2306517	2306530	AC	13	+	6	CA
gi|514486271|gb|KE346361.1|	2306614	2306626	AAAAAG	12	-	2	TTCTTT
gi|514486271|gb|KE346361.1|	2306633	2306648	AAAAC	15	-	3	TTGTT
gi|514486271|gb|KE346361.1|	2306715	2306748	A	33	-	33	T
gi|514486271|gb|KE346361.1|	2306956	2306970	AAAAG	14	-	2	TTTTC
gi|514486271|gb|KE346361.1|	2306966	2306979	A	13	-	13	T
gi|514486271|gb|KE346361.1|	2307100	2307113	AGAGGG	13	-	2	CCCTCT
gi|514486271|gb|KE346361.1|	2307198	2307211	A	13	-	13	T
gi|514486271|gb|KE346361.1|	2307405	2307428	A	23	-	23	T
gi|514486271|gb|KE346361.1|	2307459	2307472	AAGAGC	13	-	2	TGCTCT
gi|514486271|gb|KE346361.1|	2307519	2307531	AACAGC	12	-	2	TTGCTG
gi|514486271|gb|KE346361.1|	2307541	2307556	AGCGC	15	-	3	CGCTG
gi|514486271|gb|KE346361.1|	2307702	2307717	ACTGCG	15	+	2	CTGCGA
gi|514486271|gb|KE346361.1|	2307758	2307770	AAAAAT	12	-	2	ATTTTT
gi|514486271|gb|KE346361.1|	2307960	2307972	A	12	-	12	T
gi|514486271|gb|KE346361.1|	2309249	2309263	AACAGC	14	-	2	TGTTGC
gi|514486271|gb|KE346361.1|	2309323	2309348	A	25	-	25	T
gi|514486271|gb|KE346361.1|	2309346	2309366	AAC	20	-	6	TTG
gi|514486271|gb|KE346361.1|	2309561	2309574	AAAAAC	13	+	2	AAAAAC
gi|514486271|gb|KE346361.1|	2309668	2309690	A	22	+	22	A
gi|514486271|gb|KE346361.1|	2309814	2309827	AACGCC	13	-	2	GCGTTG
gi|514486271|gb|KE346361.1|	2310726	2310766	A	40	+	40	A
gi|514486271|gb|KE346361.1|	2312555	2312567	AACAAG	12	-	2	TTCTTG
gi|514486271|gb|KE346361.1|	2313096	2313108	AAAAAG	12	-	2	TCTTTT
gi|514486271|gb|KE346361.1|	2313205	2313217	A	12	+	12	A
gi|514486271|gb|KE346361.1|	2313793	2313806	ACCGCG	13	-	2	GGTCGC
gi|514486271|gb|KE346361.1|	2314028	2314043	ACCCCC	15	-	2	TGGGGG
gi|514486271|gb|KE346361.1|	2314885	2314900	A	15	-	15	T
gi|514486271|gb|KE346361.1|	2315098	2315112	AAAAT	14	+	2	AAAAT
gi|514486271|gb|KE346361.1|	2315300	2315333	A	33	+	33	A
gi|514486271|gb|KE346361.1|	2315340	2315358	AAC	18	+	6	CAA
gi|514486271|gb|KE346361.1|	2315356	2315371	AAAAAG	15	+	2	AAAGAA
gi|514486271|gb|KE346361.1|	2315516	2315538	A	22	+	22	A
gi|514486271|gb|KE346361.1|	2315560	2315579	A	19	+	19	A
gi|514486271|gb|KE346361.1|	2315800	2315813	A	13	+	13	A
gi|514486271|gb|KE346361.1|	2315850	2315863	A	13	+	13	A
gi|514486271|gb|KE346361.1|	2315915	2315927	AAAAAC	12	-	2	TTGTTT
gi|514486271|gb|KE346361.1|	2318795	2318808	AAC	13	-	4	TTG
gi|514486271|gb|KE346361.1|	2318921	2318934	AAGCTC	13	-	2	TGAGCT
gi|514486271|gb|KE346361.1|	2319278	2319304	A	26	+	26	A
gi|514486271|gb|KE346361.1|	2319490	2319502	A	12	+	12	A
gi|514486271|gb|KE346361.1|	2322342	2322354	AAGC	12	-	3	CTTG
gi|514486271|gb|KE346361.1|	2322912	2322924	AGC	12	-	4	GCT
gi|514486271|gb|KE346361.1|	2322991	2323008	ACCCCC	17	-	2	GGTGGG
gi|514486271|gb|KE346361.1|	2323036	2323051	ATC	15	-	5	GAT
gi|514486271|gb|KE346361.1|	2323456	2323468	ATGGCC	12	+	2	GGCCAT
gi|514486271|gb|KE346361.1|	2328284	2328500	AAC	216	-	72	TTG
gi|514486271|gb|KE346361.1|	2330520	2330533	ACATGG	13	+	2	ACATGG
gi|514486271|gb|KE346361.1|	2330647	2330670	ACC	23	+	7	ACC
gi|514486271|gb|KE346361.1|	2330734	2330747	ACCACG	13	+	2	ACCACG
gi|514486271|gb|KE346361.1|	2330852	2330864	ACGGCC	12	+	2	CCACGG
gi|514486271|gb|KE346361.1|	2331137	2331150	AAAAAC	13	+	2	AAACAA
gi|514486271|gb|KE346361.1|	2331319	2331331	AAAGGG	12	+	2	GGGAAA
gi|514486271|gb|KE346361.1|	2331361	2331373	AACAAT	12	-	2	ATTGTT
gi|514486271|gb|KE346361.1|	2331436	2331448	AACAAT	12	-	2	ATTGTT
gi|514486271|gb|KE346361.1|	2331475	2331487	AACAAT	12	+	2	AACAAT
gi|514486271|gb|KE346361.1|	2331534	2331546	AACAAT	12	-	2	ATTGTT
gi|514486271|gb|KE346361.1|	2331552	2331564	AACGAC	12	+	2	ACAACG
gi|514486271|gb|KE346361.1|	2332036	2332053	ACTG	17	+	4	GACT
gi|514486271|gb|KE346361.1|	2332256	2332268	ACGGGG	12	-	2	CCGTCC
gi|514486271|gb|KE346361.1|	2332331	2332344	ACC	13	+	4	CCA
gi|514486271|gb|KE346361.1|	2332539	2332551	AGGGGC	12	-	2	CTGCCC
gi|514486271|gb|KE346361.1|	2333917	2333947	ATC	30	-	10	TGA
gi|514486271|gb|KE346361.1|	2334346	2334363	CCG	17	-	5	GGC
gi|514486271|gb|KE346361.1|	2335603	2335617	ACATCC	14	+	2	TCCACA
gi|514486271|gb|KE346361.1|	2335627	2335639	AGGCGG	12	-	2	TCCGCC
gi|514486271|gb|KE346361.1|	2336202	2336215	AGGATG	13	-	2	CTCATC
gi|514486271|gb|KE346361.1|	2338097	2338110	AAAC	13	+	3	CAAA
gi|514486271|gb|KE346361.1|	2338123	2338136	AAAAC	13	+	2	AAACA
gi|514486271|gb|KE346361.1|	2338245	2338259	A	14	+	14	A
gi|514486271|gb|KE346361.1|	2338556	2338568	AACGGG	12	+	2	GGAACG
gi|514486271|gb|KE346361.1|	2339611	2339623	AAATCG	12	+	2	AAATCG
gi|514486271|gb|KE346361.1|	2340010	2340023	A	13	+	13	A
gi|514486271|gb|KE346361.1|	2340072	2340084	AATC	12	-	3	TGAT
gi|514486271|gb|KE346361.1|	2340374	2340386	AAAAAG	12	+	2	AAAAGA
gi|514486271|gb|KE346361.1|	2340519	2340531	AAAAAC	12	+	2	AACAAA
gi|514486271|gb|KE346361.1|	2340837	2340849	A	12	+	12	A
gi|514486271|gb|KE346361.1|	2340941	2340954	AAAAC	13	+	2	AAACA
gi|514486271|gb|KE346361.1|	2341298	2341319	AAAC	21	+	5	ACAA
gi|514486271|gb|KE346361.1|	2341318	2341334	AAAAAT	16	+	2	AAAAAT
gi|514486271|gb|KE346361.1|	2341349	2341362	AAAAT	13	+	2	AAATA
gi|514486271|gb|KE346361.1|	2341432	2341455	AAAAAT	23	+	3	AAAAAT
gi|514486271|gb|KE346361.1|	2341524	2341544	AACGAC	20	+	3	ACGACA
gi|514486271|gb|KE346361.1|	2341547	2341559	ACGCTG	12	+	2	GACGCT
gi|514486271|gb|KE346361.1|	2341669	2341683	A	14	-	14	T
gi|514486271|gb|KE346361.1|	2341816	2341830	AATGGC	14	-	2	TGCCAT
gi|514486271|gb|KE346361.1|	2341922	2341938	ATCCGC	16	-	2	GATGCG
gi|514486271|gb|KE346361.1|	2342054	2342076	A	22	+	22	A
gi|514486271|gb|KE346361.1|	2342314	2342328	A	14	+	14	A
gi|514486271|gb|KE346361.1|	2342641	2342658	A	17	-	17	T
gi|514486271|gb|KE346361.1|	2343079	2343091	ACCTCC	12	+	2	TCCACC
gi|514486271|gb|KE346361.1|	2343151	2343170	A	19	-	19	T
gi|514486271|gb|KE346361.1|	2343188	2343210	AACGGC	22	-	3	CGTTGC
gi|514486271|gb|KE346361.1|	2343492	2343505	AAAGTG	13	-	2	TCACTT
gi|514486271|gb|KE346361.1|	2343573	2343585	AGC	12	-	4	TGC
gi|514486271|gb|KE346361.1|	2343765	2343777	AAGGCC	12	+	2	GCCAAG
gi|514486271|gb|KE346361.1|	2345091	2345105	ATC	14	+	4	CAT
gi|514486271|gb|KE346361.1|	2345178	2345190	AGCCGC	12	+	2	AGCCGC
gi|514486271|gb|KE346361.1|	2345266	2345297	A	31	+	31	A
gi|514486271|gb|KE346361.1|	2345491	2345505	AGG	14	-	4	CTC
gi|514486271|gb|KE346361.1|	2345654	2345673	AAAAG	19	-	3	TTTTC
gi|514486271|gb|KE346361.1|	2345669	2345701	A	32	-	32	T
gi|514486271|gb|KE346361.1|	2345726	2345739	AACCCC	13	+	2	CCCCAA
gi|514486271|gb|KE346361.1|	2345996	2346008	CCGGCG	12	+	2	CGCCGG
gi|514486271|gb|KE346361.1|	2346522	2346534	AGCTCC	12	+	2	GCTCCA
gi|514486271|gb|KE346361.1|	2346707	2346719	AGCTCC	12	+	2	TCCAGC
gi|514486271|gb|KE346361.1|	2347803	2347821	AGC	18	-	6	TGC
gi|514486271|gb|KE346361.1|	2347955	2347974	ACC	19	+	6	CCA
gi|514486271|gb|KE346361.1|	2348218	2348241	AAC	23	+	7	CAA
gi|514486271|gb|KE346361.1|	2349052	2349068	A	16	-	16	T
gi|514486271|gb|KE346361.1|	2350624	2350636	AAAAAC	12	+	2	CAAAAA
gi|514486271|gb|KE346361.1|	2350631	2350652	A	21	+	21	A
gi|514486271|gb|KE346361.1|	2350863	2350875	AAGTG	12	+	2	GAAGT
gi|514486271|gb|KE346361.1|	2352054	2352081	AGC	27	+	9	GCA
gi|514486271|gb|KE346361.1|	2352213	2352242	ACG	29	+	9	GAC
gi|514486271|gb|KE346361.1|	2352387	2352404	ACAGT	17	-	3	TGTAC
gi|514486271|gb|KE346361.1|	2354221	2354243	AGC	22	+	7	CAG
gi|514486271|gb|KE346361.1|	2355067	2355079	AGC	12	+	4	CAG
gi|514486271|gb|KE346361.1|	2356455	2356477	AGC	22	+	7	GCA
gi|514486271|gb|KE346361.1|	2356472	2356484	AAGCAG	12	+	2	AGCAGA
gi|514486271|gb|KE346361.1|	2356479	2356496	ACGCAG	17	+	2	GCAGAC
gi|514486271|gb|KE346361.1|	2356558	2356573	AAAC	15	-	3	TTTG
gi|514486271|gb|KE346361.1|	2356894	2356907	AAATCT	13	+	2	AATCTA
gi|514486271|gb|KE346361.1|	2357700	2357716	AACATC	16	+	2	CAACAT
gi|514486271|gb|KE346361.1|	2360495	2360507	ACCTCG	12	+	2	CCTCGA
gi|514486271|gb|KE346361.1|	2360520	2360534	AAC	14	-	4	GTT
gi|514486271|gb|KE346361.1|	2360684	2360719	AGC	35	-	11	GCT
gi|514486271|gb|KE346361.1|	2360762	2360778	A	16	-	16	T
gi|514486271|gb|KE346361.1|	2361967	2361983	AGGCGG	16	-	2	CCGCCT
gi|514486271|gb|KE346361.1|	2362271	2362283	AACCAG	12	-	2	CTGGTT
gi|514486271|gb|KE346361.1|	2363038	2363055	AAAC	17	+	4	ACAA
gi|514486271|gb|KE346361.1|	2363897	2363909	AGCGC	12	+	2	CAGCG
gi|514486271|gb|KE346361.1|	2365086	2365098	AAACC	12	+	2	AACCA
gi|514486271|gb|KE346361.1|	2367364	2367376	ACACTG	12	+	2	TGACAC
gi|514486271|gb|KE346361.1|	2368682	2368695	AACC	13	-	3	TTGG
gi|514486271|gb|KE346361.1|	2368960	2368975	AGC	15	+	5	GCA
gi|514486271|gb|KE346361.1|	2368990	2369002	AAACCC	12	-	2	TTGGGT
gi|514486271|gb|KE346361.1|	2369109	2369123	AGCAGG	14	+	2	AGGAGC
gi|514486271|gb|KE346361.1|	2369281	2369293	AAAC	12	-	3	TTTG
gi|514486271|gb|KE346361.1|	2369290	2369305	AACC	15	-	3	TTGG
gi|514486271|gb|KE346361.1|	2370775	2370787	A	12	-	12	T
gi|514486271|gb|KE346361.1|	2370790	2370802	A	12	-	12	T
gi|514486271|gb|KE346361.1|	2370814	2370827	A	13	-	13	T
gi|514486271|gb|KE346361.1|	2370829	2370845	A	16	-	16	T
gi|514486271|gb|KE346361.1|	2370842	2370855	AAAC	13	-	3	TTTG
gi|514486271|gb|KE346361.1|	2371882	2371899	AG	17	+	8	AG
gi|514486271|gb|KE346361.1|	2372057	2372069	A	12	+	12	A
gi|514486271|gb|KE346361.1|	2372577	2372589	AAAAGG	12	+	2	AAGGAA
gi|514486271|gb|KE346361.1|	2372625	2372637	A	12	-	12	T
gi|514486271|gb|KE346361.1|	2372651	2372670	A	19	-	19	T
gi|514486271|gb|KE346361.1|	2373549	2373561	AACCCC	12	-	2	GTTGGG
gi|514486271|gb|KE346361.1|	2374087	2374137	AC	50	-	25	TG
gi|514486271|gb|KE346361.1|	2374162	2374174	AAGGGG	12	+	2	AAGGGG
gi|514486271|gb|KE346361.1|	2375145	2375182	A	37	+	37	A
gi|514486271|gb|KE346361.1|	2376750	2376764	AAATCC	14	+	2	CCAAAT
gi|514486271|gb|KE346361.1|	2376765	2376789	A	24	+	24	A
gi|514486271|gb|KE346361.1|	2376815	2376840	A	25	+	25	A
gi|514486271|gb|KE346361.1|	2377085	2377100	ACCCC	15	-	3	TGGGG
gi|514486271|gb|KE346361.1|	2377174	2377189	A	15	-	15	T
gi|514486271|gb|KE346361.1|	2377203	2377229	A	26	-	26	T
gi|514486271|gb|KE346361.1|	2377787	2377799	AAACCC	12	+	2	AACCCA
gi|514486271|gb|KE346361.1|	2377800	2377815	AGCC	15	+	3	CCAG
gi|514486271|gb|KE346361.1|	2378103	2378130	AAC	27	+	9	AAC
gi|514486271|gb|KE346361.1|	2378958	2378973	AAAC	15	+	3	AAAC
gi|514486271|gb|KE346361.1|	2378967	2378979	AAAAC	12	+	2	AACAA
gi|514486271|gb|KE346361.1|	2378977	2378992	AAAAAC	15	+	2	AAAAAC
gi|514486271|gb|KE346361.1|	2378998	2379013	AAAC	15	+	3	AAAC
gi|514486271|gb|KE346361.1|	2379111	2379127	AAAAAC	16	-	2	TTTTTG
gi|514486271|gb|KE346361.1|	2379905	2379917	AAAAAC	12	-	2	TTTTTG
gi|514486271|gb|KE346361.1|	2379933	2379945	A	12	-	12	T
gi|514486271|gb|KE346361.1|	2381328	2381345	ACACGC	17	+	2	CACACG
gi|514486271|gb|KE346361.1|	2381387	2381399	AAAC	12	+	3	AAAC
gi|514486271|gb|KE346361.1|	2382470	2382483	AAC	13	+	4	AAC
gi|514486271|gb|KE346361.1|	2383160	2383172	A	12	-	12	T
gi|514486271|gb|KE346361.1|	2383321	2383334	A	13	+	13	A
gi|514486271|gb|KE346361.1|	2383344	2383356	A	12	+	12	A
gi|514486271|gb|KE346361.1|	2383402	2383414	AAT	12	-	4	ATT
gi|514486271|gb|KE346361.1|	2383409	2383421	AAGAAT	12	-	2	TTATTC
gi|514486271|gb|KE346361.1|	2383784	2383796	C	12	+	12	C
gi|514486271|gb|KE346361.1|	2383931	2383944	ACTGC	13	+	2	CTGCA
gi|514486271|gb|KE346361.1|	2384809	2384821	AGCG	12	+	3	GAGC
gi|514486271|gb|KE346361.1|	2384827	2384842	AG	15	+	7	GA
gi|514486271|gb|KE346361.1|	2385568	2385580	AAACAC	12	-	2	TTTGTG
gi|514486271|gb|KE346361.1|	2386956	2386969	A	13	+	13	A
gi|514486271|gb|KE346361.1|	2387119	2387131	AACGAC	12	-	2	TCGTTG
gi|514486271|gb|KE346361.1|	2387439	2387451	A	12	-	12	T
gi|514486271|gb|KE346361.1|	2387473	2387500	A	27	-	27	T
gi|514486271|gb|KE346361.1|	2387570	2387585	AGCG	15	+	3	GAGC
gi|514486271|gb|KE346361.1|	2387626	2387653	AG	27	+	13	GA
gi|514486271|gb|KE346361.1|	2387654	2387671	AG	17	+	8	GA
gi|514486271|gb|KE346361.1|	2387850	2387862	AGCTGC	12	+	2	AGCTGC
gi|514486271|gb|KE346361.1|	2387905	2387921	ACTCC	16	+	3	CTCCA
gi|514486271|gb|KE346361.1|	2388048	2388072	A	24	+	24	A
gi|514486271|gb|KE346361.1|	2388375	2388393	AGC	18	-	6	CTG
gi|514486271|gb|KE346361.1|	2388388	2388400	ACCAGC	12	-	2	TGCTGG
gi|514486271|gb|KE346361.1|	2388611	2388623	AC	12	+	6	CA
gi|514486271|gb|KE346361.1|	2388906	2388918	ACACGT	12	+	2	TACACG
gi|514486271|gb|KE346361.1|	2388945	2388957	AGATCG	12	-	2	CTCGAT
gi|514486271|gb|KE346361.1|	2390047	2390059	AACGTG	12	-	2	TCACGT
gi|514486271|gb|KE346361.1|	2390077	2390090	AGCC	13	-	3	TGGC
gi|514486271|gb|KE346361.1|	2392516	2392528	ACCGCC	12	+	2	CCACCG
gi|514486271|gb|KE346361.1|	2395913	2395925	AAATCC	12	-	2	GATTTG
gi|514486271|gb|KE346361.1|	2397871	2397884	AATGCC	13	-	2	TTGGCA
gi|514486271|gb|KE346361.1|	2399132	2399144	ACGCG	12	-	2	CGCGT
gi|514486271|gb|KE346361.1|	2399781	2399794	AAAGGC	13	-	2	GCCTTT
gi|514486271|gb|KE346361.1|	2399985	2399997	ACACGT	12	+	2	TACACG
gi|514486271|gb|KE346361.1|	2401057	2401069	ACCATG	12	+	2	TGACCA
gi|514486271|gb|KE346361.1|	2403669	2403681	ACCTCG	12	+	2	ACCTCG
gi|514486271|gb|KE346361.1|	2405059	2405071	AATCAG	12	-	2	TGATTC
gi|514486271|gb|KE346361.1|	2405104	2405117	AAAAAC	13	-	2	TTTGTT
gi|514486271|gb|KE346361.1|	2405127	2405154	AAAAAC	27	-	4	TTTTGT
gi|514486271|gb|KE346361.1|	2405288	2405328	A	40	-	40	T
gi|514486271|gb|KE346361.1|	2405574	2405586	AAGCCC	12	+	2	CCCAAG
gi|514486271|gb|KE346361.1|	2408091	2408115	AC	24	+	12	AC
gi|514486271|gb|KE346361.1|	2408168	2408192	A	24	+	24	A
gi|514486271|gb|KE346361.1|	2408317	2408329	AAGATG	12	-	2	CTTCAT
gi|514486271|gb|KE346361.1|	2408611	2408625	ACTGCC	14	+	2	GCCACT
gi|514486271|gb|KE346361.1|	2408624	2408639	ACTGCC	15	+	2	CTGCCA
gi|514486271|gb|KE346361.1|	2408761	2408780	ACT	19	+	6	ACT
gi|514486271|gb|KE346361.1|	2408798	2408810	AGC	12	-	4	CTG
gi|514486271|gb|KE346361.1|	2408909	2408922	AAAGAC	13	+	2	AGACAA
gi|514486271|gb|KE346361.1|	2409439	2409456	A	17	+	17	A
gi|514486271|gb|KE346361.1|	2409646	2409675	AGC	29	-	9	CTG
gi|514486271|gb|KE346361.1|	2409871	2409883	AGCGG	12	+	2	GAGCG
gi|514486271|gb|KE346361.1|	2409953	2409965	AATAGC	12	+	2	CAATAG
gi|514486271|gb|KE346361.1|	2410414	2410426	AGCATG	12	-	2	TGCTCA
gi|514486271|gb|KE346361.1|	2410433	2410445	AATAC	12	-	2	TTGTA
gi|514486271|gb|KE346361.1|	2410565	2410581	AAAAGC	16	+	2	AAGCAA
gi|514486271|gb|KE346361.1|	2411393	2411415	AAGG	22	+	5	AAGG
gi|514486271|gb|KE346361.1|	2412009	2412030	ACC	21	-	7	GGT
gi|514486271|gb|KE346361.1|	2412029	2412043	AAGATC	14	-	2	TCTTGA
gi|514486271|gb|KE346361.1|	2412122	2412134	ACTGG	12	-	2	CCAGT
gi|514486271|gb|KE346361.1|	2412153	2412165	AAGCAG	12	-	2	CTGCTT
gi|514486271|gb|KE346361.1|	2412270	2412282	ACG	12	-	4	CGT
gi|514486271|gb|KE346361.1|	2412613	2412639	A	26	-	26	T
gi|514486271|gb|KE346361.1|	2412929	2412949	AACACG	20	-	3	TTCGTG
gi|514486271|gb|KE346361.1|	2413263	2413277	AAC	14	+	4	AAC
gi|514486271|gb|KE346361.1|	2413275	2413287	A	12	+	12	A
gi|514486271|gb|KE346361.1|	2413503	2413521	A	18	+	18	A
gi|514486271|gb|KE346361.1|	2413555	2413570	AAAAAT	15	-	2	TTTTTA
gi|514486271|gb|KE346361.1|	2413715	2413727	AAAC	12	+	3	CAAA
gi|514486271|gb|KE346361.1|	2413724	2413747	A	23	+	23	A
gi|514486271|gb|KE346361.1|	2413803	2413815	AAAAAC	12	+	2	AAACAA
gi|514486271|gb|KE346361.1|	2413852	2413864	AAAACG	12	+	2	CGAAAA
gi|514486271|gb|KE346361.1|	2414452	2414472	A	20	-	20	T
gi|514486271|gb|KE346361.1|	2415469	2415481	AAGAG	12	-	2	TTCTC
gi|514486271|gb|KE346361.1|	2415978	2415991	AAAGAC	13	-	2	GTCTTT
gi|514486271|gb|KE346361.1|	2416004	2416018	A	14	+	14	A
gi|514486271|gb|KE346361.1|	2416042	2416058	AAGAGG	16	-	2	TCCTCT
gi|514486271|gb|KE346361.1|	2419046	2419063	AC	17	-	8	GT
gi|514486271|gb|KE346361.1|	2419148	2419160	ACCCCC	12	+	2	CCCCAC
gi|514486271|gb|KE346361.1|	2419366	2419381	ACTGGC	15	+	2	TGGCAC
gi|514486271|gb|KE346361.1|	2419493	2419523	A	30	-	30	T
gi|514486271|gb|KE346361.1|	2419691	2419709	AAT	18	-	6	ATT
gi|514486271|gb|KE346361.1|	2419707	2419719	A	12	-	12	T
gi|514486271|gb|KE346361.1|	2419916	2419934	A	18	+	18	A
gi|514486271|gb|KE346361.1|	2419975	2419990	AAAACC	15	-	2	TTTGGT
gi|514486271|gb|KE346361.1|	2420228	2420240	AAGCGC	12	-	2	GCGCTT
gi|514486271|gb|KE346361.1|	2420240	2420252	AGCGGC	12	+	2	CAGCGG
gi|514486271|gb|KE346361.1|	2420487	2420501	AGC	14	+	4	GCA
gi|514486271|gb|KE346361.1|	2420506	2420520	AACAGC	14	+	2	CAGCAA
gi|514486271|gb|KE346361.1|	2422336	2422350	AAG	14	+	4	AAG
gi|514486271|gb|KE346361.1|	2423681	2423701	AAGG	20	-	5	CTTC
gi|514486271|gb|KE346361.1|	2423980	2423992	AGC	12	-	4	GCT
gi|514486271|gb|KE346361.1|	2424294	2424508	AG	214	+	107	AG
gi|514486271|gb|KE346361.1|	2424808	2424823	AACATG	15	-	2	TTCATG
gi|514486271|gb|KE346361.1|	2424828	2424842	AAAAGC	14	-	2	TTGCTT
gi|514486271|gb|KE346361.1|	2424851	2424866	AAAAGC	15	-	2	TTTTGC
gi|514486271|gb|KE346361.1|	2425151	2425175	A	24	-	24	T
gi|514486271|gb|KE346361.1|	2425521	2425534	ACGGGC	13	-	2	CCCGTG
gi|514486271|gb|KE346361.1|	2425806	2425824	A	18	-	18	T
gi|514486271|gb|KE346361.1|	2426504	2426520	AGGG	16	-	4	CCCT
gi|514486271|gb|KE346361.1|	2426923	2426935	AAATC	12	-	2	TTGAT
gi|514486271|gb|KE346361.1|	2427935	2427949	AAAAGG	14	-	2	TTTCCT
gi|514486271|gb|KE346361.1|	2428687	2428699	ACTCT	12	-	2	GTAGA
gi|514486271|gb|KE346361.1|	2429460	2429472	AAC	12	+	4	ACA
gi|514486271|gb|KE346361.1|	2429470	2429491	AGC	21	+	7	CAG
gi|514486271|gb|KE346361.1|	2429747	2429768	AAAC	21	+	5	ACAA
gi|514486271|gb|KE346361.1|	2429938	2429950	AATCAC	12	+	2	CACAAT
gi|514486271|gb|KE346361.1|	2429988	2430005	ATCATG	17	+	2	ATCATG
gi|514486271|gb|KE346361.1|	2430146	2430160	AGC	14	+	4	GCA
gi|514486271|gb|KE346361.1|	2430504	2430517	AAAAC	13	+	2	ACAAA
gi|514486271|gb|KE346361.1|	2431776	2431792	AACAGC	16	-	2	GTTGCT
gi|514486271|gb|KE346361.1|	2431799	2431813	AACAGC	14	-	2	TGCTGT
gi|514486271|gb|KE346361.1|	2431849	2431862	AGC	13	-	4	CTG
gi|514486271|gb|KE346361.1|	2433606	2433631	ACTC	25	-	6	GTGA
gi|514486271|gb|KE346361.1|	2433816	2433829	ACGATG	13	+	2	GACGAT
gi|514486271|gb|KE346361.1|	2433932	2433949	AACACC	17	+	2	CACCAA
gi|514486271|gb|KE346361.1|	2434030	2434043	ACG	13	-	4	CGT
gi|514486271|gb|KE346361.1|	2434107	2434120	ACGAGG	13	-	2	TCGTCC
gi|514486271|gb|KE346361.1|	2434767	2434779	ACATCG	12	+	2	TCGACA
gi|514486271|gb|KE346361.1|	2435005	2435017	AAG	12	+	4	AAG
gi|514486271|gb|KE346361.1|	2435301	2435313	AAAGCG	12	+	2	CGAAAG
gi|514486271|gb|KE346361.1|	2435576	2435596	ATC	20	+	6	CAT
gi|514486271|gb|KE346361.1|	2435850	2435865	AAAGCC	15	+	2	CCAAAG
gi|514486271|gb|KE346361.1|	2435917	2435964	AGC	47	+	15	CAG
gi|514486271|gb|KE346361.1|	2437600	2437612	AAGCCG	12	+	2	AGCCGA
gi|514486271|gb|KE346361.1|	2437662	2437675	ACCGCC	13	+	2	CCGCCA
gi|514486271|gb|KE346361.1|	2438702	2438715	AAGTAC	13	+	2	GTACAA
gi|514486271|gb|KE346361.1|	2439429	2439446	AAGCTC	17	-	2	GAGCTT
gi|514486271|gb|KE346361.1|	2439441	2439454	AGCTCC	13	-	2	GAGCTG
gi|514486271|gb|KE346361.1|	2440224	2440236	ATCCG	12	-	2	CGGAT
gi|514486271|gb|KE346361.1|	2440809	2440822	ACCGCC	13	-	2	GGCGGT
gi|514486271|gb|KE346361.1|	2440965	2440977	CCCCGG	12	-	2	CGGGGC
gi|514486271|gb|KE346361.1|	2441213	2441225	AAC	12	-	4	TGT
gi|514486271|gb|KE346361.1|	2442150	2442165	AACATC	15	-	2	TGATGT
gi|514486271|gb|KE346361.1|	2442672	2442684	ACCGCG	12	-	2	GTCGCG
gi|514486271|gb|KE346361.1|	2443627	2443648	AATCGC	21	-	3	GCGATT
gi|514486271|gb|KE346361.1|	2445700	2445712	AGCGCG	12	+	2	GAGCGC
gi|514486271|gb|KE346361.1|	2448141	2448158	AGCATC	17	+	2	CAGCAT
gi|514486271|gb|KE346361.1|	2448153	2448181	AGC	28	+	9	CAG
gi|514486271|gb|KE346361.1|	2449536	2449549	ACGAGG	13	-	2	CCTCGT
gi|514486271|gb|KE346361.1|	2450857	2450870	AAGGAG	13	+	2	AGGAGA
gi|514486271|gb|KE346361.1|	2451307	2451323	AACGAC	16	-	2	GTCGTT
gi|514486271|gb|KE346361.1|	2451964	2451987	ACCCCC	23	-	3	GGTGGG
gi|514486271|gb|KE346361.1|	2451992	2452006	AGC	14	+	4	GCA
gi|514486271|gb|KE346361.1|	2452134	2452153	AAC	19	-	6	GTT
gi|514486271|gb|KE346361.1|	2452148	2452165	AACAGC	17	-	2	TGTTGC
gi|514486271|gb|KE346361.1|	2452325	2452337	AAATGC	12	+	2	TGCAAA
gi|514486271|gb|KE346361.1|	2455929	2455946	A	17	+	17	A
gi|514486271|gb|KE346361.1|	2455947	2455962	A	15	+	15	A
gi|514486271|gb|KE346361.1|	2456038	2456055	AATG	17	+	4	AATG
gi|514486271|gb|KE346361.1|	2456056	2456076	AATG	20	+	5	TGAA
gi|514486271|gb|KE346361.1|	2456424	2456444	AGC	20	+	6	GCA
gi|514486271|gb|KE346361.1|	2456789	2456813	ATC	24	-	8	TGA
gi|514486271|gb|KE346361.1|	2457730	2457743	A	13	+	13	A
gi|514486271|gb|KE346361.1|	2457782	2457794	AAAC	12	+	3	CAAA
gi|514486271|gb|KE346361.1|	2457793	2457805	AACAC	12	+	2	AACAC
gi|514486271|gb|KE346361.1|	2458733	2458745	AAC	12	+	4	CAA
gi|514486271|gb|KE346361.1|	2458902	2458915	AAAAAC	13	+	2	ACAAAA
gi|514486271|gb|KE346361.1|	2458910	2458931	A	21	+	21	A
gi|514486271|gb|KE346361.1|	2460933	2460946	AAGGAG	13	-	2	CCTTCT
gi|514486271|gb|KE346361.1|	2462989	2463043	A	54	-	54	T
gi|514486271|gb|KE346361.1|	2463073	2463093	AGG	20	-	6	TCC
gi|514486271|gb|KE346361.1|	2463223	2463241	A	18	+	18	A
gi|514486271|gb|KE346361.1|	2463400	2463412	A	12	+	12	A
gi|514486271|gb|KE346361.1|	2463439	2463454	A	15	+	15	A
gi|514486271|gb|KE346361.1|	2463475	2463487	A	12	+	12	A
gi|514486271|gb|KE346361.1|	2463488	2463500	A	12	+	12	A
gi|514486271|gb|KE346361.1|	2463496	2463510	AAAAG	14	+	2	AAAAG
gi|514486271|gb|KE346361.1|	2464483	2464495	AACAAT	12	+	2	CAATAA
gi|514486271|gb|KE346361.1|	2464532	2464549	AC	17	-	8	TG
gi|514486271|gb|KE346361.1|	2465288	2465300	AACCAC	12	-	2	GTGGTT
gi|514486271|gb|KE346361.1|	2465821	2465834	A	13	+	13	A
gi|514486271|gb|KE346361.1|	2465853	2465865	A	12	-	12	T
gi|514486271|gb|KE346361.1|	2465987	2466000	ACAGCC	13	-	2	TGTGGC
gi|514486271|gb|KE346361.1|	2466267	2466280	A	13	-	13	T
gi|514486271|gb|KE346361.1|	2466347	2466363	AAAATC	16	-	2	TGATTT
gi|514486271|gb|KE346361.1|	2466365	2466378	A	13	-	13	T
gi|514486271|gb|KE346361.1|	2466417	2466429	AAGC	12	-	3	CTTG
gi|514486271|gb|KE346361.1|	2466920	2466933	ACCGCC	13	+	2	CGCCAC
gi|514486271|gb|KE346361.1|	2468523	2468535	A	12	+	12	A
gi|514486271|gb|KE346361.1|	2469307	2469319	AACACC	12	-	2	GTGTTG
gi|514486271|gb|KE346361.1|	2469324	2469341	AACAGC	17	-	2	GTTGCT
gi|514486271|gb|KE346361.1|	2470078	2470090	AAGGG	12	+	2	AAGGG
gi|514486271|gb|KE346361.1|	2470205	2470217	ACCCC	12	-	2	GGGTG
gi|514486271|gb|KE346361.1|	2470579	2470601	AACG	22	-	5	TCGT
gi|514486271|gb|KE346361.1|	2470627	2470639	A	12	-	12	T
gi|514486271|gb|KE346361.1|	2470663	2470676	AAAAAT	13	-	2	TTTTAT
gi|514486271|gb|KE346361.1|	2470957	2470969	A	12	+	12	A
gi|514486271|gb|KE346361.1|	2470984	2470997	A	13	+	13	A
gi|514486271|gb|KE346361.1|	2471225	2471240	AG	15	-	7	TC
gi|514486271|gb|KE346361.1|	2471907	2471920	AACCC	13	+	2	CCCAA
gi|514486271|gb|KE346361.1|	2472273	2472285	ACACTC	12	+	2	CACTCA
gi|514486271|gb|KE346361.1|	2473255	2473274	AAGCC	19	-	3	GCTTG
gi|514486271|gb|KE346361.1|	2473362	2473376	AAAAC	14	-	2	TTTTG
gi|514486271|gb|KE346361.1|	2473473	2473488	AAC	15	+	5	CAA
gi|514486271|gb|KE346361.1|	2473668	2473680	ACCGCC	12	-	2	CGGTGG
gi|514486271|gb|KE346361.1|	2473896	2473909	AAGC	13	-	3	TTGC
gi|514486271|gb|KE346361.1|	2474453	2474467	AAGTGC	14	+	2	AGTGCA
gi|514486271|gb|KE346361.1|	2474479	2474493	ACCGCC	14	-	2	GGCGGT
gi|514486271|gb|KE346361.1|	2477422	2477435	AAAAC	13	-	2	TTTGT
gi|514486271|gb|KE346361.1|	2477433	2477452	AAAAC	19	-	3	TTTTG
gi|514486271|gb|KE346361.1|	2477451	2477465	AAAAC	14	-	2	TTTTG
gi|514486271|gb|KE346361.1|	2477463	2477477	AAAAC	14	-	2	TTTTG
gi|514486271|gb|KE346361.1|	2477926	2477938	A	12	-	12	T
gi|514486271|gb|KE346361.1|	2477935	2477951	AAAC	16	-	4	TTTG
gi|514486271|gb|KE346361.1|	2478051	2478079	ACAGGT	28	-	4	TGTACC
gi|514486271|gb|KE346361.1|	2479000	2479029	AAAC	29	-	7	TGTT
gi|514486271|gb|KE346361.1|	2479787	2479804	AGCCCC	17	-	2	GGGGCT
gi|514486271|gb|KE346361.1|	2479929	2479946	AAAAGC	17	+	2	CAAAAG
gi|514486271|gb|KE346361.1|	2480035	2480047	AAAAAC	12	+	2	CAAAAA
gi|514486271|gb|KE346361.1|	2480053	2480067	A	14	+	14	A
gi|514486271|gb|KE346361.1|	2481186	2481199	AAAG	13	+	3	AAAG
gi|514486271|gb|KE346361.1|	2481538	2481553	ACGAGG	15	-	2	TCCTCG
gi|514486271|gb|KE346361.1|	2482183	2482195	AAAG	12	+	3	GAAA
gi|514486271|gb|KE346361.1|	2482192	2482209	A	17	+	17	A
gi|514486271|gb|KE346361.1|	2482448	2482460	AATCCC	12	+	2	CCAATC
gi|514486271|gb|KE346361.1|	2484340	2484353	AATGTC	13	+	2	CAATGT
gi|514486271|gb|KE346361.1|	2484355	2484367	ACATGC	12	-	2	CATGTG
gi|514486271|gb|KE346361.1|	2484417	2484429	AAACCG	12	+	2	AACCGA
gi|514486271|gb|KE346361.1|	2484499	2484511	ACCAGT	12	+	2	CCAGTA
gi|514486271|gb|KE346361.1|	2484848	2484865	AAC	17	+	5	CAA
gi|514486271|gb|KE346361.1|	2485104	2485118	AGC	14	-	4	TGC
gi|514486271|gb|KE346361.1|	2485122	2485139	AGC	17	-	5	TGC
gi|514486271|gb|KE346361.1|	2485479	2485491	AAGCTG	12	+	2	GAAGCT
gi|514486271|gb|KE346361.1|	2486015	2486027	AGC	12	-	4	TGC
gi|514486271|gb|KE346361.1|	2486459	2486473	ACGGCG	14	+	2	CGGCGA
gi|514486271|gb|KE346361.1|	2486658	2486674	AAC	16	-	5	GTT
gi|514486271|gb|KE346361.1|	2486676	2486696	CCG	20	+	6	GCC
gi|514486271|gb|KE346361.1|	2487094	2487106	AATGGC	12	-	2	CATTGC
gi|514486271|gb|KE346361.1|	2487233	2487253	AAC	20	-	6	GTT
gi|514486271|gb|KE346361.1|	2487268	2487281	AACAGC	13	-	2	TGCTGT
gi|514486271|gb|KE346361.1|	2487394	2487406	AGCAGG	12	-	2	CTGCTC
gi|514486271|gb|KE346361.1|	2487411	2487425	ACATGG	14	+	2	GACATG
gi|514486271|gb|KE346361.1|	2487441	2487457	AGCTGC	16	+	2	GCTGCA
gi|514486271|gb|KE346361.1|	2487579	2487591	AAGTGC	12	-	2	CTTGCA
gi|514486271|gb|KE346361.1|	2487767	2487780	AATCTG	13	-	2	CAGATT
gi|514486271|gb|KE346361.1|	2487826	2487845	AGC	19	+	6	CAG
gi|514486271|gb|KE346361.1|	2487986	2488001	ACCAGC	15	+	2	AGCACC
gi|514486271|gb|KE346361.1|	2488016	2488037	AGC	21	+	7	AGC
gi|514486271|gb|KE346361.1|	2488129	2488141	ACT	12	+	4	TAC
gi|514486271|gb|KE346361.1|	2488224	2488241	AGC	17	-	5	CTG
gi|514486271|gb|KE346361.1|	2488293	2488306	ATC	13	-	4	GAT
gi|514486271|gb|KE346361.1|	2488332	2488345	ATC	13	-	4	GAT
gi|514486271|gb|KE346361.1|	2488348	2488370	AGC	22	-	7	GCT
gi|514486271|gb|KE346361.1|	2488533	2488545	ATC	12	-	4	GAT
gi|514486271|gb|KE346361.1|	2488563	2488578	AACACC	15	+	2	CCAACA
gi|514486271|gb|KE346361.1|	2488692	2488708	AAAGTC	16	+	2	AAAGTC
gi|514486271|gb|KE346361.1|	2488872	2488885	AAAAG	13	+	2	AAAGA
gi|514486271|gb|KE346361.1|	2491621	2491633	AGGGG	12	-	2	CCCCT
gi|514486271|gb|KE346361.1|	2491861	2491876	ACATC	15	-	3	TGATG
gi|514486271|gb|KE346361.1|	2492101	2492129	A	28	+	28	A
gi|514486271|gb|KE346361.1|	2492184	2492196	ACTCG	12	+	2	CGACT
gi|514486271|gb|KE346361.1|	2492526	2492543	A	17	+	17	A
gi|514486271|gb|KE346361.1|	2492603	2492615	AAATCC	12	-	2	TTGGAT
gi|514486271|gb|KE346361.1|	2493078	2493090	ACAGAG	12	-	2	TCTGTC
gi|514486271|gb|KE346361.1|	2494380	2494393	ACGCTC	13	+	2	TCACGC
gi|514486271|gb|KE346361.1|	2494658	2494671	AAC	13	-	4	TTG
gi|514486271|gb|KE346361.1|	2494778	2494791	AGCTCG	13	+	2	GAGCTC
gi|514486271|gb|KE346361.1|	2495863	2495884	AC	21	-	10	TG
gi|514486271|gb|KE346361.1|	2496964	2496978	A	14	-	14	T
gi|514486271|gb|KE346361.1|	2496982	2496998	A	16	-	16	T
gi|514486271|gb|KE346361.1|	2497130	2497142	AACATT	12	+	2	ATTAAC
gi|514486271|gb|KE346361.1|	2497591	2497604	ACCAGC	13	+	2	CCAGCA
gi|514486271|gb|KE346361.1|	2497601	2497617	ACGTCC	16	+	2	CACGTC
gi|514486271|gb|KE346361.1|	2497799	2497827	AAAC	28	-	7	GTTT
gi|514486271|gb|KE346361.1|	2497821	2497833	AAAAC	12	-	2	TTGTT
gi|514486271|gb|KE346361.1|	2497827	2497840	AAAAAC	13	-	2	TGTTTT
gi|514486271|gb|KE346361.1|	2497835	2497856	A	21	-	21	T
gi|514486271|gb|KE346361.1|	2497853	2497868	AAAC	15	-	3	TTTG
gi|514486271|gb|KE346361.1|	2498478	2498542	A	64	-	64	T
gi|514486271|gb|KE346361.1|	2498539	2498562	AAAC	23	-	5	TTTG
gi|514486271|gb|KE346361.1|	2498753	2498768	AGC	15	-	5	TGC
gi|514486271|gb|KE346361.1|	2498909	2498921	AGGCCC	12	-	2	CTGGGC
gi|514486271|gb|KE346361.1|	2500080	2500158	AC	78	+	39	CA
gi|514486271|gb|KE346361.1|	2501529	2501549	A	20	+	20	A
gi|514486271|gb|KE346361.1|	2501699	2501720	AG	21	-	10	CT
gi|514486271|gb|KE346361.1|	2501876	2501888	ACTGAG	12	-	2	CTCAGT
gi|514486271|gb|KE346361.1|	2502365	2502378	AAGGTC	13	+	2	CAAGGT
gi|514486271|gb|KE346361.1|	2502892	2502904	AACAAG	12	+	2	ACAAGA
gi|514486271|gb|KE346361.1|	2504685	2504700	AACCGC	15	-	2	TGCGGT
gi|514486271|gb|KE346361.1|	2506120	2506142	A	22	-	22	T
gi|514486271|gb|KE346361.1|	2506511	2506523	AGCTCC	12	-	2	GCTGGA
gi|514486271|gb|KE346361.1|	2507158	2507170	AAAAAG	12	-	2	CTTTTT
gi|514486271|gb|KE346361.1|	2507293	2507309	CCG	16	+	5	CGC
gi|514486271|gb|KE346361.1|	2507440	2507458	A	18	-	18	T
gi|514486271|gb|KE346361.1|	2508236	2508256	AG	20	-	10	CT
gi|514486271|gb|KE346361.1|	2508259	2508308	AG	49	-	24	TC
gi|514486271|gb|KE346361.1|	2508309	2508366	AG	57	-	28	TC
gi|514486271|gb|KE346361.1|	2508367	2508499	AG	132	-	66	TC
gi|514486271|gb|KE346361.1|	2508496	2508552	AGG	56	-	18	CTC
gi|514486271|gb|KE346361.1|	2510684	2510696	AGCCGG	12	-	2	CTCCGG
gi|514486271|gb|KE346361.1|	2511898	2511912	AAG	14	+	4	AGA
gi|514486271|gb|KE346361.1|	2512013	2512025	ACC	12	-	4	TGG
gi|514486271|gb|KE346361.1|	2512681	2512694	AAAAC	13	-	2	TTGTT
gi|514486271|gb|KE346361.1|	2512974	2512989	AAGC	15	+	3	AGCA
gi|514486271|gb|KE346361.1|	2515083	2515096	AGC	13	-	4	CTG
gi|514486271|gb|KE346361.1|	2515109	2515126	ACTGCT	17	-	2	AGTAGC
gi|514486271|gb|KE346361.1|	2515121	2515136	ACT	15	-	5	AGT
gi|514486271|gb|KE346361.1|	2515420	2515444	A	24	+	24	A
gi|514486271|gb|KE346361.1|	2515762	2515778	A	16	+	16	A
gi|514486271|gb|KE346361.1|	2516160	2516195	A	35	+	35	A
gi|514486271|gb|KE346361.1|	2516276	2516288	AAAGCC	12	-	2	CTTTGG
gi|514486271|gb|KE346361.1|	2516531	2516543	AATGCG	12	+	2	TGCGAA
gi|514486271|gb|KE346361.1|	2516645	2516658	ACCTCC	13	-	2	GTGGAG
gi|514486271|gb|KE346361.1|	2516677	2516694	AGAGCG	17	+	2	GAGAGC
gi|514486271|gb|KE346361.1|	2516873	2516885	AAAAC	12	+	2	AACAA
gi|514486271|gb|KE346361.1|	2516974	2516989	AAAC	15	-	3	TTTG
gi|514486271|gb|KE346361.1|	2516994	2517006	A	12	-	12	T
gi|514486271|gb|KE346361.1|	2517005	2517020	AC	15	-	7	TG
gi|514486271|gb|KE346361.1|	2517263	2517277	AAAAAC	14	-	2	TTTTGT
gi|514486271|gb|KE346361.1|	2518847	2518860	ACAGT	13	-	2	CTGTA
gi|514486271|gb|KE346361.1|	2518968	2518988	A	20	+	20	A
gi|514486271|gb|KE346361.1|	2518997	2519009	AAAAAC	12	+	2	CAAAAA
gi|514486271|gb|KE346361.1|	2519173	2519186	AAACG	13	+	2	ACGAA
gi|514486271|gb|KE346361.1|	2520016	2520041	AAC	25	-	8	GTT
gi|514486271|gb|KE346361.1|	2520405	2520437	A	32	+	32	A
gi|514486271|gb|KE346361.1|	2521019	2521033	A	14	-	14	T
gi|514486271|gb|KE346361.1|	2521419	2521431	AAG	12	-	4	TTC
gi|514486271|gb|KE346361.1|	2521528	2521540	AACTGC	12	-	2	GTTGCA
gi|514486271|gb|KE346361.1|	2521622	2521637	A	15	+	15	A
gi|514486271|gb|KE346361.1|	2522004	2522016	AGGGGG	12	-	2	CCCCTC
gi|514486271|gb|KE346361.1|	2522315	2522329	AAC	14	+	4	AAC
gi|514486271|gb|KE346361.1|	2524308	2524324	A	16	-	16	T
gi|514486271|gb|KE346361.1|	2524319	2524333	AAAAAG	14	-	2	TTTTTC
gi|514486271|gb|KE346361.1|	2524548	2524563	AG	15	-	7	TC
gi|514486271|gb|KE346361.1|	2524643	2524679	AG	36	-	18	CT
gi|514486271|gb|KE346361.1|	2525584	2525596	A	12	-	12	T
gi|514486271|gb|KE346361.1|	2525672	2525688	AG	16	-	8	TC
gi|514486271|gb|KE346361.1|	2526625	2526638	AAAAAG	13	+	2	AAAAAG
gi|514486271|gb|KE346361.1|	2526780	2526797	ACTGCT	17	-	2	AGCAGT
gi|514486271|gb|KE346361.1|	2526804	2526821	AGCAGG	17	+	2	AGCAGG
gi|514486271|gb|KE346361.1|	2527148	2527160	AAGCCG	12	-	2	CGGCTT
gi|514486271|gb|KE346361.1|	2527225	2527238	AAAC	13	+	3	AAAC
gi|514486271|gb|KE346361.1|	2527235	2527499	AC	264	+	132	AC
gi|514486271|gb|KE346361.1|	2527601	2527619	AC	18	+	9	CA
gi|514486271|gb|KE346361.1|	2528430	2528443	AGGC	13	+	3	GGCA
gi|514486271|gb|KE346361.1|	2528440	2528525	ACAG	85	+	21	CAGA
gi|514486271|gb|KE346361.1|	2528526	2528539	ACAG	13	+	3	GACA
gi|514486271|gb|KE346361.1|	2528543	2528556	ACAG	13	+	3	ACAG
gi|514486271|gb|KE346361.1|	2528680	2528692	AAAGG	12	+	2	AGGAA
gi|514486271|gb|KE346361.1|	2530247	2530260	AGC	13	+	4	CAG
gi|514486271|gb|KE346361.1|	2530257	2530269	ACCGCT	12	-	2	AGCGGT
gi|514486271|gb|KE346361.1|	2530729	2530741	A	12	+	12	A
gi|514486271|gb|KE346361.1|	2530941	2530954	CCG	13	-	4	GGC
gi|514486271|gb|KE346361.1|	2530956	2530970	AAGCAC	14	-	2	TGTGCT
gi|514486271|gb|KE346361.1|	2533127	2533140	AGGGGG	13	+	2	GAGGGG
gi|514486271|gb|KE346361.1|	2533221	2533233	ACCTCG	12	+	2	CGACCT
gi|514486271|gb|KE346361.1|	2534021	2534046	ACG	25	+	8	CGA
gi|514486271|gb|KE346361.1|	2535037	2535071	A	34	-	34	T
gi|514486271|gb|KE346361.1|	2535882	2535895	AACAAT	13	+	2	AACAAT
gi|514486271|gb|KE346361.1|	2535896	2535909	AGCGGC	13	+	2	CAGCGG
gi|514486271|gb|KE346361.1|	2536269	2536281	A	12	-	12	T
gi|514486271|gb|KE346361.1|	2538685	2538698	AACCGC	13	+	2	GCAACC
gi|514486271|gb|KE346361.1|	2539772	2539784	ACTCT	12	+	2	ACTCT
gi|514486271|gb|KE346361.1|	2540695	2540707	AGGGGG	12	-	2	CTCCCC
gi|514486271|gb|KE346361.1|	2541517	2541529	AAAGTC	12	-	2	ACTTTG
gi|514486271|gb|KE346361.1|	2541584	2541596	ACCACG	12	-	2	GTCGTG
gi|514486271|gb|KE346361.1|	2541922	2541938	A	16	-	16	T
gi|514486271|gb|KE346361.1|	2541954	2541968	AAAAAG	14	-	2	TCTTTT
gi|514486271|gb|KE346361.1|	2542084	2542103	A	19	+	19	A
gi|514486271|gb|KE346361.1|	2542139	2542166	A	27	+	27	A
gi|514486271|gb|KE346361.1|	2543398	2543413	A	15	-	15	T
gi|514486271|gb|KE346361.1|	2544130	2544142	AATCAC	12	-	2	GTGATT
gi|514486271|gb|KE346361.1|	2547559	2547571	AATGGG	12	+	2	TGGGAA
gi|514486271|gb|KE346361.1|	2547845	2547863	AAAC	18	-	4	TGTT
gi|514486271|gb|KE346361.1|	2548241	2548253	AGCTGC	12	+	2	GCTGCA
gi|514486271|gb|KE346361.1|	2548266	2548287	ACCACG	21	+	3	CACGAC
gi|514486271|gb|KE346361.1|	2548341	2548358	AGC	17	+	5	CAG
gi|514486271|gb|KE346361.1|	2548497	2548513	AACCCC	16	+	2	CAACCC
gi|514486271|gb|KE346361.1|	2548598	2548610	AAAGAG	12	-	2	TTCTCT
gi|514486271|gb|KE346361.1|	2548605	2548619	AG	14	-	7	TC
gi|514486271|gb|KE346361.1|	2548784	2548808	AGAGGG	24	-	4	TCCCTC
gi|514486271|gb|KE346361.1|	2548884	2548899	A	15	+	15	A
gi|514486271|gb|KE346361.1|	2549632	2549644	AAGAC	12	-	2	GTCTT
gi|514486271|gb|KE346361.1|	2549771	2549783	ACGCGC	12	+	2	GCGCAC
gi|514486271|gb|KE346361.1|	2549899	2549914	AG	15	-	7	TC
gi|514486271|gb|KE346361.1|	2550777	2550792	AAAC	15	-	3	TTGT
gi|514486271|gb|KE346361.1|	2550864	2550880	A	16	-	16	T
gi|514486271|gb|KE346361.1|	2551162	2551175	AAC	13	+	4	ACA
gi|514486271|gb|KE346361.1|	2551871	2551884	AGGCC	13	+	2	GCCAG
gi|514486271|gb|KE346361.1|	2553034	2553046	AAAAG	12	-	2	TCTTT
gi|514486271|gb|KE346361.1|	2553115	2553128	AAACAC	13	-	2	TGTTTG
gi|514486271|gb|KE346361.1|	2553295	2553311	AAC	16	+	5	ACA
gi|514486271|gb|KE346361.1|	2553798	2553810	AAGCGC	12	-	2	TGCGCT
gi|514486271|gb|KE346361.1|	2554721	2554743	A	22	+	22	A
gi|514486271|gb|KE346361.1|	2555836	2555848	AGCCCC	12	-	2	GGCTGG
gi|514486271|gb|KE346361.1|	2556072	2556096	AAAC	24	+	6	CAAA
gi|514486271|gb|KE346361.1|	2556907	2556924	ACCTGC	17	-	2	GCAGGT
gi|514486271|gb|KE346361.1|	2556981	2556993	AGCTGC	12	+	2	TGCAGC
gi|514486271|gb|KE346361.1|	2557331	2557343	AAAAC	12	-	2	TTTTG
gi|514486271|gb|KE346361.1|	2557671	2557688	ACCATG	17	+	2	CATGAC
gi|514486271|gb|KE346361.1|	2557750	2557763	ATCGC	13	+	2	CGCAT
gi|514486271|gb|KE346361.1|	2558138	2558150	ACTCCC	12	+	2	ACTCCC
gi|514486271|gb|KE346361.1|	2558565	2558577	AAAAAC	12	+	2	AACAAA
gi|514486271|gb|KE346361.1|	2558742	2558754	ACAGTG	12	+	2	CAGTGA
gi|514486271|gb|KE346361.1|	2558782	2558794	ACCGCC	12	+	2	ACCGCC
gi|514486271|gb|KE346361.1|	2558949	2558962	AGGGCG	13	+	2	AGGGCG
gi|514486271|gb|KE346361.1|	2559159	2559173	ACGCTG	14	-	2	CGTCAG
gi|514486271|gb|KE346361.1|	2559373	2559385	ACGATC	12	+	2	CGATCA
gi|514486271|gb|KE346361.1|	2559661	2559673	ACACG	12	+	2	ACACG
gi|514486271|gb|KE346361.1|	2559876	2559892	ACG	16	+	5	ACG
gi|514486271|gb|KE346361.1|	2559887	2559901	ACGAGG	14	+	2	GACGAG
gi|514486271|gb|KE346361.1|	2559911	2559925	AAGACG	14	+	2	GACGAA
gi|514486271|gb|KE346361.1|	2559949	2559969	ACG	20	+	6	CGA
gi|514486271|gb|KE346361.1|	2560339	2560351	AGCCCG	12	+	2	CGAGCC
gi|514486271|gb|KE346361.1|	2560358	2560370	AGCCGG	12	+	2	GAGCCG
gi|514486271|gb|KE346361.1|	2560895	2560907	ACGCGG	12	-	2	TCCGCG
gi|514486271|gb|KE346361.1|	2563193	2563206	ACCTGC	13	+	2	CACCTG
gi|514486271|gb|KE346361.1|	2563625	2563637	AAGG	12	-	3	CTTC
gi|514486271|gb|KE346361.1|	2563974	2563987	AGC	13	+	4	GCA
gi|514486271|gb|KE346361.1|	2564011	2564024	ACGAGG	13	-	2	CTCGTC
gi|514486271|gb|KE346361.1|	2564179	2564194	AAGCAG	15	-	2	GCTTCT
gi|514486271|gb|KE346361.1|	2564928	2564940	AGGCGC	12	+	2	GCGCAG
gi|514486271|gb|KE346361.1|	2565860	2565873	ACGCGC	13	+	2	GCGCAC
gi|514486271|gb|KE346361.1|	2566265	2566285	AGC	20	-	6	CTG
gi|514486271|gb|KE346361.1|	2567152	2567164	AGATG	12	+	2	GAGAT
gi|514486271|gb|KE346361.1|	2567513	2567525	ACCATC	12	-	2	GTGATG
gi|514486271|gb|KE346361.1|	2567700	2567712	AAACAC	12	+	2	CAAACA
gi|514486271|gb|KE346361.1|	2568789	2568812	ACC	23	-	7	GTG
gi|514486271|gb|KE346361.1|	2569378	2569394	AAGCG	16	-	3	TCGCT
gi|514486271|gb|KE346361.1|	2569502	2569520	AATCAG	18	-	3	TGATTC
gi|514486271|gb|KE346361.1|	2569928	2569946	AGAGGG	18	+	3	GAGGGA
gi|514486271|gb|KE346361.1|	2570047	2570059	AGAGG	12	+	2	GAGAG
gi|514486271|gb|KE346361.1|	2570053	2570079	AAGAGG	26	+	4	AGAGGA
gi|514486271|gb|KE346361.1|	2570598	2570612	AAC	14	+	4	CAA
gi|514486271|gb|KE346361.1|	2570862	2570877	AGC	15	+	5	CAG
gi|514486271|gb|KE346361.1|	2571807	2571822	A	15	+	15	A
gi|514486271|gb|KE346361.1|	2571895	2571909	ACGAGT	14	+	2	AGTACG
gi|514486271|gb|KE346361.1|	2572147	2572159	AGAGG	12	-	2	TCTCC
gi|514486271|gb|KE346361.1|	2572922	2572936	AAAAAC	14	-	2	TGTTTT
gi|514486271|gb|KE346361.1|	2573593	2573609	AC	16	+	8	CA
gi|514486271|gb|KE346361.1|	2573665	2573681	AGCATC	16	+	2	AGCATC
gi|514486271|gb|KE346361.1|	2573746	2573758	AACCAG	12	+	2	AACCAG
gi|514486271|gb|KE346361.1|	2573797	2573821	AGC	24	+	8	CAG
gi|514486271|gb|KE346361.1|	2573858	2573873	AGC	15	+	5	GCA
gi|514486271|gb|KE346361.1|	2573881	2573896	ACAGTC	15	-	2	CTGTGA
gi|514486271|gb|KE346361.1|	2574002	2574022	ACTGCC	20	+	3	TGCCAC
gi|514486271|gb|KE346361.1|	2574474	2574486	AGG	12	-	4	CCT
gi|514486271|gb|KE346361.1|	2574517	2574536	AGC	19	-	6	CTG
gi|514486271|gb|KE346361.1|	2574534	2574549	CCG	15	-	5	GCG
gi|514486271|gb|KE346361.1|	2574986	2574998	AAAC	12	-	3	GTTT
gi|514486271|gb|KE346361.1|	2575323	2575336	A	13	-	13	T
gi|514486271|gb|KE346361.1|	2575753	2575769	A	16	-	16	T
gi|514486271|gb|KE346361.1|	2575768	2575789	AC	21	-	10	TG
gi|514486271|gb|KE346361.1|	2575798	2575813	AAAC	15	-	3	GTTT
gi|514486271|gb|KE346361.1|	2576189	2576202	ACTGCT	13	+	2	CTGCTA
gi|514486271|gb|KE346361.1|	2578003	2578017	AGC	14	-	4	GCT
gi|514486271|gb|KE346361.1|	2578054	2578071	AAATGC	17	+	2	GCAAAT
gi|514486271|gb|KE346361.1|	2578960	2578972	A	12	-	12	T
gi|514486271|gb|KE346361.1|	2580162	2580174	AACGGC	12	-	2	CCGTTG
gi|514486271|gb|KE346361.1|	2580921	2580933	AC	12	-	6	TG
gi|514486271|gb|KE346361.1|	2581159	2581171	AAACG	12	+	2	AAACG
gi|514486271|gb|KE346361.1|	2581180	2581192	AAAAAC	12	+	2	AACAAA
gi|514486271|gb|KE346361.1|	2582750	2582773	AAGACG	23	-	3	TCGTCT
gi|514486271|gb|KE346361.1|	2583083	2583103	ACGAGG	20	-	3	TCGTCC
gi|514486271|gb|KE346361.1|	2583130	2583148	ACGATG	18	-	3	ATCGTC
gi|514486271|gb|KE346361.1|	2583264	2583280	AGCTGC	16	+	2	CAGCTG
gi|514486271|gb|KE346361.1|	2583523	2583538	AG	15	+	7	GA
gi|514486271|gb|KE346361.1|	2583545	2583558	AG	13	+	6	AG
gi|514486271|gb|KE346361.1|	2583658	2583670	AAGTGC	12	+	2	CAAGTG
gi|514486271|gb|KE346361.1|	2583989	2584004	AACCCC	15	-	2	GGGGTT
gi|514486271|gb|KE346361.1|	2584066	2584082	AAAGCC	16	+	2	CCAAAG
gi|514486271|gb|KE346361.1|	2584190	2584208	AACAAG	18	+	3	ACAAGA
gi|514486271|gb|KE346361.1|	2584203	2584218	AAGAGC	15	+	2	CAAGAG
gi|514486271|gb|KE346361.1|	2584239	2584256	ACTGGC	17	-	2	TGCCAG
gi|514486271|gb|KE346361.1|	2584592	2584607	ATC	15	-	5	GAT
gi|514486271|gb|KE346361.1|	2585556	2585570	AAAC	14	+	3	CAAA
gi|514486271|gb|KE346361.1|	2585651	2585664	AACAAG	13	+	2	ACAAGA
gi|514486271|gb|KE346361.1|	2586144	2586156	AATCG	12	+	2	CGAAT
gi|514486271|gb|KE346361.1|	2586754	2586766	AGAGCG	12	-	2	CTCTCG
gi|514486271|gb|KE346361.1|	2587647	2587677	ACG	30	-	10	CGT
gi|514486271|gb|KE346361.1|	2588492	2588504	ATCGGC	12	+	2	GCATCG
gi|514486271|gb|KE346361.1|	2588542	2588554	ATC	12	-	4	ATG
gi|514486271|gb|KE346361.1|	2588609	2588629	ACG	20	-	6	TCG
gi|514486271|gb|KE346361.1|	2588649	2588661	ACCATC	12	+	2	CATCAC
gi|514486271|gb|KE346361.1|	2588723	2588742	ACG	19	-	6	TCG
gi|514486271|gb|KE346361.1|	2588875	2588887	CCG	12	-	4	CGG
gi|514486271|gb|KE346361.1|	2589003	2589019	ATCGC	16	+	3	ATCGC
gi|514486271|gb|KE346361.1|	2589682	2589694	AACCAC	12	+	2	ACAACC
gi|514486271|gb|KE346361.1|	2590846	2590860	AAAAGC	14	-	2	TGCTTT
gi|514486271|gb|KE346361.1|	2592039	2592051	AAAAG	12	+	2	AAAGA
gi|514486271|gb|KE346361.1|	2593677	2593689	AGC	12	+	4	CAG
gi|514486271|gb|KE346361.1|	2593804	2593816	AAC	12	+	4	AAC
gi|514486271|gb|KE346361.1|	2594030	2594042	ACAGAG	12	+	2	GACAGA
gi|514486271|gb|KE346361.1|	2594217	2594229	AGCG	12	+	3	CGAG
gi|514486271|gb|KE346361.1|	2594348	2594370	ATC	22	-	7	GAT
gi|514486271|gb|KE346361.1|	2596218	2596230	AAATGC	12	+	2	AAATGC
gi|514486271|gb|KE346361.1|	2597021	2597033	ACTGAG	12	+	2	ACTGAG
gi|514486271|gb|KE346361.1|	2597778	2597790	AAAC	12	-	3	TTTG
gi|514486271|gb|KE346361.1|	2599799	2599811	ATCGGC	12	-	2	ATGCCG
gi|514486271|gb|KE346361.1|	2600073	2600085	AACTG	12	+	2	ACTGA
gi|514486271|gb|KE346361.1|	2600834	2600851	CCG	17	+	5	CCG
gi|514486271|gb|KE346361.1|	2600895	2600907	AGGCCG	12	+	2	CCGAGG
gi|514486271|gb|KE346361.1|	2600999	2601016	AGCCGC	17	-	2	CTGCGG
gi|514486271|gb|KE346361.1|	2601015	2601038	ACAGTC	23	-	3	GACTGT
gi|514486271|gb|KE346361.1|	2602520	2602532	ACTCGG	12	-	2	AGTCCG
gi|514486271|gb|KE346361.1|	2604840	2604855	ACGGAG	15	+	2	GAGACG
gi|514486271|gb|KE346361.1|	2605554	2605567	AACGG	13	+	2	ACGGA
gi|514486271|gb|KE346361.1|	2605697	2605709	AATCAC	12	+	2	AATCAC
gi|514486271|gb|KE346361.1|	2607849	2607876	AG	27	+	13	AG
gi|514486271|gb|KE346361.1|	2608010	2608025	AGAGCG	15	+	2	GAGCGA
gi|514486271|gb|KE346361.1|	2608260	2608277	AAAAAG	17	+	2	AAAAAG
gi|514486271|gb|KE346361.1|	2608272	2608284	A	12	+	12	A
gi|514486271|gb|KE346361.1|	2608317	2608330	A	13	+	13	A
gi|514486271|gb|KE346361.1|	2608328	2608348	AAT	20	+	6	AAT
gi|514486271|gb|KE346361.1|	2608350	2608367	AAAAAT	17	+	2	AAAAAT
gi|514486271|gb|KE346361.1|	2608362	2608374	A	12	+	12	A
gi|514486271|gb|KE346361.1|	2608475	2608502	AG	27	+	13	AG
gi|514486271|gb|KE346361.1|	2608868	2608880	AGCGGC	12	+	2	CGGCAG
gi|514486271|gb|KE346361.1|	2609493	2609520	ACG	27	-	9	GTC
gi|514486271|gb|KE346361.1|	2611083	2611096	AAC	13	+	4	ACA
gi|514486271|gb|KE346361.1|	2611654	2611670	AGATGC	16	+	2	GCAGAT
gi|514486271|gb|KE346361.1|	2611672	2611684	ACG	12	+	4	GAC
gi|514486271|gb|KE346361.1|	2612563	2612575	AACC	12	+	3	AACC
gi|514486271|gb|KE346361.1|	2614467	2614485	AAAC	18	+	4	AAAC
gi|514486271|gb|KE346361.1|	2614510	2614522	ACACAG	12	-	2	CTGTGT
gi|514486271|gb|KE346361.1|	2615190	2615202	AAGCCC	12	+	2	GCCCAA
gi|514486271|gb|KE346361.1|	2615374	2615387	AGAGCG	13	+	2	GAGAGC
gi|514486271|gb|KE346361.1|	2618039	2618051	AGAGGG	12	+	2	GGGAGA
gi|514486271|gb|KE346361.1|	2618052	2618064	AGGGGG	12	+	2	GGGGAG
gi|514486271|gb|KE346361.1|	2618076	2618088	AGGG	12	+	3	GGGA
gi|514486271|gb|KE346361.1|	2618181	2618195	AAAACC	14	+	2	AAACCA
gi|514486271|gb|KE346361.1|	2618201	2618213	AAAACC	12	+	2	AACCAA
gi|514486271|gb|KE346361.1|	2618792	2618808	ATCCGC	16	-	2	GATGCG
gi|514486271|gb|KE346361.1|	2618803	2618815	AGGATG	12	+	2	GGATGA
gi|514486271|gb|KE346361.1|	2618837	2618852	AGAGCC	15	+	2	CCAGAG
gi|514486271|gb|KE346361.1|	2618853	2618869	AGAGCC	16	+	2	AGCCAG
gi|514486271|gb|KE346361.1|	2618876	2618897	AGCCTG	21	+	3	GAGCCT
gi|514486271|gb|KE346361.1|	2618923	2618935	AGC	12	-	4	CTG
gi|514486271|gb|KE346361.1|	2619234	2619246	ACTC	12	-	3	GAGT
gi|514486271|gb|KE346361.1|	2619305	2619321	AGGATG	16	-	2	ATCCTC
gi|514486271|gb|KE346361.1|	2619359	2619371	AAAAAC	12	-	2	TGTTTT
gi|514486271|gb|KE346361.1|	2619485	2619510	AAC	25	+	8	CAA
gi|514486271|gb|KE346361.1|	2619515	2619527	ACTGCG	12	-	2	GTCGCA
gi|514486271|gb|KE346361.1|	2619597	2619611	ACC	14	-	4	GGT
gi|514486271|gb|KE346361.1|	2619841	2619857	AACAAT	16	+	2	ATAACA
gi|514486271|gb|KE346361.1|	2619913	2619926	AGC	13	-	4	CTG
gi|514486271|gb|KE346361.1|	2620430	2620445	AC	15	-	7	TG
gi|514486271|gb|KE346361.1|	2621471	2621483	AGCAGG	12	-	2	GCTCCT
gi|514486271|gb|KE346361.1|	2621778	2621790	AACAC	12	-	2	TGTTG
gi|514486271|gb|KE346361.1|	2622253	2622266	ACATCT	13	-	2	TGTAGA
gi|514486271|gb|KE346361.1|	2622696	2622708	AAAT	12	-	3	TATT
gi|514486271|gb|KE346361.1|	2623484	2623496	AACATG	12	-	2	GTTCAT
gi|514486271|gb|KE346361.1|	2623666	2623679	ACC	13	+	4	ACC
gi|514486271|gb|KE346361.1|	2623962	2623977	A	15	+	15	A
gi|514486271|gb|KE346361.1|	2624186	2624208	A	22	-	22	T
gi|514486271|gb|KE346361.1|	2624216	2624228	AAATGC	12	-	2	TGCATT
gi|514486271|gb|KE346361.1|	2624250	2624262	AAAAAG	12	+	2	GAAAAA
gi|514486271|gb|KE346361.1|	2625101	2625113	AGGG	12	-	3	TCCC
gi|514486271|gb|KE346361.1|	2625117	2625129	AAAAG	12	-	2	TTTTC
gi|514486271|gb|KE346361.1|	2625258	2625271	A	13	-	13	T
gi|514486271|gb|KE346361.1|	2625287	2625299	AAAAT	12	-	2	TTTTA
gi|514486271|gb|KE346361.1|	2625612	2625625	ACCG	13	+	3	CCGA
gi|514486271|gb|KE346361.1|	2626041	2626060	AGC	19	-	6	TGC
gi|514486271|gb|KE346361.1|	2626264	2626276	AAATGC	12	+	2	AATGCA
gi|514486271|gb|KE346361.1|	2626385	2626397	AAAAAT	12	-	2	TTTATT
gi|514486271|gb|KE346361.1|	2626503	2626515	AAC	12	-	4	TTG
gi|514486271|gb|KE346361.1|	2626802	2626814	AAACAC	12	-	2	GTGTTT
gi|514486271|gb|KE346361.1|	2632248	2632260	ACCGCC	12	+	2	CCACCG
gi|514486271|gb|KE346361.1|	2634865	2634877	AAATAC	12	+	2	ATACAA
gi|514486271|gb|KE346361.1|	2635852	2635875	AG	23	+	11	GA
gi|514486271|gb|KE346361.1|	2636824	2636846	AGC	22	+	7	GCA
gi|514486271|gb|KE346361.1|	2636896	2636910	ATC	14	+	4	TCA
gi|514486271|gb|KE346361.1|	2639062	2639074	AGCG	12	-	3	CTCG
gi|514486271|gb|KE346361.1|	2639310	2639329	ACG	19	+	6	GAC
gi|514486271|gb|KE346361.1|	2639678	2639690	AGCG	12	+	3	GAGC
gi|514486271|gb|KE346361.1|	2639690	2639709	AG	19	+	9	AG
gi|514486271|gb|KE346361.1|	2639709	2639723	AG	14	+	7	AG
gi|514486271|gb|KE346361.1|	2639730	2639743	AAAAAG	13	+	2	AAGAAA
gi|514486271|gb|KE346361.1|	2639899	2639922	AAT	23	-	7	TTA
gi|514486271|gb|KE346361.1|	2639930	2639942	A	12	-	12	T
gi|514486271|gb|KE346361.1|	2640230	2640256	ACG	26	-	8	GTC
gi|514486271|gb|KE346361.1|	2640328	2640341	AG	13	-	6	CT
gi|514486271|gb|KE346361.1|	2640342	2640358	ACAGAG	16	-	2	GTCTCT
gi|514486271|gb|KE346361.1|	2640369	2640381	ATC	12	-	4	ATG
gi|514486271|gb|KE346361.1|	2640434	2640447	ACACTC	13	-	2	GTGAGT
gi|514486271|gb|KE346361.1|	2640444	2640457	ACACTC	13	-	2	GTGAGT
gi|514486271|gb|KE346361.1|	2640458	2640471	AC	13	-	6	GT
gi|514486271|gb|KE346361.1|	2640507	2640535	A	28	+	28	A
gi|514486271|gb|KE346361.1|	2640728	2640742	AACG	14	-	3	TCGT
gi|514486271|gb|KE346361.1|	2641019	2641031	ACTCC	12	-	2	GTGGA
gi|514486271|gb|KE346361.1|	2641396	2641408	ACTG	12	-	3	TCAG
gi|514486271|gb|KE346361.1|	2641570	2641582	AGAGC	12	-	2	CTCTG
gi|514486271|gb|KE346361.1|	2641985	2641997	ACAGCG	12	+	2	CAGCGA
gi|514486271|gb|KE346361.1|	2642064	2642093	AGG	29	-	9	TCC
gi|514486271|gb|KE346361.1|	2642094	2642111	ATC	17	+	5	TCA
gi|514486271|gb|KE346361.1|	2642582	2642604	AGC	22	+	7	CAG
gi|514486271|gb|KE346361.1|	2643588	2643601	AATGAG	13	+	2	ATGAGA
gi|514486271|gb|KE346361.1|	2644140	2644153	AAAAAC	13	+	2	AACAAA
gi|514486271|gb|KE346361.1|	2644929	2645103	AAAC	174	+	43	AAAC
gi|514486271|gb|KE346361.1|	2645739	2645755	A	16	-	16	T
gi|514486271|gb|KE346361.1|	2645912	2645936	AAC	24	+	8	AAC
gi|514486271|gb|KE346361.1|	2647108	2647121	ATCGGC	13	-	2	GATGCC
gi|514486271|gb|KE346361.1|	2647276	2647289	AGC	13	+	4	GCA
gi|514486271|gb|KE346361.1|	2647331	2647368	AGAGCC	37	+	6	AGCCAG
gi|514486271|gb|KE346361.1|	2647805	2647818	ACG	13	+	4	GAC
gi|514486271|gb|KE346361.1|	2649072	2649092	AAAAAC	20	+	3	AAAAAC
gi|514486271|gb|KE346361.1|	2649873	2649886	AAC	13	+	4	AAC
gi|514486271|gb|KE346361.1|	2652144	2652156	AGC	12	+	4	GCA
gi|514486271|gb|KE346361.1|	2652496	2652508	ATCC	12	-	3	ATGG
gi|514486271|gb|KE346361.1|	2652707	2652760	AG	53	-	26	TC
gi|514486271|gb|KE346361.1|	2652918	2652933	ATCC	15	+	3	TCCA
gi|514486271|gb|KE346361.1|	2653403	2653415	ATCGCG	12	+	2	GATCGC
gi|514486271|gb|KE346361.1|	2653498	2653510	C	12	-	12	G
gi|514486271|gb|KE346361.1|	2653850	2653863	AATCG	13	-	2	TTCGA
gi|514486271|gb|KE346361.1|	2654015	2654027	ACG	12	-	4	TCG
gi|514486271|gb|KE346361.1|	2654051	2654064	ACGG	13	-	3	TCCG
gi|514486271|gb|KE346361.1|	2654333	2654363	AGC	30	+	10	AGC
gi|514486271|gb|KE346361.1|	2654464	2654495	ATC	31	-	10	ATG
gi|514486271|gb|KE346361.1|	2654497	2654510	ATC	13	-	4	ATG
gi|514486271|gb|KE346361.1|	2654607	2654622	AGCATC	15	+	2	GCATCA
gi|514486271|gb|KE346361.1|	2654620	2654637	AGCATC	17	+	2	CAGCAT
gi|514486271|gb|KE346361.1|	2654816	2654836	CCG	20	+	6	CCG
gi|514486271|gb|KE346361.1|	2654913	2654929	AGC	16	+	5	AGC
gi|514486271|gb|KE346361.1|	2654964	2654980	AACACG	16	+	2	ACGAAC
gi|514486271|gb|KE346361.1|	2655063	2655080	ACGATG	17	+	2	GACGAT
gi|514486271|gb|KE346361.1|	2655131	2655144	ACG	13	+	4	GAC
gi|514486271|gb|KE346361.1|	2655270	2655282	ACCATG	12	+	2	ACCATG
gi|514486271|gb|KE346361.1|	2655504	2655517	AAACAC	13	-	2	TGTTTG
gi|514486271|gb|KE346361.1|	2655581	2655595	AAGGAG	14	-	2	TTCTCC
gi|514486271|gb|KE346361.1|	2656359	2656377	ACG	18	+	6	CGA
gi|514486271|gb|KE346361.1|	2656616	2656628	AAAACC	12	-	2	TGGTTT
gi|514486271|gb|KE346361.1|	2657661	2657685	A	24	-	24	T
gi|514486271|gb|KE346361.1|	2657849	2657865	A	16	-	16	T
gi|514486271|gb|KE346361.1|	2658055	2658082	A	27	-	27	T
gi|514486271|gb|KE346361.1|	2658195	2658208	AGGG	13	-	3	CCCT
gi|514486271|gb|KE346361.1|	2658263	2658295	A	32	-	32	T
gi|514486271|gb|KE346361.1|	2662731	2662760	AGC	29	-	9	CTG
gi|514486271|gb|KE346361.1|	2663033	2663045	AAATCC	12	-	2	TTGGAT
gi|514486271|gb|KE346361.1|	2663522	2663539	AG	17	+	8	AG
gi|514486271|gb|KE346361.1|	2663540	2663565	AG	25	+	12	AG
gi|514486271|gb|KE346361.1|	2664156	2664184	AG	28	-	14	CT
gi|514486271|gb|KE346361.1|	2664504	2664518	AG	14	-	7	TC
gi|514486271|gb|KE346361.1|	2664731	2664752	AC	21	+	10	CA
gi|514486271|gb|KE346361.1|	2664887	2664899	AAGCG	12	-	2	CGCTT
gi|514486271|gb|KE346361.1|	2664996	2665008	ATC	12	+	4	TCA
gi|514486271|gb|KE346361.1|	2665250	2665264	ACTGGG	14	-	2	AGTCCC
gi|514486271|gb|KE346361.1|	2665490	2665503	AGC	13	+	4	AGC
gi|514486271|gb|KE346361.1|	2665840	2665854	ATCGC	14	+	2	CGCAT
gi|514486271|gb|KE346361.1|	2665879	2665891	AAGCCG	12	-	2	TTCGGC
gi|514486271|gb|KE346361.1|	2666790	2666803	AAATGT	13	-	2	TTTACA
gi|514486271|gb|KE346361.1|	2667182	2667194	AAGCTC	12	+	2	AAGCTC
gi|514486271|gb|KE346361.1|	2667473	2667494	A	21	-	21	T
gi|514486271|gb|KE346361.1|	2667494	2667506	C	12	-	12	G
gi|514486271|gb|KE346361.1|	2667517	2667531	AAAAT	14	-	2	TTTTA
gi|514486271|gb|KE346361.1|	2667701	2667751	AG	50	-	25	CT
gi|514486271|gb|KE346361.1|	2667746	2667758	AGAGAT	12	-	2	TCTCTA
gi|514486271|gb|KE346361.1|	2667759	2667775	ATC	16	+	5	CAT
