gi|514486632|gb|KE346360.1|	1084	1104	A	20	-	20	T
gi|514486632|gb|KE346360.1|	1230	1266	AG	36	-	18	TC
gi|514486632|gb|KE346360.1|	1261	1278	ACTCTC	17	+	2	CTCTCA
gi|514486632|gb|KE346360.1|	1351	1366	AGCCTG	15	+	2	CCTGAG
gi|514486632|gb|KE346360.1|	2773	2804	A	31	-	31	T
gi|514486632|gb|KE346360.1|	3048	3066	A	18	-	18	T
gi|514486632|gb|KE346360.1|	3201	3221	AGC	20	-	6	TGC
gi|514486632|gb|KE346360.1|	3401	3415	ACGGGCG	14	-	2	TCGCCCG
gi|514486632|gb|KE346360.1|	3467	3509	A	42	-	42	T
gi|514486632|gb|KE346360.1|	3718	3738	A	20	-	20	T
gi|514486632|gb|KE346360.1|	4391	4415	A	24	-	24	T
gi|514486632|gb|KE346360.1|	4726	4740	ACCCCCC	14	-	2	GGTGGGG
gi|514486632|gb|KE346360.1|	4930	4945	AAAC	15	-	3	TTTG
gi|514486632|gb|KE346360.1|	6253	6269	AAAC	16	-	4	TTTG
gi|514486632|gb|KE346360.1|	7961	7975	ACGGCCG	14	-	2	CCGTCGG
gi|514486632|gb|KE346360.1|	9685	9700	AAAAAAC	15	+	2	AAAAACA
gi|514486632|gb|KE346360.1|	9725	9741	A	16	+	16	A
gi|514486632|gb|KE346360.1|	9776	9793	A	17	+	17	A
gi|514486632|gb|KE346360.1|	9829	9843	ACATGC	14	-	2	GCATGT
gi|514486632|gb|KE346360.1|	10973	10990	AC	17	+	8	AC
gi|514486632|gb|KE346360.1|	11346	11360	AGAGCGG	14	+	2	GAGAGCG
gi|514486632|gb|KE346360.1|	11835	11884	AC	49	+	24	AC
gi|514486632|gb|KE346360.1|	12045	12063	AGG	18	-	6	CCT
gi|514486632|gb|KE346360.1|	13305	13322	AGC	17	+	5	AGC
gi|514486632|gb|KE346360.1|	13320	13338	AAG	18	+	6	AGA
gi|514486632|gb|KE346360.1|	13454	13472	ATC	18	-	6	ATG
gi|514486632|gb|KE346360.1|	13467	13490	ACCATC	23	-	3	TGATGG
gi|514486632|gb|KE346360.1|	13576	13599	AGC	23	-	7	TGC
gi|514486632|gb|KE346360.1|	13599	13627	ACGCCG	28	-	4	GTCGGC
gi|514486632|gb|KE346360.1|	13720	13748	AGC	28	-	9	CTG
gi|514486632|gb|KE346360.1|	13961	13983	AGC	22	-	7	TGC
gi|514486632|gb|KE346360.1|	14127	14149	A	22	+	22	A
gi|514486632|gb|KE346360.1|	14197	14211	AGG	14	+	4	GGA
gi|514486632|gb|KE346360.1|	14516	14547	A	31	+	31	A
gi|514486632|gb|KE346360.1|	15825	15839	AG	14	+	7	AG
gi|514486632|gb|KE346360.1|	15949	15969	ACGGCG	20	+	3	GACGGC
gi|514486632|gb|KE346360.1|	16038	16053	A	15	+	15	A
gi|514486632|gb|KE346360.1|	16225	16239	AAAAAG	14	-	2	TTTTTC
gi|514486632|gb|KE346360.1|	16387	16413	AAAC	26	-	6	TGTT
gi|514486632|gb|KE346360.1|	16904	16919	AAAC	15	-	3	TTTG
gi|514486632|gb|KE346360.1|	17229	17247	AGC	18	-	6	TGC
gi|514486632|gb|KE346360.1|	17932	17946	AGC	14	-	4	TGC
gi|514486632|gb|KE346360.1|	18388	18402	AAAAC	14	+	2	AAAAC
gi|514486632|gb|KE346360.1|	21201	21218	AAAAAC	17	+	2	AACAAA
gi|514486632|gb|KE346360.1|	21235	21254	AAAC	19	+	4	AAAC
gi|514486632|gb|KE346360.1|	21247	21261	AAAAAC	14	+	2	AAACAA
gi|514486632|gb|KE346360.1|	21380	21408	AGC	28	-	9	GCT
gi|514486632|gb|KE346360.1|	21983	22033	AC	50	+	25	CA
gi|514486632|gb|KE346360.1|	22400	22436	AGC	36	-	12	CTG
gi|514486632|gb|KE346360.1|	23264	23278	AACAGC	14	-	2	TGCTGT
gi|514486632|gb|KE346360.1|	23994	24009	AAAAACG	15	+	2	CGAAAAA
gi|514486632|gb|KE346360.1|	24622	24652	AGC	30	+	10	CAG
gi|514486632|gb|KE346360.1|	24971	24985	AGCAGG	14	-	2	TGCTCC
gi|514486632|gb|KE346360.1|	25004	25020	AGCAGG	16	-	2	TCCTGC
gi|514486632|gb|KE346360.1|	25421	25435	AATGTC	14	+	2	GTCAAT
gi|514486632|gb|KE346360.1|	25564	25578	ACACAG	14	+	2	CACAGA
gi|514486632|gb|KE346360.1|	25655	25670	AAAC	15	+	3	AAAC
gi|514486632|gb|KE346360.1|	30665	30680	AAC	15	+	5	ACA
gi|514486632|gb|KE346360.1|	30789	30803	A	14	+	14	A
gi|514486632|gb|KE346360.1|	30831	30846	A	15	+	15	A
gi|514486632|gb|KE346360.1|	31523	31540	AAAATAC	17	+	2	AAAATAC
gi|514486632|gb|KE346360.1|	31956	31975	A	19	-	19	T
gi|514486632|gb|KE346360.1|	32161	32178	A	17	+	17	A
gi|514486632|gb|KE346360.1|	32603	32618	AGCGC	15	+	3	CAGCG
gi|514486632|gb|KE346360.1|	32963	32978	AACCCTC	15	-	2	GAGGGTT
gi|514486632|gb|KE346360.1|	33054	33068	ACCACTG	14	+	2	ACCACTG
gi|514486632|gb|KE346360.1|	33755	33779	AAAAATC	24	-	3	TTTTTGA
gi|514486632|gb|KE346360.1|	34707	34726	AAAGC	19	+	3	CAAAG
gi|514486632|gb|KE346360.1|	35000	35016	CCGCG	16	-	3	CGGCG
gi|514486632|gb|KE346360.1|	39970	39985	AAG	15	-	5	TTC
gi|514486632|gb|KE346360.1|	40234	40263	ACAGGC	29	+	4	CAGGCA
gi|514486632|gb|KE346360.1|	40260	40275	AGCGCC	15	-	2	GGCGCT
gi|514486632|gb|KE346360.1|	40869	40883	ACGATG	14	+	2	GATGAC
gi|514486632|gb|KE346360.1|	41729	41744	AATGCGG	15	-	2	CGCATTC
gi|514486632|gb|KE346360.1|	42334	42353	ACG	19	+	6	ACG
gi|514486632|gb|KE346360.1|	42550	42579	AC	29	-	14	GT
gi|514486632|gb|KE346360.1|	43263	43278	A	15	-	15	T
gi|514486632|gb|KE346360.1|	43578	43592	AAAGACG	14	+	2	AAAGACG
gi|514486632|gb|KE346360.1|	43606	43656	A	50	+	50	A
gi|514486632|gb|KE346360.1|	43665	43680	AAAACG	15	-	2	TTTCGT
gi|514486632|gb|KE346360.1|	43956	43972	AAAACG	16	+	2	AAACGA
gi|514486632|gb|KE346360.1|	43967	43981	AAAAAC	14	+	2	AAAACA
gi|514486632|gb|KE346360.1|	44148	44163	AAAAC	15	+	3	AAAAC
gi|514486632|gb|KE346360.1|	44949	44966	A	17	-	17	T
gi|514486632|gb|KE346360.1|	45143	45157	AGCGCG	14	-	2	CGCGCT
gi|514486632|gb|KE346360.1|	45242	45256	AATGCAC	14	-	2	TGCATTG
gi|514486632|gb|KE346360.1|	45301	45316	A	15	-	15	T
gi|514486632|gb|KE346360.1|	45518	45535	A	17	-	17	T
gi|514486632|gb|KE346360.1|	45751	45779	ACG	28	+	9	ACG
gi|514486632|gb|KE346360.1|	46345	46359	AACAACC	14	-	2	GGTTGTT
gi|514486632|gb|KE346360.1|	47336	47350	ACTGGG	14	+	2	GGACTG
gi|514486632|gb|KE346360.1|	47879	47898	AGC	19	-	6	TGC
gi|514486632|gb|KE346360.1|	48138	48183	A	45	-	45	T
gi|514486632|gb|KE346360.1|	48255	48270	AG	15	-	7	TC
gi|514486632|gb|KE346360.1|	48485	48499	AG	14	+	7	AG
gi|514486632|gb|KE346360.1|	48848	48863	AAAAC	15	-	3	TTTGT
gi|514486632|gb|KE346360.1|	49512	49526	AAAAAAC	14	-	2	TTTTTTG
gi|514486632|gb|KE346360.1|	50566	50581	ACCC	15	+	3	CCCA
gi|514486632|gb|KE346360.1|	52126	52142	AGC	16	-	5	GCT
gi|514486632|gb|KE346360.1|	52299	52315	AGCCGG	16	+	2	GCCGGA
gi|514486632|gb|KE346360.1|	52429	52448	AAAAAAC	19	+	2	AAAAAAC
gi|514486632|gb|KE346360.1|	52605	52619	ACACACC	14	+	2	CACACAC
gi|514486632|gb|KE346360.1|	52894	52910	AAAACAC	16	+	2	ACACAAA
gi|514486632|gb|KE346360.1|	53242	53256	AAAAAAC	14	+	2	AAACAAA
gi|514486632|gb|KE346360.1|	53686	53707	AAG	21	-	7	TTC
gi|514486632|gb|KE346360.1|	53889	53905	ACTGCT	16	-	2	TAGCAG
gi|514486632|gb|KE346360.1|	53990	54011	ATCC	21	+	5	TCCA
gi|514486632|gb|KE346360.1|	54362	54377	A	15	-	15	T
gi|514486632|gb|KE346360.1|	54383	54397	AAG	14	-	4	TCT
gi|514486632|gb|KE346360.1|	54449	54475	AAGAG	26	+	5	GAAGA
gi|514486632|gb|KE346360.1|	56305	56353	A	48	+	48	A
gi|514486632|gb|KE346360.1|	57113	57131	AAGCC	18	+	3	CAAGC
gi|514486632|gb|KE346360.1|	57175	57193	A	18	+	18	A
gi|514486632|gb|KE346360.1|	57371	57400	A	29	+	29	A
gi|514486632|gb|KE346360.1|	57598	57618	A	20	+	20	A
gi|514486632|gb|KE346360.1|	58507	58523	A	16	-	16	T
gi|514486632|gb|KE346360.1|	59442	59464	A	22	-	22	T
gi|514486632|gb|KE346360.1|	59660	59674	A	14	-	14	T
gi|514486632|gb|KE346360.1|	59724	59738	AATCATC	14	-	2	ATGATTG
gi|514486632|gb|KE346360.1|	68300	68314	AAAG	14	+	3	AAAG
gi|514486632|gb|KE346360.1|	68483	68500	AAATCGC	17	-	2	TGCGATT
gi|514486632|gb|KE346360.1|	68606	68623	AG	17	+	8	AG
gi|514486632|gb|KE346360.1|	68682	68698	AAAAT	16	+	3	AAATA
gi|514486632|gb|KE346360.1|	68783	68800	AAAAAAT	17	-	2	TTTTTTA
gi|514486632|gb|KE346360.1|	68952	68974	ACTC	22	+	5	ACTC
gi|514486632|gb|KE346360.1|	72160	72176	ACGAGG	16	+	2	GAGGAC
gi|514486632|gb|KE346360.1|	72508	72527	AGC	19	+	6	GCA
gi|514486632|gb|KE346360.1|	73095	73112	AGCGCG	17	+	2	GAGCGC
gi|514486632|gb|KE346360.1|	73510	73524	AATC	14	-	3	TTGA
gi|514486632|gb|KE346360.1|	73522	73538	AAAAAAC	16	-	2	TTTTTTG
gi|514486632|gb|KE346360.1|	73558	73579	A	21	-	21	T
gi|514486632|gb|KE346360.1|	73661	73684	AGC	23	-	7	CTG
gi|514486632|gb|KE346360.1|	74254	74268	AAAAG	14	-	2	TTTTC
gi|514486632|gb|KE346360.1|	74312	74328	ACACATC	16	-	2	TGTGTGA
gi|514486632|gb|KE346360.1|	74332	74347	AAGTG	15	+	3	TGAAG
gi|514486632|gb|KE346360.1|	74489	74505	AAGGGG	16	-	2	CTTCCC
gi|514486632|gb|KE346360.1|	74650	74729	AAG	79	-	26	TTC
gi|514486632|gb|KE346360.1|	74803	74817	AAC	14	-	4	TGT
gi|514486632|gb|KE346360.1|	76002	76018	A	16	-	16	T
gi|514486632|gb|KE346360.1|	77599	77614	AACAGCC	15	+	2	CCAACAG
gi|514486632|gb|KE346360.1|	77906	77922	ATC	16	-	5	GAT
gi|514486632|gb|KE346360.1|	79572	79591	AAG	19	+	6	AAG
gi|514486632|gb|KE346360.1|	80833	80847	ACTGCG	14	+	2	CTGCGA
gi|514486632|gb|KE346360.1|	81232	81246	A	14	+	14	A
gi|514486632|gb|KE346360.1|	81286	81308	AAAACC	22	-	3	TTTTGG
gi|514486632|gb|KE346360.1|	81509	81524	AAAT	15	+	3	AAAT
gi|514486632|gb|KE346360.1|	81528	81544	AAAAAAT	16	+	2	AATAAAA
gi|514486632|gb|KE346360.1|	81560	81574	AATG	14	-	3	CATT
gi|514486632|gb|KE346360.1|	81919	81936	A	17	+	17	A
gi|514486632|gb|KE346360.1|	82043	82058	A	15	+	15	A
gi|514486632|gb|KE346360.1|	83426	83441	AAAAAAC	15	-	2	TTTTTGT
gi|514486632|gb|KE346360.1|	84862	84877	ACACGCC	15	+	2	ACACGCC
gi|514486632|gb|KE346360.1|	89546	89567	ACGCCG	21	+	3	ACGCCG
gi|514486632|gb|KE346360.1|	90329	90359	AGC	30	+	10	AGC
gi|514486632|gb|KE346360.1|	90419	90434	AAGCGCC	15	+	2	CGCCAAG
gi|514486632|gb|KE346360.1|	92260	92274	AACAACC	14	+	2	CCAACAA
gi|514486632|gb|KE346360.1|	93347	93363	AAAACTC	16	-	2	TTTGAGT
gi|514486632|gb|KE346360.1|	93772	93803	ATC	31	-	10	TGA
gi|514486632|gb|KE346360.1|	93829	93848	ACTC	19	-	4	GAGT
gi|514486632|gb|KE346360.1|	94589	94603	AAGCTC	14	+	2	TCAAGC
gi|514486632|gb|KE346360.1|	94687	94701	AACGCG	14	+	2	CGAACG
gi|514486632|gb|KE346360.1|	94892	94910	ACC	18	+	6	CAC
gi|514486632|gb|KE346360.1|	95335	95349	AGAGGG	14	-	2	CTCTCC
gi|514486632|gb|KE346360.1|	96096	96122	AGC	26	-	8	CTG
gi|514486632|gb|KE346360.1|	98937	98962	ACC	25	+	8	CCA
gi|514486632|gb|KE346360.1|	99130	99144	AGCGCG	14	+	2	GCGAGC
gi|514486632|gb|KE346360.1|	99979	99997	AGG	18	-	6	TCC
gi|514486632|gb|KE346360.1|	100457	100476	AGC	19	+	6	AGC
gi|514486632|gb|KE346360.1|	101555	101578	ACTGCC	23	+	3	CTGCCA
gi|514486632|gb|KE346360.1|	104114	104128	ACAGT	14	+	2	AGTAC
gi|514486632|gb|KE346360.1|	104536	104551	AAACAAC	15	-	2	TGTTGTT
gi|514486632|gb|KE346360.1|	104561	104584	AAACAAC	23	-	3	TTGTTTG
gi|514486632|gb|KE346360.1|	104617	104641	AAACAAC	24	-	3	TTTGTTG
gi|514486632|gb|KE346360.1|	104766	104783	AAAAAT	17	-	2	TTTTTA
gi|514486632|gb|KE346360.1|	104783	104803	AAT	20	-	6	TTA
gi|514486632|gb|KE346360.1|	104840	104858	A	18	-	18	T
gi|514486632|gb|KE346360.1|	105224	105239	ACC	15	+	5	CAC
gi|514486632|gb|KE346360.1|	105234	105251	AACCAC	17	+	2	ACCACA
gi|514486632|gb|KE346360.1|	105319	105347	ACG	28	-	9	CGT
gi|514486632|gb|KE346360.1|	105486	105507	ACTGCC	21	-	3	GGCAGT
gi|514486632|gb|KE346360.1|	105567	105582	ATCGCC	15	+	2	CCATCG
gi|514486632|gb|KE346360.1|	105669	105689	AGC	20	-	6	GCT
gi|514486632|gb|KE346360.1|	105760	105775	ACG	15	-	5	CGT
gi|514486632|gb|KE346360.1|	105795	105809	ACGGGG	14	-	2	CCGTCC
gi|514486632|gb|KE346360.1|	105929	105956	ACTC	27	-	6	GAGT
gi|514486632|gb|KE346360.1|	106010	106026	A	16	-	16	T
gi|514486632|gb|KE346360.1|	106036	106053	AAAAAG	17	-	2	TTTTTC
gi|514486632|gb|KE346360.1|	106057	106074	AG	17	-	8	TC
gi|514486632|gb|KE346360.1|	106295	106319	AAG	24	-	8	CTT
gi|514486632|gb|KE346360.1|	106649	106668	AAATGC	19	+	3	AATGCA
gi|514486632|gb|KE346360.1|	106708	106727	AACATC	19	-	3	TTGATG
gi|514486632|gb|KE346360.1|	106777	106791	AACAGC	14	+	2	CAACAG
gi|514486632|gb|KE346360.1|	106789	106803	AACAGC	14	+	2	CAGCAA
gi|514486632|gb|KE346360.1|	107000	107015	ACCTGG	15	-	2	CAGGTC
gi|514486632|gb|KE346360.1|	107047	107061	AACAGC	14	+	2	GCAACA
gi|514486632|gb|KE346360.1|	107936	107950	AAAAAAC	14	-	2	TGTTTTT
gi|514486632|gb|KE346360.1|	107986	108001	AAGAGG	15	-	2	CTTCCT
gi|514486632|gb|KE346360.1|	108799	108813	AAC	14	+	4	CAA
gi|514486632|gb|KE346360.1|	108853	108867	AAC	14	+	4	CAA
gi|514486632|gb|KE346360.1|	108865	108879	AGC	14	+	4	CAG
gi|514486632|gb|KE346360.1|	113098	113112	A	14	-	14	T
gi|514486632|gb|KE346360.1|	113650	113667	AAGCAG	17	-	2	CTGCTT
gi|514486632|gb|KE346360.1|	114392	114411	AACAGC	19	-	3	TGTTGC
gi|514486632|gb|KE346360.1|	114512	114527	AAACAGG	15	-	2	TTCCTGT
gi|514486632|gb|KE346360.1|	116102	116117	AGCCCG	15	-	2	TCGGGC
gi|514486632|gb|KE346360.1|	116572	116587	AGCGGC	15	-	2	TGCCGC
gi|514486632|gb|KE346360.1|	117251	117276	ACTC	25	+	6	TCAC
gi|514486632|gb|KE346360.1|	118965	118979	AAC	14	-	4	GTT
gi|514486632|gb|KE346360.1|	120617	120637	AACCAC	20	+	3	ACAACC
gi|514486632|gb|KE346360.1|	121255	121275	AACAGC	20	+	3	CAACAG
gi|514486632|gb|KE346360.1|	121270	121287	ACCAGC	17	+	2	CAGCAC
gi|514486632|gb|KE346360.1|	121282	121297	AACAGC	15	+	2	CAGCAA
gi|514486632|gb|KE346360.1|	121902	121916	AAAACAC	14	-	2	TTTTGTG
gi|514486632|gb|KE346360.1|	130510	130525	ACTCC	15	+	3	CACTC
gi|514486632|gb|KE346360.1|	130845	130859	AAGCACC	14	-	2	CTTGGTG
gi|514486632|gb|KE346360.1|	131665	131679	AAGACG	14	+	2	ACGAAG
gi|514486632|gb|KE346360.1|	135595	135612	AAACACC	17	+	2	ACCAAAC
gi|514486632|gb|KE346360.1|	136139	136153	A	14	+	14	A
gi|514486632|gb|KE346360.1|	138696	138716	AAAAAAG	20	-	2	TTTTTTC
gi|514486632|gb|KE346360.1|	138870	138884	AAAAAT	14	+	2	AAAAAT
gi|514486632|gb|KE346360.1|	138893	138908	AAAAAAT	15	+	2	AAAATAA
gi|514486632|gb|KE346360.1|	139256	139280	A	24	+	24	A
gi|514486632|gb|KE346360.1|	139539	139554	AAAAAAT	15	+	2	AAAAAAT
gi|514486632|gb|KE346360.1|	140034	140052	A	18	+	18	A
gi|514486632|gb|KE346360.1|	140624	140644	AAC	20	+	6	AAC
gi|514486632|gb|KE346360.1|	140737	140751	AAAAAAC	14	+	2	AAAAACA
gi|514486632|gb|KE346360.1|	143050	143068	ACCAGC	18	-	3	TGGTGC
gi|514486632|gb|KE346360.1|	143063	143077	ACCGGC	14	-	2	GGTGCC
gi|514486632|gb|KE346360.1|	143423	143437	AGCCGC	14	+	2	GCAGCC
gi|514486632|gb|KE346360.1|	143470	143484	ACT	14	-	4	AGT
gi|514486632|gb|KE346360.1|	144050	144064	CCG	14	+	4	GCC
gi|514486632|gb|KE346360.1|	144525	144541	AG	16	-	8	CT
gi|514486632|gb|KE346360.1|	144578	144606	AAG	28	-	9	CTT
gi|514486632|gb|KE346360.1|	144694	144718	A	24	-	24	T
gi|514486632|gb|KE346360.1|	145032	145047	A	15	+	15	A
gi|514486632|gb|KE346360.1|	145271	145293	A	22	-	22	T
gi|514486632|gb|KE346360.1|	145439	145454	AAAAAAT	15	+	2	AATAAAA
gi|514486632|gb|KE346360.1|	145482	145502	A	20	+	20	A
gi|514486632|gb|KE346360.1|	146461	146479	AG	18	+	9	AG
gi|514486632|gb|KE346360.1|	146709	146727	A	18	-	18	T
gi|514486632|gb|KE346360.1|	148116	148133	AAAAAC	17	+	2	AACAAA
gi|514486632|gb|KE346360.1|	149056	149070	C	14	-	14	G
gi|514486632|gb|KE346360.1|	150515	150533	AAAAAC	18	+	3	AAAAAC
gi|514486632|gb|KE346360.1|	150530	150549	AACC	19	+	4	AACC
gi|514486632|gb|KE346360.1|	151048	151068	ATC	20	+	6	TCA
gi|514486632|gb|KE346360.1|	153311	153325	AAACC	14	+	2	AAACC
gi|514486632|gb|KE346360.1|	154125	154139	AACAGTC	14	+	2	CAGTCAA
gi|514486632|gb|KE346360.1|	154790	154805	AGC	15	+	5	CAG
gi|514486632|gb|KE346360.1|	154869	154890	ACC	21	-	7	GTG
gi|514486632|gb|KE346360.1|	155014	155028	ACTC	14	-	3	AGTG
gi|514486632|gb|KE346360.1|	156894	156913	AGCG	19	-	4	GCTC
gi|514486632|gb|KE346360.1|	157548	157566	A	18	+	18	A
gi|514486632|gb|KE346360.1|	157924	157944	AG	20	+	10	AG
gi|514486632|gb|KE346360.1|	158017	158032	AAAAAC	15	+	2	AAAAAC
gi|514486632|gb|KE346360.1|	158189	158203	AAAACTC	14	+	2	CAAAACT
gi|514486632|gb|KE346360.1|	163972	163986	AACGAGC	14	-	2	CTCGTTG
gi|514486632|gb|KE346360.1|	169475	169490	AACCGAC	15	-	2	GTCGGTT
gi|514486632|gb|KE346360.1|	173147	173162	AACCGAC	15	-	2	GTCGGTT
gi|514486632|gb|KE346360.1|	180662	180676	AACAGAG	14	-	2	TCTGTTC
gi|514486632|gb|KE346360.1|	180711	180728	AACATC	17	-	2	ATGTTG
gi|514486632|gb|KE346360.1|	181044	181061	AGCCCC	17	-	2	CTGGGG
gi|514486632|gb|KE346360.1|	181062	181091	AGCCCC	29	-	4	CTGGGG
gi|514486632|gb|KE346360.1|	181385	181402	ACGAGG	17	+	2	GACGAG
gi|514486632|gb|KE346360.1|	183258	183272	AAAAAAG	14	-	2	CTTTTTT
gi|514486632|gb|KE346360.1|	183266	183293	A	27	-	27	T
gi|514486632|gb|KE346360.1|	183968	183986	AACCGC	18	+	3	GCAACC
gi|514486632|gb|KE346360.1|	187195	187212	AAG	17	+	5	GAA
gi|514486632|gb|KE346360.1|	188689	188704	AAAAAAG	15	+	2	AGAAAAA
gi|514486632|gb|KE346360.1|	189023	189037	AGCATCG	14	-	2	CTCGATG
gi|514486632|gb|KE346360.1|	189353	189380	A	27	-	27	T
gi|514486632|gb|KE346360.1|	189911	189942	A	31	+	31	A
gi|514486632|gb|KE346360.1|	189999	190013	A	14	+	14	A
gi|514486632|gb|KE346360.1|	191992	192007	AAAC	15	+	3	AAAC
gi|514486632|gb|KE346360.1|	193799	193818	ACG	19	+	6	GAC
gi|514486632|gb|KE346360.1|	195414	195429	A	15	+	15	A
gi|514486632|gb|KE346360.1|	195433	195453	A	20	+	20	A
gi|514486632|gb|KE346360.1|	195547	195565	AG	18	-	9	TC
gi|514486632|gb|KE346360.1|	195931	195946	ACG	15	+	5	CGA
gi|514486632|gb|KE346360.1|	196066	196084	ACTCTC	18	-	3	AGAGTG
gi|514486632|gb|KE346360.1|	196118	196138	ACCAGC	20	-	3	GCTGGT
gi|514486632|gb|KE346360.1|	196131	196145	ACCAGGC	14	-	2	CTGGTGC
gi|514486632|gb|KE346360.1|	196144	196158	ACAGCG	14	-	2	CGCTGT
gi|514486632|gb|KE346360.1|	196253	196276	ATC	23	+	7	TCA
gi|514486632|gb|KE346360.1|	196313	196330	AGCATC	17	-	2	TGCTGA
gi|514486632|gb|KE346360.1|	196450	196483	ATC	33	+	11	ATC
gi|514486632|gb|KE346360.1|	196603	196618	AACGAC	15	+	2	AACGAC
gi|514486632|gb|KE346360.1|	196822	196836	AACTGAC	14	-	2	TTGTCAG
gi|514486632|gb|KE346360.1|	196971	196985	ATC	14	+	4	CAT
gi|514486632|gb|KE346360.1|	197603	197621	AACAGC	18	+	3	CAACAG
gi|514486632|gb|KE346360.1|	197871	197899	ACG	28	+	9	ACG
gi|514486632|gb|KE346360.1|	199308	199336	A	28	-	28	T
gi|514486632|gb|KE346360.1|	200742	200757	AAGC	15	-	3	TGCT
gi|514486632|gb|KE346360.1|	201742	201759	AG	17	-	8	CT
gi|514486632|gb|KE346360.1|	202424	202438	AAAAAAC	14	+	2	CAAAAAA
gi|514486632|gb|KE346360.1|	203220	203235	AGAGGG	15	+	2	AGAGGG
gi|514486632|gb|KE346360.1|	204412	204426	AAGC	14	+	3	AAGC
gi|514486632|gb|KE346360.1|	204453	204470	ACTG	17	-	4	TCAG
gi|514486632|gb|KE346360.1|	204649	204670	CCG	21	-	7	GGC
gi|514486632|gb|KE346360.1|	205654	205668	AAAGAGC	14	-	2	CTTTGCT
gi|514486632|gb|KE346360.1|	205897	205911	AACGC	14	+	2	CGCAA
gi|514486632|gb|KE346360.1|	205954	205970	A	16	-	16	T
gi|514486632|gb|KE346360.1|	205972	205987	A	15	-	15	T
gi|514486632|gb|KE346360.1|	206051	206070	ACGCTG	19	+	3	CGCTGA
gi|514486632|gb|KE346360.1|	206195	206211	A	16	-	16	T
gi|514486632|gb|KE346360.1|	206268	206283	AACAC	15	-	3	GTTGT
gi|514486632|gb|KE346360.1|	206499	206513	AG	14	+	7	GA
gi|514486632|gb|KE346360.1|	206557	206572	ACCCCTC	15	+	2	CTCACCC
gi|514486632|gb|KE346360.1|	208491	208506	A	15	+	15	A
gi|514486632|gb|KE346360.1|	209056	209080	A	24	+	24	A
gi|514486632|gb|KE346360.1|	210510	210527	A	17	-	17	T
gi|514486632|gb|KE346360.1|	210523	210537	AAAAC	14	-	2	TTTTG
gi|514486632|gb|KE346360.1|	210533	210547	A	14	-	14	T
gi|514486632|gb|KE346360.1|	211855	211870	ACGAGG	15	+	2	CGAGGA
gi|514486632|gb|KE346360.1|	212010	212024	AGCATC	14	+	2	CAGCAT
gi|514486632|gb|KE346360.1|	212028	212045	ATC	17	+	5	CAT
gi|514486632|gb|KE346360.1|	213127	213142	AGC	15	-	5	TGC
gi|514486632|gb|KE346360.1|	213302	213319	AGCGGC	17	-	2	GCCGCT
gi|514486632|gb|KE346360.1|	215561	215582	ACGC	21	+	5	CGCA
gi|514486632|gb|KE346360.1|	216175	216189	A	14	-	14	T
gi|514486632|gb|KE346360.1|	216255	216271	AAAAAAG	16	-	2	TTTTCTT
gi|514486632|gb|KE346360.1|	216280	216294	AAG	14	-	4	CTT
gi|514486632|gb|KE346360.1|	217379	217412	ACT	33	+	11	ACT
gi|514486632|gb|KE346360.1|	218150	218164	ACG	14	-	4	TCG
gi|514486632|gb|KE346360.1|	219007	219025	ACAGAG	18	-	3	TCTCTG
gi|514486632|gb|KE346360.1|	219760	219774	A	14	-	14	T
gi|514486632|gb|KE346360.1|	220230	220247	AAAAAAC	17	+	2	CAAAAAA
gi|514486632|gb|KE346360.1|	220788	220802	AAAAAAT	14	-	2	ATTTTTT
gi|514486632|gb|KE346360.1|	221015	221035	A	20	-	20	T
gi|514486632|gb|KE346360.1|	221075	221100	AG	25	-	12	CT
gi|514486632|gb|KE346360.1|	221185	221202	AAGG	17	+	4	GGAA
gi|514486632|gb|KE346360.1|	221214	221228	AAAGTCG	14	-	2	ACTTTCG
gi|514486632|gb|KE346360.1|	221260	221276	AG	16	-	8	CT
gi|514486632|gb|KE346360.1|	223907	223932	ATC	25	-	8	TGA
gi|514486632|gb|KE346360.1|	224309	224324	AG	15	+	7	AG
gi|514486632|gb|KE346360.1|	224327	224341	AATCTAC	14	-	2	TAGATTG
gi|514486632|gb|KE346360.1|	226997	227016	AGCGCC	19	+	3	CAGCGC
gi|514486632|gb|KE346360.1|	229906	229921	ACCCCCC	15	+	2	CCACCCC
gi|514486632|gb|KE346360.1|	229964	229978	AAAAAT	14	+	2	AATAAA
gi|514486632|gb|KE346360.1|	229975	230008	AAAAT	33	+	6	AAAAT
gi|514486632|gb|KE346360.1|	230014	230030	AAAAAAT	16	+	2	AAAATAA
gi|514486632|gb|KE346360.1|	230386	230433	AAAAAAT	47	+	6	AAAAAAT
gi|514486632|gb|KE346360.1|	230428	230446	AAAAAAT	18	+	2	AAAAATA
gi|514486632|gb|KE346360.1|	230441	230467	AAAAAAT	26	+	3	AAAAATA
gi|514486632|gb|KE346360.1|	230698	230723	A	25	+	25	A
gi|514486632|gb|KE346360.1|	230849	230864	ACTCTC	15	-	2	GAGTGA
gi|514486632|gb|KE346360.1|	231113	231134	AAAAGAC	21	+	3	CAAAAGA
gi|514486632|gb|KE346360.1|	234536	234642	AC	106	+	53	AC
gi|514486632|gb|KE346360.1|	235105	235123	AGC	18	-	6	GCT
gi|514486632|gb|KE346360.1|	235519	235533	AAAC	14	-	3	TTGT
gi|514486632|gb|KE346360.1|	235706	235724	AACGCC	18	+	3	CGCCAA
gi|514486632|gb|KE346360.1|	237043	237057	AC	14	+	7	CA
gi|514486632|gb|KE346360.1|	237390	237408	ATC	18	+	6	TCA
gi|514486632|gb|KE346360.1|	237509	237524	AAAAAAT	15	-	2	TTTTATT
gi|514486632|gb|KE346360.1|	237642	237659	AC	17	-	8	GT
gi|514486632|gb|KE346360.1|	237724	237741	ACTCCC	17	+	2	CACTCC
gi|514486632|gb|KE346360.1|	237846	237868	A	22	+	22	A
gi|514486632|gb|KE346360.1|	237993	238010	AGGGGG	17	+	2	GGGGAG
gi|514486632|gb|KE346360.1|	238404	238418	AACTTG	14	-	2	AAGTTC
gi|514486632|gb|KE346360.1|	238544	238561	A	17	-	17	T
gi|514486632|gb|KE346360.1|	238762	238776	AAAACAC	14	-	2	TGTTTTG
gi|514486632|gb|KE346360.1|	239601	239616	AAAAAT	15	-	2	TTTATT
gi|514486632|gb|KE346360.1|	242127	242144	AGC	17	-	5	TGC
gi|514486632|gb|KE346360.1|	242183	242209	ACGATG	26	-	4	GTCATC
gi|514486632|gb|KE346360.1|	242260	242274	AGGCGCG	14	-	2	CTCGCGC
gi|514486632|gb|KE346360.1|	242871	242888	AAC	17	-	5	TGT
gi|514486632|gb|KE346360.1|	243141	243179	ACTGCT	38	+	6	CTGCTA
gi|514486632|gb|KE346360.1|	243342	243357	AGC	15	+	5	GCA
gi|514486632|gb|KE346360.1|	243958	243972	ACG	14	+	4	ACG
gi|514486632|gb|KE346360.1|	244299	244313	AG	14	+	7	AG
gi|514486632|gb|KE346360.1|	244503	244517	AAAACGC	14	+	2	AACGCAA
gi|514486632|gb|KE346360.1|	245452	245466	AGC	14	-	4	GCT
gi|514486632|gb|KE346360.1|	245591	245608	AAAGGC	17	+	2	GCAAAG
gi|514486632|gb|KE346360.1|	245823	245837	AAGCTGC	14	+	2	GCTGCAA
gi|514486632|gb|KE346360.1|	247941	247956	A	15	-	15	T
gi|514486632|gb|KE346360.1|	248374	248396	AAC	22	+	7	ACA
gi|514486632|gb|KE346360.1|	249935	249950	ACG	15	-	5	TCG
gi|514486632|gb|KE346360.1|	250022	250039	ACGATG	17	-	2	TCATCG
gi|514486632|gb|KE346360.1|	250040	250054	ACG	14	-	4	TCG
gi|514486632|gb|KE346360.1|	250386	250401	AGC	15	+	5	CAG
gi|514486632|gb|KE346360.1|	250720	250734	AGC	14	-	4	GCT
gi|514486632|gb|KE346360.1|	250745	250769	ACG	24	-	8	TCG
gi|514486632|gb|KE346360.1|	250903	250918	AAAAAAT	15	+	2	AAAAAAT
gi|514486632|gb|KE346360.1|	252726	252745	AAAAAAC	19	+	2	AAAAACA
gi|514486632|gb|KE346360.1|	253430	253444	AAC	14	-	4	TGT
gi|514486632|gb|KE346360.1|	254400	254415	AATC	15	+	3	TCAA
gi|514486632|gb|KE346360.1|	254874	254890	AC	16	+	8	CA
gi|514486632|gb|KE346360.1|	256056	256070	ACG	14	+	4	GAC
gi|514486632|gb|KE346360.1|	256896	256940	A	44	+	44	A
gi|514486632|gb|KE346360.1|	257583	257602	AAAAAC	19	+	3	AAAACA
gi|514486632|gb|KE346360.1|	257597	257611	AAC	14	+	4	AAC
gi|514486632|gb|KE346360.1|	258197	258215	ACGATG	18	+	3	ACGATG
gi|514486632|gb|KE346360.1|	259239	259254	AATCATC	15	-	2	GATTGAT
gi|514486632|gb|KE346360.1|	262248	262262	AGATGCG	14	+	2	GCGAGAT
gi|514486632|gb|KE346360.1|	262471	262485	AAGGAG	14	-	2	TCCTTC
gi|514486632|gb|KE346360.1|	263271	263289	ACG	18	-	6	GTC
gi|514486632|gb|KE346360.1|	263584	263604	AAGACG	20	-	3	TCTTCG
gi|514486632|gb|KE346360.1|	263599	263615	ACG	16	-	5	TCG
gi|514486632|gb|KE346360.1|	263610	263624	AACGAC	14	-	2	GTCGTT
gi|514486632|gb|KE346360.1|	264231	264245	ATC	14	+	4	TCA
gi|514486632|gb|KE346360.1|	264323	264338	ACTC	15	+	3	CTCA
gi|514486632|gb|KE346360.1|	264353	264367	ACTACTC	14	+	2	ACTCACT
gi|514486632|gb|KE346360.1|	264360	264382	ACTC	22	+	5	ACTC
gi|514486632|gb|KE346360.1|	264465	264485	AGC	20	-	6	TGC
gi|514486632|gb|KE346360.1|	264576	264595	ACG	19	-	6	TCG
gi|514486632|gb|KE346360.1|	264726	264746	AGC	20	+	6	GCA
gi|514486632|gb|KE346360.1|	268748	268762	AAAAAAC	14	-	2	TTTTTGT
gi|514486632|gb|KE346360.1|	268759	268774	AC	15	-	7	TG
gi|514486632|gb|KE346360.1|	268981	269004	A	23	-	23	T
gi|514486632|gb|KE346360.1|	269428	269452	A	24	+	24	A
gi|514486632|gb|KE346360.1|	271664	271685	AG	21	-	10	TC
gi|514486632|gb|KE346360.1|	271913	271928	AC	15	+	7	CA
gi|514486632|gb|KE346360.1|	272253	272268	AGC	15	+	5	CAG
gi|514486632|gb|KE346360.1|	272480	272502	AGC	22	+	7	GCA
gi|514486632|gb|KE346360.1|	272809	272838	ACCAGC	29	-	4	TGCTGG
gi|514486632|gb|KE346360.1|	274272	274288	AAAC	16	-	4	TTTG
gi|514486632|gb|KE346360.1|	276692	276710	AAAAG	18	-	3	TTTTC
gi|514486632|gb|KE346360.1|	278825	278839	AGC	14	+	4	AGC
gi|514486632|gb|KE346360.1|	278865	278889	CCG	24	+	8	CCG
gi|514486632|gb|KE346360.1|	278955	278969	AGCCGGG	14	-	2	GCTCCCG
gi|514486632|gb|KE346360.1|	280160	280175	AGGCGG	15	-	2	TCCGCC
gi|514486632|gb|KE346360.1|	283348	283362	ACTGGC	14	-	2	CCAGTG
gi|514486632|gb|KE346360.1|	283363	283380	AGCCGG	17	+	2	GAGCCG
gi|514486632|gb|KE346360.1|	283678	283704	A	26	+	26	A
gi|514486632|gb|KE346360.1|	284921	284935	AGCATC	14	+	2	CATCAG
gi|514486632|gb|KE346360.1|	285706	285740	A	34	-	34	T
gi|514486632|gb|KE346360.1|	286131	286150	A	19	+	19	A
gi|514486632|gb|KE346360.1|	286276	286302	AAG	26	-	8	CTT
gi|514486632|gb|KE346360.1|	286708	286722	AGATGGC	14	+	2	TGGCAGA
gi|514486632|gb|KE346360.1|	289367	289382	AACACAC	15	+	2	ACACACA
gi|514486632|gb|KE346360.1|	291461	291482	ACGATG	21	+	3	GACGAT
gi|514486632|gb|KE346360.1|	291506	291532	ATC	26	-	8	GAT
gi|514486632|gb|KE346360.1|	291693	291716	A	23	-	23	T
gi|514486632|gb|KE346360.1|	291982	291996	AACGAG	14	+	2	GAGAAC
gi|514486632|gb|KE346360.1|	292003	292017	AACCAAT	14	-	2	ATTGGTT
gi|514486632|gb|KE346360.1|	292133	292149	AAGG	16	-	4	TTCC
gi|514486632|gb|KE346360.1|	292168	292185	AGC	17	-	5	GCT
gi|514486632|gb|KE346360.1|	292448	292465	AGC	17	-	5	CTG
gi|514486632|gb|KE346360.1|	294606	294626	ACG	20	-	6	TCG
gi|514486632|gb|KE346360.1|	295034	295048	AAAAATC	14	-	2	TTTTTGA
gi|514486632|gb|KE346360.1|	295454	295471	AACGAC	17	-	2	GTTGTC
gi|514486632|gb|KE346360.1|	297107	297121	AAAC	14	-	3	TTGT
gi|514486632|gb|KE346360.1|	297130	297144	AAAC	14	-	3	GTTT
gi|514486632|gb|KE346360.1|	299834	299848	AACAGC	14	-	2	TGTTGC
gi|514486632|gb|KE346360.1|	299852	299872	AAC	20	-	6	TGT
gi|514486632|gb|KE346360.1|	299867	299881	AACAGC	14	-	2	TGTTGC
gi|514486632|gb|KE346360.1|	300992	301009	AAGCTC	17	-	2	GCTTGA
gi|514486632|gb|KE346360.1|	301017	301033	AAGCTC	16	-	2	CTTGAG
gi|514486632|gb|KE346360.1|	301237	301282	A	45	+	45	A
gi|514486632|gb|KE346360.1|	301293	301313	A	20	+	20	A
gi|514486632|gb|KE346360.1|	302262	302277	AC	15	-	7	TG
gi|514486632|gb|KE346360.1|	304685	304699	ACGTCC	14	+	2	CACGTC
gi|514486632|gb|KE346360.1|	309878	309896	ACTGCT	18	-	3	AGCAGT
gi|514486632|gb|KE346360.1|	309891	309907	ACTGCC	16	-	2	GCAGTG
gi|514486632|gb|KE346360.1|	310412	310432	ACTGAG	20	-	3	TCTCAG
gi|514486632|gb|KE346360.1|	312500	312515	A	15	+	15	A
gi|514486632|gb|KE346360.1|	317188	317203	AACACAC	15	-	2	TTGTGTG
gi|514486632|gb|KE346360.1|	317671	317685	A	14	-	14	T
gi|514486632|gb|KE346360.1|	318859	318880	ACAG	21	-	5	GTCT
gi|514486632|gb|KE346360.1|	319158	319173	AAGCCG	15	+	2	GCCGAA
gi|514486632|gb|KE346360.1|	319724	319742	AAG	18	-	6	CTT
gi|514486632|gb|KE346360.1|	320993	321010	AG	17	-	8	CT
gi|514486632|gb|KE346360.1|	321663	321680	AGCGGC	17	-	2	GCTGCC
gi|514486632|gb|KE346360.1|	322408	322422	AGC	14	+	4	CAG
gi|514486632|gb|KE346360.1|	322519	322539	ACC	20	+	6	CCA
gi|514486632|gb|KE346360.1|	325384	325399	AGC	15	+	5	CAG
gi|514486632|gb|KE346360.1|	325678	325697	ACTCT	19	-	3	GTAGA
gi|514486632|gb|KE346360.1|	325883	325897	AG	14	+	7	GA
gi|514486632|gb|KE346360.1|	325916	325935	AAAAAG	19	+	3	AGAAAA
gi|514486632|gb|KE346360.1|	326197	326212	AATCGCC	15	-	2	ATTGGCG
gi|514486632|gb|KE346360.1|	326963	326977	AAAAAC	14	-	2	TTTTGT
gi|514486632|gb|KE346360.1|	327531	327546	AAAATCC	15	-	2	TTTTGGA
gi|514486632|gb|KE346360.1|	327709	327730	A	21	-	21	T
gi|514486632|gb|KE346360.1|	327742	327779	A	37	-	37	T
gi|514486632|gb|KE346360.1|	327804	327818	AAGGGG	14	-	2	CCTTCC
gi|514486632|gb|KE346360.1|	329891	329905	AAATATC	14	+	2	ATCAAAT
gi|514486632|gb|KE346360.1|	332826	332842	AACGAC	16	-	2	TCGTTG
gi|514486632|gb|KE346360.1|	332837	332855	ACCACG	18	-	3	GTCGTG
gi|514486632|gb|KE346360.1|	333528	333542	AGC	14	+	4	CAG
gi|514486632|gb|KE346360.1|	334019	334033	AAAAAAC	14	+	2	AAACAAA
gi|514486632|gb|KE346360.1|	334026	334041	AAAC	15	+	3	AAAC
gi|514486632|gb|KE346360.1|	335173	335274	AG	101	-	50	TC
gi|514486632|gb|KE346360.1|	335275	335302	AG	27	-	13	TC
gi|514486632|gb|KE346360.1|	336893	336921	AAG	28	-	9	TCT
gi|514486632|gb|KE346360.1|	337959	338019	AC	60	-	30	TG
gi|514486632|gb|KE346360.1|	340120	340134	AAGACG	14	-	2	CTTCGT
gi|514486632|gb|KE346360.1|	340410	340424	ACGACGC	14	-	2	GCGTCGT
gi|514486632|gb|KE346360.1|	340603	340617	AAAAAC	14	-	2	TTTTTG
gi|514486632|gb|KE346360.1|	340623	340639	AAAGATC	16	-	2	GATCTTT
gi|514486632|gb|KE346360.1|	342226	342240	AGGGGG	14	-	2	CCCCCT
gi|514486632|gb|KE346360.1|	344855	344875	A	20	+	20	A
gi|514486632|gb|KE346360.1|	345153	345168	AAACGAC	15	+	2	CGACAAA
gi|514486632|gb|KE346360.1|	353283	353297	AAC	14	+	4	ACA
gi|514486632|gb|KE346360.1|	353629	353643	A	14	+	14	A
gi|514486632|gb|KE346360.1|	353891	353910	AAAC	19	-	4	TTTG
gi|514486632|gb|KE346360.1|	355575	355589	AGAGGC	14	-	2	CTCTGC
gi|514486632|gb|KE346360.1|	356495	356510	ACCATC	15	+	2	CCATCA
gi|514486632|gb|KE346360.1|	356537	356551	AAG	14	-	4	TTC
gi|514486632|gb|KE346360.1|	356797	356843	A	46	+	46	A
gi|514486632|gb|KE346360.1|	357057	357080	ACTC	23	+	5	CACT
gi|514486632|gb|KE346360.1|	357079	357098	ACTC	19	+	4	CACT
gi|514486632|gb|KE346360.1|	357140	357157	ACG	17	-	5	CGT
gi|514486632|gb|KE346360.1|	357912	357926	AGAGGG	14	-	2	CCCTCT
gi|514486632|gb|KE346360.1|	358140	358155	AAAC	15	-	3	GTTT
gi|514486632|gb|KE346360.1|	358268	358286	ACG	18	-	6	CGT
gi|514486632|gb|KE346360.1|	359789	359803	A	14	+	14	A
gi|514486632|gb|KE346360.1|	360729	360743	AGCAGCC	14	-	2	CTGGCTG
gi|514486632|gb|KE346360.1|	361141	361155	AAAC	14	-	3	TGTT
gi|514486632|gb|KE346360.1|	362194	362220	AGC	26	-	8	CTG
gi|514486632|gb|KE346360.1|	366120	366137	AAAAGGC	17	+	2	AAAGGCA
gi|514486632|gb|KE346360.1|	366520	366534	A	14	-	14	T
gi|514486632|gb|KE346360.1|	366967	366982	A	15	-	15	T
gi|514486632|gb|KE346360.1|	367410	367424	AATCAGC	14	+	2	ATCAGCA
gi|514486632|gb|KE346360.1|	370139	370252	ACC	113	+	37	CAC
gi|514486632|gb|KE346360.1|	371345	371359	ATC	14	-	4	GAT
gi|514486632|gb|KE346360.1|	371553	371571	ATC	18	+	6	CAT
gi|514486632|gb|KE346360.1|	372656	372679	A	23	+	23	A
gi|514486632|gb|KE346360.1|	372814	372828	ACC	14	+	4	CAC
gi|514486632|gb|KE346360.1|	373172	373192	CCG	20	-	6	GCG
gi|514486632|gb|KE346360.1|	373538	373552	ATC	14	+	4	TCA
gi|514486632|gb|KE346360.1|	373550	373576	ACG	26	-	8	TCG
gi|514486632|gb|KE346360.1|	373571	373585	AAGACG	14	-	2	TCGTCT
gi|514486632|gb|KE346360.1|	373664	373678	ACAGTG	14	-	2	TCACTG
gi|514486632|gb|KE346360.1|	374563	374577	AAAACGC	14	+	2	CGCAAAA
gi|514486632|gb|KE346360.1|	374981	374995	AGGGGGG	14	+	2	GGGAGGG
gi|514486632|gb|KE346360.1|	375411	375435	AGC	24	-	8	TGC
gi|514486632|gb|KE346360.1|	375994	376008	AAAGAGC	14	-	2	TTGCTCT
gi|514486632|gb|KE346360.1|	378433	378452	A	19	+	19	A
gi|514486632|gb|KE346360.1|	378453	378468	A	15	+	15	A
gi|514486632|gb|KE346360.1|	380990	381004	ACC	14	+	4	CAC
gi|514486632|gb|KE346360.1|	381157	381180	AGCGGC	23	-	3	GCCGCT
gi|514486632|gb|KE346360.1|	381469	381492	AAAAAAG	23	+	3	AAGAAAA
gi|514486632|gb|KE346360.1|	381486	381501	A	15	+	15	A
gi|514486632|gb|KE346360.1|	381598	381616	A	18	-	18	T
gi|514486632|gb|KE346360.1|	381796	381814	A	18	+	18	A
gi|514486632|gb|KE346360.1|	382116	382153	AG	37	+	18	GA
gi|514486632|gb|KE346360.1|	382152	382187	AC	35	-	17	GT
gi|514486632|gb|KE346360.1|	382192	382207	ACTC	15	-	3	GAGT
gi|514486632|gb|KE346360.1|	382995	383015	ACAG	20	-	5	TCTG
gi|514486632|gb|KE346360.1|	383098	383113	AGATG	15	-	3	CATCT
gi|514486632|gb|KE346360.1|	385706	385720	AAAAAAC	14	+	2	AACAAAA
gi|514486632|gb|KE346360.1|	385713	385728	AAAAC	15	+	3	AACAA
gi|514486632|gb|KE346360.1|	386218	386234	ACACC	16	-	3	TGGTG
gi|514486632|gb|KE346360.1|	387054	387142	AAG	88	-	29	CTT
gi|514486632|gb|KE346360.1|	387460	387474	A	14	-	14	T
gi|514486632|gb|KE346360.1|	388594	388614	AATG	20	-	5	ATTC
gi|514486632|gb|KE346360.1|	388629	388650	A	21	-	21	T
gi|514486632|gb|KE346360.1|	388784	388798	CCG	14	-	4	GCG
gi|514486632|gb|KE346360.1|	388793	388809	AGCGGC	16	+	2	GCGGCA
gi|514486632|gb|KE346360.1|	388895	388909	AGC	14	+	4	GCA
gi|514486632|gb|KE346360.1|	389050	389066	AGC	16	+	5	GCA
gi|514486632|gb|KE346360.1|	389494	389512	AC	18	-	9	TG
gi|514486632|gb|KE346360.1|	389547	389562	ACACC	15	-	3	TGTGG
gi|514486632|gb|KE346360.1|	389733	389748	A	15	+	15	A
gi|514486632|gb|KE346360.1|	389863	389877	AACAGTC	14	+	2	AACAGTC
gi|514486632|gb|KE346360.1|	389962	389979	A	17	-	17	T
gi|514486632|gb|KE346360.1|	390873	390887	AGC	14	-	4	TGC
gi|514486632|gb|KE346360.1|	392564	392579	AAAAAC	15	-	2	TGTTTT
gi|514486632|gb|KE346360.1|	393130	393144	A	14	-	14	T
gi|514486632|gb|KE346360.1|	393551	393600	A	49	-	49	T
gi|514486632|gb|KE346360.1|	394015	394038	A	23	+	23	A
gi|514486632|gb|KE346360.1|	394793	394814	AG	21	+	10	GA
gi|514486632|gb|KE346360.1|	397280	397296	AAC	16	-	5	TTG
gi|514486632|gb|KE346360.1|	397338	397363	AAG	25	-	8	TCT
gi|514486632|gb|KE346360.1|	398350	398364	AAGGGG	14	-	2	CCCCTT
gi|514486632|gb|KE346360.1|	400378	400393	AGC	15	+	5	CAG
gi|514486632|gb|KE346360.1|	400634	400652	AGC	18	+	6	AGC
gi|514486632|gb|KE346360.1|	401038	401055	AAATC	17	-	3	GATTT
gi|514486632|gb|KE346360.1|	401348	401367	AG	19	+	9	GA
gi|514486632|gb|KE346360.1|	401513	401527	AAAGTC	14	-	2	TTTGAC
gi|514486632|gb|KE346360.1|	401610	401627	AAAAAG	17	+	2	AAAAAG
gi|514486632|gb|KE346360.1|	401839	401876	A	37	-	37	T
gi|514486632|gb|KE346360.1|	402103	402125	AATCTC	22	+	3	TCTCAA
gi|514486632|gb|KE346360.1|	402251	402265	AAAAAC	14	-	2	TTTTTG
gi|514486632|gb|KE346360.1|	402379	402393	A	14	+	14	A
gi|514486632|gb|KE346360.1|	402593	402614	A	21	+	21	A
gi|514486632|gb|KE346360.1|	402979	402993	AAGC	14	-	3	TTGC
gi|514486632|gb|KE346360.1|	404295	404309	ACGGCC	14	-	2	GCCGTG
gi|514486632|gb|KE346360.1|	407995	408032	AGC	37	-	12	CTG
gi|514486632|gb|KE346360.1|	408695	408709	AAGCGG	14	-	2	CTTCCG
gi|514486632|gb|KE346360.1|	410865	410888	ACCCGC	23	+	3	GCACCC
gi|514486632|gb|KE346360.1|	411447	411464	AGC	17	-	5	GCT
gi|514486632|gb|KE346360.1|	418028	418052	AC	24	+	12	AC
gi|514486632|gb|KE346360.1|	421973	421989	ACTGCG	16	-	2	GTCGCA
gi|514486632|gb|KE346360.1|	422035	422066	AGC	31	+	10	CAG
gi|514486632|gb|KE346360.1|	422271	422289	A	18	+	18	A
gi|514486632|gb|KE346360.1|	422298	422312	AAC	14	+	4	AAC
gi|514486632|gb|KE346360.1|	422374	422388	AACTCTT	14	-	2	AAGAGTT
gi|514486632|gb|KE346360.1|	422417	422432	A	15	-	15	T
gi|514486632|gb|KE346360.1|	422550	422571	ACTGCTG	21	-	3	GCAGTCA
gi|514486632|gb|KE346360.1|	422796	422812	AAACGG	16	-	2	TTTCCG
gi|514486632|gb|KE346360.1|	422971	422987	AAATAAT	16	-	2	TTATTTA
gi|514486632|gb|KE346360.1|	423017	423044	A	27	-	27	T
gi|514486632|gb|KE346360.1|	423225	423242	AAATAAT	17	+	2	AAATAAT
gi|514486632|gb|KE346360.1|	423241	423255	AAAAAT	14	+	2	AAAAAT
gi|514486632|gb|KE346360.1|	423819	423834	AAAAAAC	15	-	2	GTTTTTT
gi|514486632|gb|KE346360.1|	424020	424036	AAACAAC	16	-	2	TGTTTGT
gi|514486632|gb|KE346360.1|	424694	424708	AGC	14	-	4	GCT
gi|514486632|gb|KE346360.1|	427105	427119	AAAAGC	14	-	2	CTTTTG
gi|514486632|gb|KE346360.1|	427339	427360	ACC	21	+	7	CCA
gi|514486632|gb|KE346360.1|	427541	427555	AAC	14	+	4	CAA
gi|514486632|gb|KE346360.1|	427667	427683	ACCAGT	16	+	2	CCAGTA
gi|514486632|gb|KE346360.1|	427680	427707	AGC	27	+	9	CAG
gi|514486632|gb|KE346360.1|	433392	433414	AAAAACG	22	-	3	TTTCGTT
gi|514486632|gb|KE346360.1|	433411	433425	AAAAAAC	14	-	2	TTTGTTT
gi|514486632|gb|KE346360.1|	433827	433844	AAAC	17	+	4	ACAA
gi|514486632|gb|KE346360.1|	437721	437739	AAAG	18	+	4	AAGA
gi|514486632|gb|KE346360.1|	439934	439950	AACCATC	16	+	2	CAACCAT
gi|514486632|gb|KE346360.1|	441370	441385	AGG	15	+	5	AGG
gi|514486632|gb|KE346360.1|	441509	441523	ACC	14	+	4	CAC
gi|514486632|gb|KE346360.1|	441575	441590	AAAAAC	15	+	2	AACAAA
gi|514486632|gb|KE346360.1|	441604	441627	CCG	23	+	7	CCG
gi|514486632|gb|KE346360.1|	443611	443625	AGC	14	+	4	CAG
gi|514486632|gb|KE346360.1|	444597	444621	A	24	-	24	T
gi|514486632|gb|KE346360.1|	444852	444868	A	16	-	16	T
gi|514486632|gb|KE346360.1|	445001	445015	ATC	14	+	4	CAT
gi|514486632|gb|KE346360.1|	445351	445372	AAGAGG	21	+	3	GAGGAA
gi|514486632|gb|KE346360.1|	445367	445384	AAAGAG	17	+	2	AAGAGA
gi|514486632|gb|KE346360.1|	447394	447409	AAAAAAC	15	-	2	TTTGTTT
gi|514486632|gb|KE346360.1|	448333	448348	AAAC	15	-	3	TTTG
gi|514486632|gb|KE346360.1|	448988	449002	AACGATC	14	-	2	TTGATCG
gi|514486632|gb|KE346360.1|	449827	449947	AG	120	-	60	CT
gi|514486632|gb|KE346360.1|	450476	450647	AC	171	-	85	TG
gi|514486632|gb|KE346360.1|	450642	450665	ACACAT	23	-	3	TGTGTA
gi|514486632|gb|KE346360.1|	450660	450679	AC	19	-	9	TG
gi|514486632|gb|KE346360.1|	452381	452400	A	19	-	19	T
gi|514486632|gb|KE346360.1|	453491	453508	AAC	17	-	5	GTT
gi|514486632|gb|KE346360.1|	454211	454225	AAGCGC	14	-	2	CTTGCG
gi|514486632|gb|KE346360.1|	454455	454471	AGC	16	+	5	CAG
gi|514486632|gb|KE346360.1|	454572	454586	ACTGCTC	14	-	2	GAGCAGT
gi|514486632|gb|KE346360.1|	454663	454677	AC	14	+	7	CA
gi|514486632|gb|KE346360.1|	455102	455119	ATCCC	17	+	3	ATCCC
gi|514486632|gb|KE346360.1|	455365	455380	AAAAAG	15	+	2	AAGAAA
gi|514486632|gb|KE346360.1|	456173	456193	ACCTCC	20	+	3	CCTCCA
gi|514486632|gb|KE346360.1|	457536	457601	AAGG	65	+	16	AAGG
gi|514486632|gb|KE346360.1|	459234	459254	AAAAACC	20	+	2	CAAAAAC
gi|514486632|gb|KE346360.1|	459249	459283	A	34	+	34	A
gi|514486632|gb|KE346360.1|	459302	459316	AATTC	14	+	2	CAATT
gi|514486632|gb|KE346360.1|	462132	462147	AAAAAG	15	-	2	TTTTTC
gi|514486632|gb|KE346360.1|	462839	462854	AAACTGG	15	+	2	GGAAACT
gi|514486632|gb|KE346360.1|	462847	462862	AAACTG	15	+	2	GAAACT
gi|514486632|gb|KE346360.1|	462913	462934	AG	21	+	10	AG
gi|514486632|gb|KE346360.1|	464566	464581	AACGAC	15	+	2	ACAACG
gi|514486632|gb|KE346360.1|	467035	467051	AAAAAAT	16	+	2	AATAAAA
gi|514486632|gb|KE346360.1|	467294	467318	A	24	-	24	T
gi|514486632|gb|KE346360.1|	467854	467868	AGGGGG	14	+	2	GGGAGG
gi|514486632|gb|KE346360.1|	467903	467917	AGGGGGG	14	+	2	AGGGGGG
gi|514486632|gb|KE346360.1|	468036	468053	AGCCG	17	-	3	GCTCG
gi|514486632|gb|KE346360.1|	471067	471084	AGCTCC	17	+	2	GCTCCA
gi|514486632|gb|KE346360.1|	475317	475334	AGCCG	17	+	3	GCCGA
gi|514486632|gb|KE346360.1|	475604	475618	AGGGGGG	14	-	2	CCCCCCT
gi|514486632|gb|KE346360.1|	476096	476113	A	17	-	17	T
gi|514486632|gb|KE346360.1|	476343	476360	AAATCAT	17	-	2	TTTATGA
gi|514486632|gb|KE346360.1|	476379	476394	AAAC	15	-	3	TTTG
gi|514486632|gb|KE346360.1|	476804	476825	A	21	+	21	A
gi|514486632|gb|KE346360.1|	477020	477034	AAAAT	14	-	2	TTTTA
gi|514486632|gb|KE346360.1|	477049	477074	AAAAT	25	-	5	ATTTT
gi|514486632|gb|KE346360.1|	479185	479199	AGC	14	+	4	CAG
gi|514486632|gb|KE346360.1|	479194	479211	ACCAGC	17	+	2	CAGCAC
gi|514486632|gb|KE346360.1|	479256	479271	AATTAC	15	+	2	ACAATT
gi|514486632|gb|KE346360.1|	479330	479346	AGC	16	+	5	AGC
gi|514486632|gb|KE346360.1|	479344	479363	AAC	19	+	6	CAA
gi|514486632|gb|KE346360.1|	479364	479385	AACATC	21	+	3	ACATCA
gi|514486632|gb|KE346360.1|	480422	480454	AAAC	32	-	8	GTTT
gi|514486632|gb|KE346360.1|	480464	480593	AAC	129	-	43	GTT
gi|514486632|gb|KE346360.1|	480681	480706	AAAC	25	-	6	TGTT
gi|514486632|gb|KE346360.1|	482547	482570	A	23	+	23	A
gi|514486632|gb|KE346360.1|	483567	483595	AGC	28	+	9	GCA
gi|514486632|gb|KE346360.1|	485046	485069	A	23	-	23	T
gi|514486632|gb|KE346360.1|	488134	488152	AGCATG	18	-	3	CATGCT
gi|514486632|gb|KE346360.1|	488445	488460	AGC	15	+	5	CAG
gi|514486632|gb|KE346360.1|	488815	488830	AAAACG	15	-	2	CGTTTT
gi|514486632|gb|KE346360.1|	488880	488895	AACCACC	15	+	2	CAACCAC
gi|514486632|gb|KE346360.1|	489044	489058	AAACCCC	14	+	2	CAAACCC
gi|514486632|gb|KE346360.1|	490981	491001	ACCTCCC	20	-	2	GGAGGTG
gi|514486632|gb|KE346360.1|	491047	491111	AAAC	64	-	16	GTTT
gi|514486632|gb|KE346360.1|	491104	491122	AAAAC	18	-	3	TTTGT
gi|514486632|gb|KE346360.1|	491443	491457	AAGCAGC	14	-	2	CTTGCTG
gi|514486632|gb|KE346360.1|	492238	492254	AAC	16	-	5	TTG
gi|514486632|gb|KE346360.1|	493997	494011	AAATC	14	+	2	AATCA
gi|514486632|gb|KE346360.1|	495121	495138	AAC	17	+	5	AAC
gi|514486632|gb|KE346360.1|	495478	495492	ACTCGC	14	+	2	TCGCAC
gi|514486632|gb|KE346360.1|	498068	498083	AAATCAC	15	-	2	GATTTGT
gi|514486632|gb|KE346360.1|	499398	499581	AG	183	-	91	TC
gi|514486632|gb|KE346360.1|	499582	499611	AG	29	-	14	TC
gi|514486632|gb|KE346360.1|	500472	500490	AGCAGG	18	-	3	TCCTGC
gi|514486632|gb|KE346360.1|	501525	501540	ACACAG	15	-	2	GTGTCT
gi|514486632|gb|KE346360.1|	503139	503155	AGG	16	+	5	AGG
gi|514486632|gb|KE346360.1|	503315	503329	AGC	14	+	4	CAG
gi|514486632|gb|KE346360.1|	503590	503604	AACATTC	14	-	2	AATGTTG
gi|514486632|gb|KE346360.1|	503958	503974	AGCGC	16	+	3	AGCGC
gi|514486632|gb|KE346360.1|	504450	504489	ACT	39	+	13	ACT
gi|514486632|gb|KE346360.1|	504989	505003	AGCCGCG	14	-	2	GGCTCGC
gi|514486632|gb|KE346360.1|	506495	506513	AAAAC	18	-	3	TTTTG
gi|514486632|gb|KE346360.1|	506712	506726	AACTGCC	14	-	2	CAGTTGG
gi|514486632|gb|KE346360.1|	507610	507624	AAAAACC	14	+	2	CAAAAAC
gi|514486632|gb|KE346360.1|	508110	508134	A	24	-	24	T
gi|514486632|gb|KE346360.1|	508830	508844	AGC	14	+	4	CAG
gi|514486632|gb|KE346360.1|	509048	509072	A	24	-	24	T
gi|514486632|gb|KE346360.1|	510114	510130	AAGTCAG	16	-	2	CTTCTGA
gi|514486632|gb|KE346360.1|	513142	513161	AAAAAAG	19	-	2	TTTTTTC
gi|514486632|gb|KE346360.1|	513436	513450	AAGCGAG	14	-	2	CTTCTCG
gi|514486632|gb|KE346360.1|	517350	517364	AAAGTTC	14	-	2	TTTGAAC
gi|514486632|gb|KE346360.1|	517418	517433	ATC	15	+	5	CAT
gi|514486632|gb|KE346360.1|	517987	518022	A	35	-	35	T
gi|514486632|gb|KE346360.1|	518563	518578	AAATC	15	-	3	GATTT
gi|514486632|gb|KE346360.1|	519945	519959	AAAAATG	14	-	2	TCATTTT
gi|514486632|gb|KE346360.1|	521267	521283	AAC	16	+	5	ACA
gi|514486632|gb|KE346360.1|	521303	521318	AAC	15	+	5	ACA
gi|514486632|gb|KE346360.1|	521577	521596	AAG	19	-	6	TCT
gi|514486632|gb|KE346360.1|	523490	523506	AAAAGTC	16	-	2	TGACTTT
gi|514486632|gb|KE346360.1|	523544	523558	ACG	14	-	4	GTC
gi|514486632|gb|KE346360.1|	523590	523605	A	15	-	15	T
gi|514486632|gb|KE346360.1|	523973	523992	A	19	-	19	T
gi|514486632|gb|KE346360.1|	524071	524086	AAAATCC	15	-	2	GGATTTT
gi|514486632|gb|KE346360.1|	524209	524232	A	23	-	23	T
gi|514486632|gb|KE346360.1|	526140	526155	AAGGCC	15	+	2	GCCAAG
gi|514486632|gb|KE346360.1|	527401	527416	AAAGCTC	15	+	2	CAAAGCT
gi|514486632|gb|KE346360.1|	530444	530458	A	14	-	14	T
gi|514486632|gb|KE346360.1|	530455	530478	AAAC	23	-	5	TTTG
gi|514486632|gb|KE346360.1|	531583	531602	A	19	-	19	T
gi|514486632|gb|KE346360.1|	531685	531714	ACATCG	29	+	4	TCGACA
gi|514486632|gb|KE346360.1|	533501	533515	AC	14	-	7	GT
gi|514486632|gb|KE346360.1|	534715	534729	AAACGAC	14	+	2	CGACAAA
gi|514486632|gb|KE346360.1|	534778	534793	AAC	15	+	5	ACA
gi|514486632|gb|KE346360.1|	534989	535003	AAAAAC	14	+	2	AAAACA
gi|514486632|gb|KE346360.1|	535948	535967	AC	19	-	9	GT
gi|514486632|gb|KE346360.1|	536744	536770	AGC	26	-	8	GCT
gi|514486632|gb|KE346360.1|	537346	537362	ACAGGAG	16	-	2	TCCTGTC
gi|514486632|gb|KE346360.1|	537522	537537	A	15	-	15	T
gi|514486632|gb|KE346360.1|	537648	537664	ATCATG	16	+	2	ATCATG
gi|514486632|gb|KE346360.1|	537729	537743	AAAAAAT	14	-	2	TTTTATT
gi|514486632|gb|KE346360.1|	537985	538002	A	17	-	17	T
gi|514486632|gb|KE346360.1|	538430	538444	AAATAAT	14	-	2	TATTATT
gi|514486632|gb|KE346360.1|	538643	538660	A	17	-	17	T
gi|514486632|gb|KE346360.1|	538656	538670	AAAAC	14	-	2	TTTTG
gi|514486632|gb|KE346360.1|	540641	540659	AAAAC	18	+	3	AAAAC
gi|514486632|gb|KE346360.1|	540652	540667	AAAC	15	+	3	AAAC
gi|514486632|gb|KE346360.1|	541187	541201	AAC	14	+	4	AAC
gi|514486632|gb|KE346360.1|	541374	541399	AAC	25	+	8	ACA
gi|514486632|gb|KE346360.1|	542659	542675	A	16	+	16	A
gi|514486632|gb|KE346360.1|	542837	542851	AGGATG	14	-	2	TCCTCA
gi|514486632|gb|KE346360.1|	543319	543340	AAAACC	21	-	3	TTTTGG
gi|514486632|gb|KE346360.1|	543459	543473	AGC	14	+	4	AGC
gi|514486632|gb|KE346360.1|	543630	543644	AGATGC	14	+	2	AGATGC
gi|514486632|gb|KE346360.1|	543915	543930	A	15	+	15	A
gi|514486632|gb|KE346360.1|	544298	544313	AAC	15	-	5	GTT
gi|514486632|gb|KE346360.1|	544320	544335	AAACAAC	15	-	2	TTTGTTG
gi|514486632|gb|KE346360.1|	544658	544673	AC	15	-	7	GT
gi|514486632|gb|KE346360.1|	544686	544700	ACTC	14	-	3	GAGT
gi|514486632|gb|KE346360.1|	544756	544778	A	22	+	22	A
gi|514486632|gb|KE346360.1|	547214	547228	AACAACC	14	-	2	GTTGTTG
gi|514486632|gb|KE346360.1|	550493	550570	AGG	77	-	25	CTC
gi|514486632|gb|KE346360.1|	551184	551198	ATCGCC	14	+	2	TCGCCA
gi|514486632|gb|KE346360.1|	551661	551676	ACGGCG	15	+	2	GACGGC
gi|514486632|gb|KE346360.1|	551915	551932	AACGAC	17	-	2	GTCGTT
gi|514486632|gb|KE346360.1|	552170	552189	ACG	19	+	6	CGA
gi|514486632|gb|KE346360.1|	552281	552301	ACG	20	+	6	CGA
gi|514486632|gb|KE346360.1|	552582	552596	ACTGAG	14	-	2	CTCAGT
gi|514486632|gb|KE346360.1|	552901	552919	ACG	18	-	6	GTC
gi|514486632|gb|KE346360.1|	554192	554230	AAC	38	+	12	AAC
gi|514486632|gb|KE346360.1|	554856	554871	AAAAAAC	15	+	2	AAACAAA
gi|514486632|gb|KE346360.1|	557298	557313	AGG	15	-	5	CTC
gi|514486632|gb|KE346360.1|	557333	557347	AAGCTG	14	-	2	GCTTCA
gi|514486632|gb|KE346360.1|	557817	557835	AG	18	-	9	TC
gi|514486632|gb|KE346360.1|	557977	557999	AAC	22	+	7	CAA
gi|514486632|gb|KE346360.1|	557995	558010	AACGTC	15	+	2	CAACGT
gi|514486632|gb|KE346360.1|	558105	558135	A	30	-	30	T
gi|514486632|gb|KE346360.1|	558314	558328	A	14	-	14	T
gi|514486632|gb|KE346360.1|	558328	558345	AAAACGG	17	-	2	CGTTTTC
gi|514486632|gb|KE346360.1|	559313	559327	ACTG	14	+	3	CTGA
gi|514486632|gb|KE346360.1|	560289	560304	AAAAC	15	+	3	CAAAA
gi|514486632|gb|KE346360.1|	560306	560321	AAAAC	15	+	3	CAAAA
gi|514486632|gb|KE346360.1|	560314	560331	AAAAAC	17	+	2	AACAAA
gi|514486632|gb|KE346360.1|	560654	560672	ACACGG	18	-	3	TGTCCG
gi|514486632|gb|KE346360.1|	562511	562525	AAAAGAC	14	+	2	ACAAAAG
gi|514486632|gb|KE346360.1|	562617	562671	AC	54	-	27	TG
gi|514486632|gb|KE346360.1|	562985	563005	A	20	-	20	T
gi|514486632|gb|KE346360.1|	563360	563375	ACTC	15	+	3	CTCA
gi|514486632|gb|KE346360.1|	563539	563553	ACG	14	+	4	GAC
gi|514486632|gb|KE346360.1|	563649	563665	A	16	+	16	A
gi|514486632|gb|KE346360.1|	563666	563682	A	16	+	16	A
gi|514486632|gb|KE346360.1|	565806	565823	AAAAAC	17	+	2	AAAAAC
gi|514486632|gb|KE346360.1|	566595	566609	AACAACG	14	-	2	TTGTTCG
gi|514486632|gb|KE346360.1|	567512	567527	AAGAG	15	+	3	AGAGA
gi|514486632|gb|KE346360.1|	567636	567658	ACTCC	22	+	4	CACTC
gi|514486632|gb|KE346360.1|	567677	567691	ACACGT	14	-	2	GTACGT
gi|514486632|gb|KE346360.1|	567835	567850	AGC	15	-	5	TGC
gi|514486632|gb|KE346360.1|	568007	568022	AACAGC	15	+	2	GCAACA
gi|514486632|gb|KE346360.1|	568062	568077	AGC	15	+	5	CAG
gi|514486632|gb|KE346360.1|	568198	568217	ACCAGC	19	+	3	ACCAGC
gi|514486632|gb|KE346360.1|	568411	568433	AGC	22	-	7	CTG
gi|514486632|gb|KE346360.1|	569058	569075	AGCGAT	17	-	2	ATCGCT
gi|514486632|gb|KE346360.1|	570763	570782	A	19	+	19	A
gi|514486632|gb|KE346360.1|	572417	572431	AAGGCG	14	-	2	CGCCTT
gi|514486632|gb|KE346360.1|	573276	573314	AAC	38	-	12	TTG
gi|514486632|gb|KE346360.1|	573309	573323	AAAAC	14	-	2	TTGTT
gi|514486632|gb|KE346360.1|	573594	573619	AAG	25	-	8	CTT
gi|514486632|gb|KE346360.1|	573933	573948	A	15	-	15	T
gi|514486632|gb|KE346360.1|	575280	575303	A	23	-	23	T
gi|514486632|gb|KE346360.1|	576856	576873	A	17	-	17	T
gi|514486632|gb|KE346360.1|	577291	577306	AGGGGG	15	+	2	GGGAGG
gi|514486632|gb|KE346360.1|	577412	577434	A	22	+	22	A
gi|514486632|gb|KE346360.1|	577478	577493	AAAAG	15	-	3	TTTTC
gi|514486632|gb|KE346360.1|	577644	577661	A	17	-	17	T
gi|514486632|gb|KE346360.1|	578018	578036	A	18	+	18	A
gi|514486632|gb|KE346360.1|	578376	578390	ACCAGC	14	-	2	TGCTGG
gi|514486632|gb|KE346360.1|	578503	578520	A	17	+	17	A
gi|514486632|gb|KE346360.1|	579039	579053	AAAAC	14	-	2	TTTTG
gi|514486632|gb|KE346360.1|	579046	579060	AAAAAC	14	-	2	TTGTTT
gi|514486632|gb|KE346360.1|	579174	579193	AC	19	+	9	CA
gi|514486632|gb|KE346360.1|	579656	579673	AG	17	+	8	GA
gi|514486632|gb|KE346360.1|	580970	580984	ACGAT	14	+	2	TACGA
gi|514486632|gb|KE346360.1|	581658	581674	ATCGCC	16	-	2	GGCGAT
gi|514486632|gb|KE346360.1|	581845	581870	AAAC	25	-	6	GTTT
gi|514486632|gb|KE346360.1|	582350	582379	AGCCCG	29	-	4	GGCTCG
gi|514486632|gb|KE346360.1|	582410	582424	AGG	14	+	4	GAG
gi|514486632|gb|KE346360.1|	582667	582682	AAAAAAC	15	-	2	TTTGTTT
gi|514486632|gb|KE346360.1|	583773	583787	AAC	14	-	4	TTG
gi|514486632|gb|KE346360.1|	583846	583865	A	19	-	19	T
gi|514486632|gb|KE346360.1|	584086	584107	A	21	-	21	T
gi|514486632|gb|KE346360.1|	584140	584162	A	22	-	22	T
gi|514486632|gb|KE346360.1|	584180	584206	A	26	-	26	T
gi|514486632|gb|KE346360.1|	584566	584583	AGC	17	-	5	CTG
gi|514486632|gb|KE346360.1|	584615	584635	ACCGCC	20	-	3	CGGTGG
gi|514486632|gb|KE346360.1|	584630	584647	AGCGCC	17	-	2	TGGCGC
gi|514486632|gb|KE346360.1|	584711	584726	ACAGTCC	15	+	2	GTCCACA
gi|514486632|gb|KE346360.1|	586651	586667	AGC	16	-	5	CTG
gi|514486632|gb|KE346360.1|	587088	587108	AAAAC	20	+	4	AAAAC
gi|514486632|gb|KE346360.1|	587417	587431	ACTCGG	14	-	2	TCCGAG
gi|514486632|gb|KE346360.1|	588741	588758	AGC	17	-	5	GCT
gi|514486632|gb|KE346360.1|	588841	588857	ATCGGC	16	+	2	CATCGG
gi|514486632|gb|KE346360.1|	588968	588982	AATGTC	14	+	2	GTCAAT
gi|514486632|gb|KE346360.1|	589682	589707	AAC	25	-	8	GTT
gi|514486632|gb|KE346360.1|	590274	590290	ACG	16	-	5	GTC
gi|514486632|gb|KE346360.1|	590329	590343	AAAAAAC	14	-	2	TGTTTTT
gi|514486632|gb|KE346360.1|	590547	590564	AAT	17	+	5	AAT
gi|514486632|gb|KE346360.1|	590559	590573	AAAAAAT	14	+	2	AATAAAA
gi|514486632|gb|KE346360.1|	592217	592240	A	23	-	23	T
gi|514486632|gb|KE346360.1|	592355	592377	ATC	22	+	7	ATC
gi|514486632|gb|KE346360.1|	592423	592437	AAAAAG	14	-	2	TTCTTT
gi|514486632|gb|KE346360.1|	592456	592485	AAAAT	29	-	5	TTTTA
gi|514486632|gb|KE346360.1|	592652	592667	A	15	+	15	A
gi|514486632|gb|KE346360.1|	592825	592840	A	15	+	15	A
gi|514486632|gb|KE346360.1|	592914	592941	AGC	27	+	9	GCA
gi|514486632|gb|KE346360.1|	593093	593108	AAGAAGC	15	-	2	TGCTTCT
gi|514486632|gb|KE346360.1|	593183	593197	A	14	-	14	T
gi|514486632|gb|KE346360.1|	593737	593756	A	19	-	19	T
gi|514486632|gb|KE346360.1|	593898	593938	A	40	-	40	T
gi|514486632|gb|KE346360.1|	594159	594179	A	20	+	20	A
gi|514486632|gb|KE346360.1|	596032	596053	AAAACAG	21	-	3	GTTTTCT
gi|514486632|gb|KE346360.1|	596261	596281	A	20	-	20	T
gi|514486632|gb|KE346360.1|	596870	596891	AAAC	21	+	5	ACAA
gi|514486632|gb|KE346360.1|	598537	598551	ACATGG	14	+	2	TGGACA
gi|514486632|gb|KE346360.1|	599993	600016	A	23	+	23	A
gi|514486632|gb|KE346360.1|	600131	600147	AAACAAC	16	-	2	GTTTGTT
gi|514486632|gb|KE346360.1|	600985	601006	A	21	+	21	A
gi|514486632|gb|KE346360.1|	601019	601037	A	18	+	18	A
gi|514486632|gb|KE346360.1|	603337	603354	A	17	+	17	A
gi|514486632|gb|KE346360.1|	603480	603494	A	14	-	14	T
gi|514486632|gb|KE346360.1|	603496	603513	A	17	-	17	T
gi|514486632|gb|KE346360.1|	604108	604136	A	28	-	28	T
gi|514486632|gb|KE346360.1|	604501	604516	ACGAGG	15	+	2	GAGGAC
gi|514486632|gb|KE346360.1|	606974	606988	AAC	14	-	4	TGT
gi|514486632|gb|KE346360.1|	607624	607639	AAAAAC	15	+	2	AAAACA
gi|514486632|gb|KE346360.1|	607994	608009	AAAACAG	15	+	2	AACAGAA
gi|514486632|gb|KE346360.1|	608200	608217	AGC	17	-	5	CTG
gi|514486632|gb|KE346360.1|	608977	608995	ACG	18	-	6	GTC
gi|514486632|gb|KE346360.1|	611489	611506	ACG	17	+	5	GAC
gi|514486632|gb|KE346360.1|	611504	611521	ATC	17	-	5	GAT
gi|514486632|gb|KE346360.1|	613019	613057	AAAAC	38	-	7	TTTTG
gi|514486632|gb|KE346360.1|	613218	613236	AAG	18	-	6	TTC
gi|514486632|gb|KE346360.1|	613345	613368	AG	23	-	11	TC
gi|514486632|gb|KE346360.1|	613472	613498	A	26	-	26	T
gi|514486632|gb|KE346360.1|	613662	613682	A	20	-	20	T
gi|514486632|gb|KE346360.1|	613762	613785	AATG	23	-	5	ATTC
gi|514486632|gb|KE346360.1|	614693	614710	ACGGGG	17	-	2	CCCCGT
gi|514486632|gb|KE346360.1|	615016	615032	A	16	-	16	T
gi|514486632|gb|KE346360.1|	615172	615186	AAAAAC	14	-	2	TTGTTT
gi|514486632|gb|KE346360.1|	615519	615536	A	17	-	17	T
gi|514486632|gb|KE346360.1|	615533	615548	AAAC	15	-	3	TTTG
gi|514486632|gb|KE346360.1|	616332	616346	AAACCAC	14	+	2	CACAAAC
gi|514486632|gb|KE346360.1|	616460	616476	AAAATGG	16	-	2	TTCCATT
gi|514486632|gb|KE346360.1|	616544	616567	A	23	-	23	T
gi|514486632|gb|KE346360.1|	617201	617217	AGGGGG	16	-	2	CCCCTC
gi|514486632|gb|KE346360.1|	617309	617331	A	22	-	22	T
gi|514486632|gb|KE346360.1|	617367	617387	A	20	-	20	T
gi|514486632|gb|KE346360.1|	617559	617577	A	18	-	18	T
gi|514486632|gb|KE346360.1|	617641	617663	A	22	-	22	T
gi|514486632|gb|KE346360.1|	618017	618035	AAC	18	+	6	CAA
gi|514486632|gb|KE346360.1|	618174	618190	ACCAGC	16	+	2	CAGCAC
gi|514486632|gb|KE346360.1|	618651	618668	ACCAGC	17	+	2	CAGCAC
gi|514486632|gb|KE346360.1|	620901	620917	AACAAGC	16	-	2	TTGTTGC
gi|514486632|gb|KE346360.1|	621074	621089	ACGGGCG	15	-	2	GTCGCCC
gi|514486632|gb|KE346360.1|	622521	622535	ACGCCC	14	+	2	GCCCAC
gi|514486632|gb|KE346360.1|	624150	624167	AAAAAT	17	+	2	AAAAAT
gi|514486632|gb|KE346360.1|	626333	626354	A	21	+	21	A
gi|514486632|gb|KE346360.1|	626795	626813	A	18	-	18	T
gi|514486632|gb|KE346360.1|	627457	627477	ACGGCG	20	+	3	CGGCGA
gi|514486632|gb|KE346360.1|	629510	629524	AAGGCC	14	+	2	GCCAAG
gi|514486632|gb|KE346360.1|	631356	631378	AAAG	22	-	5	TTTC
gi|514486632|gb|KE346360.1|	631672	631690	ACGGAG	18	+	3	GAGACG
gi|514486632|gb|KE346360.1|	632100	632131	AG	31	+	15	AG
gi|514486632|gb|KE346360.1|	632132	632187	AG	55	+	27	AG
gi|514486632|gb|KE346360.1|	634541	634556	AATGGT	15	+	2	ATGGTA
gi|514486632|gb|KE346360.1|	635218	635240	A	22	+	22	A
gi|514486632|gb|KE346360.1|	635652	635666	AG	14	-	7	TC
gi|514486632|gb|KE346360.1|	640215	640232	AACCGC	17	-	2	TTGCGG
gi|514486632|gb|KE346360.1|	640420	640453	AGAGCC	33	+	5	CCAGAG
gi|514486632|gb|KE346360.1|	640581	640595	AACTGC	14	+	2	ACTGCA
gi|514486632|gb|KE346360.1|	641727	641755	ATC	28	-	9	GAT
gi|514486632|gb|KE346360.1|	642118	642134	ACCCCC	16	-	2	GGGGGT
gi|514486632|gb|KE346360.1|	642220	642243	ACTGAG	23	-	3	CTCAGT
gi|514486632|gb|KE346360.1|	642359	642374	AG	15	-	7	CT
gi|514486632|gb|KE346360.1|	642478	642492	AGCAGGG	14	-	2	CTGCTCC
gi|514486632|gb|KE346360.1|	642533	642547	AGC	14	-	4	CTG
gi|514486632|gb|KE346360.1|	642784	642798	AGGGGG	14	-	2	CCCCCT
gi|514486632|gb|KE346360.1|	645897	645913	ACCTGC	16	+	2	CTGCAC
gi|514486632|gb|KE346360.1|	645963	645986	AACTGC	23	+	3	CTGCAA
gi|514486632|gb|KE346360.1|	646353	646369	ACCTGC	16	+	2	CTGCAC
gi|514486632|gb|KE346360.1|	646382	646399	ACCTGC	17	+	2	CCTGCA
gi|514486632|gb|KE346360.1|	646400	646430	ACCTGC	30	+	5	CCTGCA
gi|514486632|gb|KE346360.1|	646764	646780	ACCTGC	16	+	2	CTGCAC
gi|514486632|gb|KE346360.1|	646793	646810	ACCTGC	17	+	2	CCTGCA
gi|514486632|gb|KE346360.1|	646818	646835	AACTGC	17	+	2	CTGCAA
gi|514486632|gb|KE346360.1|	646830	646864	ACCTGC	34	+	5	CTGCAC
gi|514486632|gb|KE346360.1|	647856	647881	ACC	25	+	8	CCA
gi|514486632|gb|KE346360.1|	651996	652015	AGC	19	+	6	GCA
gi|514486632|gb|KE346360.1|	652822	652837	AAGAT	15	+	3	TAAGA
gi|514486632|gb|KE346360.1|	653028	653042	AGCGGC	14	+	2	GCGGCA
gi|514486632|gb|KE346360.1|	653049	653063	AGC	14	+	4	GCA
gi|514486632|gb|KE346360.1|	653067	653086	AGC	19	+	6	GCA
gi|514486632|gb|KE346360.1|	653130	653147	AATGGG	17	-	2	CCATTC
gi|514486632|gb|KE346360.1|	653407	653421	ACCAGC	14	+	2	CACCAG
gi|514486632|gb|KE346360.1|	653547	653567	AACATC	20	-	3	TGTTGA
gi|514486632|gb|KE346360.1|	653832	653846	AACCGGC	14	-	2	GTTGCCG
gi|514486632|gb|KE346360.1|	654249	654263	AAC	14	+	4	CAA
gi|514486632|gb|KE346360.1|	654270	654284	AACATC	14	+	2	CATCAA
gi|514486632|gb|KE346360.1|	654279	654293	AACAGC	14	+	2	CAACAG
gi|514486632|gb|KE346360.1|	654422	654438	ACACAT	16	-	2	GTGTAT
gi|514486632|gb|KE346360.1|	654433	654449	AC	16	-	8	TG
gi|514486632|gb|KE346360.1|	657117	657132	ACCGCC	15	+	2	CACCGC
gi|514486632|gb|KE346360.1|	657157	657174	ACAGCC	17	+	2	GCCACA
gi|514486632|gb|KE346360.1|	657206	657237	AAC	31	+	10	ACA
gi|514486632|gb|KE346360.1|	659220	659234	AAC	14	+	4	AAC
gi|514486632|gb|KE346360.1|	659229	659247	AAAC	18	+	4	AACA
gi|514486632|gb|KE346360.1|	660680	660696	AAC	16	+	5	ACA
gi|514486632|gb|KE346360.1|	661811	661830	AAAAC	19	+	3	AAAAC
gi|514486632|gb|KE346360.1|	662584	662598	AAG	14	-	4	TTC
gi|514486632|gb|KE346360.1|	663714	663728	AACAACG	14	+	2	AACAACG
gi|514486632|gb|KE346360.1|	663737	663753	ACCCC	16	-	3	GGGGT
gi|514486632|gb|KE346360.1|	663804	663819	AAAC	15	+	3	AAAC
gi|514486632|gb|KE346360.1|	664316	664331	AC	15	+	7	AC
gi|514486632|gb|KE346360.1|	664814	664834	A	20	-	20	T
gi|514486632|gb|KE346360.1|	665177	665194	AAG	17	+	5	AAG
gi|514486632|gb|KE346360.1|	665224	665239	AATG	15	-	3	TCAT
gi|514486632|gb|KE346360.1|	665253	665270	AAGC	17	+	4	AGCA
gi|514486632|gb|KE346360.1|	665686	665709	AATCTG	23	-	3	TCAGAT
gi|514486632|gb|KE346360.1|	665702	665716	AATTCAG	14	+	2	ATTCAGA
gi|514486632|gb|KE346360.1|	667170	667187	AC	17	+	8	AC
gi|514486632|gb|KE346360.1|	669163	669180	AAG	17	+	5	GAA
gi|514486632|gb|KE346360.1|	669501	669517	AAAAAC	16	+	2	AAAACA
gi|514486632|gb|KE346360.1|	670552	670590	ACCAGG	38	+	6	ACCAGG
gi|514486632|gb|KE346360.1|	670681	670695	AAATGC	14	-	2	TTTGCA
gi|514486632|gb|KE346360.1|	671780	671796	AAAG	16	+	4	AGAA
gi|514486632|gb|KE346360.1|	672077	672097	AGATGG	20	-	3	CATCTC
gi|514486632|gb|KE346360.1|	672570	672586	AAC	16	+	5	CAA
gi|514486632|gb|KE346360.1|	672581	672598	AACCAC	17	+	2	ACAACC
gi|514486632|gb|KE346360.1|	672791	672819	ACCAGC	28	+	4	CACCAG
gi|514486632|gb|KE346360.1|	673247	673263	CCG	16	+	5	GCC
gi|514486632|gb|KE346360.1|	673787	673804	AACAGC	17	+	2	CAGCAA
gi|514486632|gb|KE346360.1|	673928	673945	AGC	17	+	5	CAG
gi|514486632|gb|KE346360.1|	673957	673971	ACC	14	+	4	ACC
gi|514486632|gb|KE346360.1|	674000	674017	AACAGC	17	+	2	CAACAG
gi|514486632|gb|KE346360.1|	675311	675325	AAAAG	14	+	2	AAAAG
gi|514486632|gb|KE346360.1|	675428	675446	AAC	18	+	6	AAC
gi|514486632|gb|KE346360.1|	675465	675480	A	15	+	15	A
gi|514486632|gb|KE346360.1|	677187	677207	AACGC	20	+	4	ACGCA
gi|514486632|gb|KE346360.1|	677206	677222	AAAC	16	+	4	ACAA
gi|514486632|gb|KE346360.1|	677545	677564	AGGAGGG	19	-	2	CCTCCCT
gi|514486632|gb|KE346360.1|	677835	677855	A	20	+	20	A
gi|514486632|gb|KE346360.1|	678067	678089	A	22	+	22	A
gi|514486632|gb|KE346360.1|	678148	678162	AAAAAT	14	+	2	AAAAAT
gi|514486632|gb|KE346360.1|	678301	678320	ATC	19	+	6	CAT
gi|514486632|gb|KE346360.1|	678334	678360	A	26	+	26	A
gi|514486632|gb|KE346360.1|	678757	678775	AGC	18	-	6	GCT
gi|514486632|gb|KE346360.1|	678836	678860	AG	24	+	12	AG
gi|514486632|gb|KE346360.1|	679438	679455	A	17	+	17	A
gi|514486632|gb|KE346360.1|	679665	679683	AAAAAAC	18	+	2	AAAAACA
gi|514486632|gb|KE346360.1|	680466	680489	AAAAAC	23	+	3	AAAAAC
gi|514486632|gb|KE346360.1|	681478	681496	AG	18	+	9	GA
gi|514486632|gb|KE346360.1|	682603	682619	AGAGAT	16	+	2	GAGATA
gi|514486632|gb|KE346360.1|	682725	682739	AATGAG	14	+	2	ATGAGA
gi|514486632|gb|KE346360.1|	684326	684341	AG	15	+	7	AG
gi|514486632|gb|KE346360.1|	684491	684509	A	18	+	18	A
gi|514486632|gb|KE346360.1|	684848	684872	AACG	24	+	6	ACGA
gi|514486632|gb|KE346360.1|	685578	685594	A	16	-	16	T
gi|514486632|gb|KE346360.1|	685796	685811	A	15	-	15	T
gi|514486632|gb|KE346360.1|	687636	687653	AGC	17	+	5	GCA
gi|514486632|gb|KE346360.1|	688538	688552	AAAAATG	14	-	2	TCATTTT
gi|514486632|gb|KE346360.1|	690134	690150	A	16	-	16	T
gi|514486632|gb|KE346360.1|	690149	690163	AC	14	-	7	TG
gi|514486632|gb|KE346360.1|	690503	690528	A	25	-	25	T
gi|514486632|gb|KE346360.1|	690586	690607	AAGACTC	21	+	3	GACTCAA
gi|514486632|gb|KE346360.1|	690862	690879	A	17	+	17	A
gi|514486632|gb|KE346360.1|	691159	691174	ACGATG	15	+	2	TGACGA
gi|514486632|gb|KE346360.1|	691324	691340	AGC	16	-	5	TGC
gi|514486632|gb|KE346360.1|	691789	691803	AGCAGCC	14	-	2	TGCTGGC
gi|514486632|gb|KE346360.1|	693008	693025	AAAAC	17	-	3	TTTGT
gi|514486632|gb|KE346360.1|	693018	693032	AAAC	14	-	3	TTTG
gi|514486632|gb|KE346360.1|	693153	693169	A	16	+	16	A
gi|514486632|gb|KE346360.1|	694601	694621	AGC	20	-	6	CTG
gi|514486632|gb|KE346360.1|	695596	695621	ACG	25	-	8	TCG
gi|514486632|gb|KE346360.1|	696310	696326	AAG	16	+	5	GAA
gi|514486632|gb|KE346360.1|	696751	696768	AGC	17	-	5	GCT
gi|514486632|gb|KE346360.1|	696874	696891	A	17	+	17	A
gi|514486632|gb|KE346360.1|	697032	697046	AC	14	-	7	GT
gi|514486632|gb|KE346360.1|	697138	697153	AAAAAAG	15	+	2	AGAAAAA
gi|514486632|gb|KE346360.1|	697257	697273	AACGC	16	+	3	CAACG
gi|514486632|gb|KE346360.1|	697883	697897	AAAACCC	14	-	2	GGGTTTT
gi|514486632|gb|KE346360.1|	698166	698184	ACC	18	-	6	TGG
gi|514486632|gb|KE346360.1|	698422	698440	AAAAAAC	18	-	2	TTTTTGT
gi|514486632|gb|KE346360.1|	701406	701422	ATCCCC	16	-	2	TGGGGA
gi|514486632|gb|KE346360.1|	702176	702191	AAAAAC	15	+	2	AAAAAC
gi|514486632|gb|KE346360.1|	702372	702386	AG	14	+	7	AG
gi|514486632|gb|KE346360.1|	702688	702704	AGAGAGG	16	-	2	CTCTCCT
gi|514486632|gb|KE346360.1|	702944	702958	A	14	+	14	A
gi|514486632|gb|KE346360.1|	703201	703215	AAAAAAC	14	-	2	TGTTTTT
gi|514486632|gb|KE346360.1|	703679	703695	AAAAAT	16	-	2	ATTTTT
gi|514486632|gb|KE346360.1|	703753	703769	AAAGAAG	16	-	2	TTTCTTC
gi|514486632|gb|KE346360.1|	704003	704023	AAGAGG	20	-	3	TCCTCT
gi|514486632|gb|KE346360.1|	704126	704140	AAAAAC	14	-	2	TTGTTT
gi|514486632|gb|KE346360.1|	704443	704457	AC	14	+	7	CA
gi|514486632|gb|KE346360.1|	704728	704742	AAACTC	14	-	2	GAGTTT
gi|514486632|gb|KE346360.1|	707381	707398	AAGAGG	17	+	2	GAGGAA
gi|514486632|gb|KE346360.1|	707393	707408	AGG	15	+	5	GAG
gi|514486632|gb|KE346360.1|	707562	707577	A	15	+	15	A
gi|514486632|gb|KE346360.1|	708405	708435	AC	30	+	15	AC
gi|514486632|gb|KE346360.1|	710205	710226	ACGGGC	21	+	3	GGCACG
gi|514486632|gb|KE346360.1|	711143	711166	A	23	-	23	T
gi|514486632|gb|KE346360.1|	713817	713833	AAGCAC	16	-	2	CTTGTG
gi|514486632|gb|KE346360.1|	714890	714915	A	25	+	25	A
gi|514486632|gb|KE346360.1|	715100	715116	A	16	+	16	A
gi|514486632|gb|KE346360.1|	715162	715178	AACTG	16	+	3	TGAAC
gi|514486632|gb|KE346360.1|	716398	716416	A	18	+	18	A
gi|514486632|gb|KE346360.1|	716918	716932	ACGG	14	-	3	GTCC
gi|514486632|gb|KE346360.1|	717066	717085	A	19	+	19	A
gi|514486632|gb|KE346360.1|	717112	717130	A	18	+	18	A
gi|514486632|gb|KE346360.1|	717944	717958	AAAAC	14	-	2	TTTTG
gi|514486632|gb|KE346360.1|	717966	717980	A	14	-	14	T
gi|514486632|gb|KE346360.1|	718186	718206	A	20	-	20	T
gi|514486632|gb|KE346360.1|	718697	718715	A	18	-	18	T
gi|514486632|gb|KE346360.1|	718954	718968	AAAAACC	14	+	2	AAAAACC
gi|514486632|gb|KE346360.1|	720833	720847	ACCCGCC	14	+	2	ACCCGCC
gi|514486632|gb|KE346360.1|	722301	722321	AC	20	-	10	GT
gi|514486632|gb|KE346360.1|	723979	723997	ACACGAG	18	-	2	TCTCGTG
gi|514486632|gb|KE346360.1|	725381	725415	AAAC	34	+	8	AACA
gi|514486632|gb|KE346360.1|	725905	725922	ACG	17	-	5	CGT
gi|514486632|gb|KE346360.1|	728499	728513	ACC	14	+	4	CCA
gi|514486632|gb|KE346360.1|	730903	730918	AAAAAC	15	-	2	TTGTTT
gi|514486632|gb|KE346360.1|	732040	732055	A	15	-	15	T
gi|514486632|gb|KE346360.1|	733571	733586	AAAAAC	15	+	2	AAAAAC
gi|514486632|gb|KE346360.1|	737550	737567	AAC	17	+	5	CAA
gi|514486632|gb|KE346360.1|	738840	738871	AGC	31	+	10	AGC
gi|514486632|gb|KE346360.1|	738902	738917	AGC	15	+	5	CAG
gi|514486632|gb|KE346360.1|	739111	739127	AGCGGC	16	+	2	GCAGCG
gi|514486632|gb|KE346360.1|	739228	739254	AGC	26	-	8	CTG
gi|514486632|gb|KE346360.1|	739861	739878	AGC	17	-	5	GCT
gi|514486632|gb|KE346360.1|	739917	739932	CCG	15	-	5	GGC
gi|514486632|gb|KE346360.1|	739996	740022	AGC	26	-	8	TGC
gi|514486632|gb|KE346360.1|	740140	740157	A	17	+	17	A
gi|514486632|gb|KE346360.1|	742843	742860	AGCTCC	17	-	2	GCTGGA
gi|514486632|gb|KE346360.1|	743276	743292	ACG	16	+	5	ACG
gi|514486632|gb|KE346360.1|	747011	747025	AGC	14	+	4	GCA
gi|514486632|gb|KE346360.1|	748087	748109	AACAGC	22	+	3	CAGCAA
gi|514486632|gb|KE346360.1|	748318	748338	AGC	20	+	6	CAG
gi|514486632|gb|KE346360.1|	749135	749154	AGC	19	+	6	AGC
gi|514486632|gb|KE346360.1|	749152	749169	AAC	17	+	5	CAA
gi|514486632|gb|KE346360.1|	749167	749190	AGC	23	+	7	CAG
gi|514486632|gb|KE346360.1|	750814	750829	AGC	15	+	5	CAG
gi|514486632|gb|KE346360.1|	751425	751443	AGC	18	+	6	GCA
gi|514486632|gb|KE346360.1|	752077	752091	AGC	14	-	4	GCT
gi|514486632|gb|KE346360.1|	752089	752103	CCG	14	+	4	GCC
gi|514486632|gb|KE346360.1|	752119	752142	ATC	23	+	7	TCA
gi|514486632|gb|KE346360.1|	752357	752371	AAAGCC	14	-	2	TGGCTT
gi|514486632|gb|KE346360.1|	752381	752395	AAAGCC	14	-	2	TTGGCT
gi|514486632|gb|KE346360.1|	753325	753348	A	23	-	23	T
gi|514486632|gb|KE346360.1|	756568	756593	AGC	25	-	8	CTG
gi|514486632|gb|KE346360.1|	757172	757196	AGC	24	-	8	TGC
gi|514486632|gb|KE346360.1|	759095	759113	AACAGC	18	+	3	GCAACA
gi|514486632|gb|KE346360.1|	759114	759137	AACAGC	23	+	3	CAACAG
gi|514486632|gb|KE346360.1|	761480	761498	ATC	18	-	6	GAT
gi|514486632|gb|KE346360.1|	761926	761941	ACG	15	-	5	GTC
gi|514486632|gb|KE346360.1|	762198	762217	AGC	19	-	6	CTG
gi|514486632|gb|KE346360.1|	763876	763892	AGC	16	-	5	GCT
gi|514486632|gb|KE346360.1|	763967	763986	AGC	19	+	6	AGC
gi|514486632|gb|KE346360.1|	764510	764525	AAGAGG	15	-	2	TCTTCC
gi|514486632|gb|KE346360.1|	764601	764615	AAGTC	14	-	2	TTGAC
gi|514486632|gb|KE346360.1|	764981	764995	AACTCT	14	+	2	CTCTAA
gi|514486632|gb|KE346360.1|	764999	765019	AG	20	-	10	TC
gi|514486632|gb|KE346360.1|	765283	765297	AAAAC	14	-	2	TTTTG
gi|514486632|gb|KE346360.1|	765581	765596	A	15	-	15	T
gi|514486632|gb|KE346360.1|	767121	767135	AAGGATG	14	+	2	ATGAAGG
gi|514486632|gb|KE346360.1|	767836	767862	A	26	-	26	T
gi|514486632|gb|KE346360.1|	767999	768023	A	24	+	24	A
gi|514486632|gb|KE346360.1|	772975	772989	ACGGCG	14	+	2	CGGCGA
gi|514486632|gb|KE346360.1|	773308	773324	ATC	16	-	5	TGA
gi|514486632|gb|KE346360.1|	773426	773442	ACCCCC	16	+	2	CCCCAC
gi|514486632|gb|KE346360.1|	773879	773893	ACG	14	+	4	GAC
gi|514486632|gb|KE346360.1|	774484	774501	AGGGGG	17	-	2	TCCCCC
gi|514486632|gb|KE346360.1|	775219	775240	AC	21	+	10	AC
gi|514486632|gb|KE346360.1|	775246	775261	A	15	+	15	A
gi|514486632|gb|KE346360.1|	776710	776724	ACCGGCC	14	-	2	CGGTGGC
gi|514486632|gb|KE346360.1|	778718	778732	AGC	14	-	4	TGC
gi|514486632|gb|KE346360.1|	778727	778741	AACAGC	14	-	2	TGCTGT
gi|514486632|gb|KE346360.1|	778858	778877	AGC	19	+	6	AGC
gi|514486632|gb|KE346360.1|	779252	779277	A	25	+	25	A
gi|514486632|gb|KE346360.1|	779316	779330	A	14	+	14	A
gi|514486632|gb|KE346360.1|	779649	779664	AAAAG	15	+	3	AAAAG
gi|514486632|gb|KE346360.1|	780742	780756	AC	14	+	7	CA
gi|514486632|gb|KE346360.1|	784809	784832	A	23	+	23	A
gi|514486632|gb|KE346360.1|	785175	785198	A	23	+	23	A
gi|514486632|gb|KE346360.1|	785392	785409	AG	17	+	8	AG
gi|514486632|gb|KE346360.1|	786158	786176	ACG	18	+	6	GAC
gi|514486632|gb|KE346360.1|	786285	786299	AATCGTG	14	-	2	ATTCACG
gi|514486632|gb|KE346360.1|	788369	788383	AGCCGC	14	+	2	GCAGCC
gi|514486632|gb|KE346360.1|	788414	788428	AACCGGC	14	-	2	CGGTTGC
gi|514486632|gb|KE346360.1|	788940	788959	AACGAC	19	+	3	ACAACG
gi|514486632|gb|KE346360.1|	790062	790079	A	17	-	17	T
gi|514486632|gb|KE346360.1|	790100	790114	A	14	+	14	A
gi|514486632|gb|KE346360.1|	794791	794806	ATCGC	15	-	3	GATGC
gi|514486632|gb|KE346360.1|	795109	795135	AGC	26	-	8	GCT
gi|514486632|gb|KE346360.1|	795367	795384	AACCAC	17	+	2	AACCAC
gi|514486632|gb|KE346360.1|	797190	797205	ACACGC	15	-	2	TGTGCG
gi|514486632|gb|KE346360.1|	797289	797303	A	14	-	14	T
gi|514486632|gb|KE346360.1|	799679	799693	ACG	14	-	4	CGT
gi|514486632|gb|KE346360.1|	802271	802306	AAC	35	+	11	CAA
gi|514486632|gb|KE346360.1|	802546	802560	AACCTGC	14	-	2	TGCAGGT
gi|514486632|gb|KE346360.1|	802805	802835	A	30	-	30	T
gi|514486632|gb|KE346360.1|	802855	802870	AAACAAC	15	-	2	TTGTTGT
gi|514486632|gb|KE346360.1|	803271	803285	ACG	14	+	4	CGA
gi|514486632|gb|KE346360.1|	803330	803486	AC	156	+	78	AC
gi|514486632|gb|KE346360.1|	803527	803541	AACAACC	14	-	2	GTTGTTG
gi|514486632|gb|KE346360.1|	805066	805081	AACAGGC	15	+	2	GGCAACA
gi|514486632|gb|KE346360.1|	805078	805092	AGC	14	+	4	CAG
gi|514486632|gb|KE346360.1|	807796	807810	AAAAC	14	-	2	GTTTT
gi|514486632|gb|KE346360.1|	808585	808600	AAAAC	15	-	3	GTTTT
gi|514486632|gb|KE346360.1|	811250	811265	ACGAGCG	15	+	2	CGAGCGA
gi|514486632|gb|KE346360.1|	812354	812370	ACTCGG	16	+	2	CTCGGA
gi|514486632|gb|KE346360.1|	813937	813953	AAGAC	16	-	3	GTCTT
gi|514486632|gb|KE346360.1|	814260	814275	C	15	+	15	C
gi|514486632|gb|KE346360.1|	814438	814460	AC	22	-	11	TG
gi|514486632|gb|KE346360.1|	817362	817378	A	16	+	16	A
gi|514486632|gb|KE346360.1|	819315	819330	ACGATG	15	-	2	TCATCG
gi|514486632|gb|KE346360.1|	819501	819522	ACG	21	+	7	GAC
gi|514486632|gb|KE346360.1|	820075	820094	AC	19	-	9	GT
gi|514486632|gb|KE346360.1|	820643	820661	AAC	18	-	6	GTT
gi|514486632|gb|KE346360.1|	823513	823527	ACG	14	-	4	GTC
gi|514486632|gb|KE346360.1|	823603	823625	AGAGCC	22	-	3	TGGCTC
gi|514486632|gb|KE346360.1|	823626	823647	AGAGCC	21	-	3	CTGGCT
gi|514486632|gb|KE346360.1|	824343	824357	A	14	-	14	T
gi|514486632|gb|KE346360.1|	824359	824374	A	15	-	15	T
gi|514486632|gb|KE346360.1|	824718	824734	ACG	16	-	5	CGT
gi|514486632|gb|KE346360.1|	824735	824749	ACGATG	14	-	2	TCATCG
gi|514486632|gb|KE346360.1|	824956	824978	AAG	22	-	7	TTC
gi|514486632|gb|KE346360.1|	825392	825406	AAC	14	-	4	TGT
gi|514486632|gb|KE346360.1|	825401	825448	AACAGC	47	-	7	TGTTGC
gi|514486632|gb|KE346360.1|	825451	825468	AACAGC	17	-	2	TTGCTG
gi|514486632|gb|KE346360.1|	826874	826992	AAC	118	+	39	CAA
gi|514486632|gb|KE346360.1|	828284	828298	ACATGC	14	-	2	CATGTG
gi|514486632|gb|KE346360.1|	830505	830521	ATC	16	+	5	TCA
gi|514486632|gb|KE346360.1|	830649	830671	A	22	+	22	A
gi|514486632|gb|KE346360.1|	830678	830707	AACG	29	-	7	GTTC
gi|514486632|gb|KE346360.1|	831022	831056	A	34	+	34	A
gi|514486632|gb|KE346360.1|	831429	831443	AC	14	-	7	TG
gi|514486632|gb|KE346360.1|	835056	835085	A	29	-	29	T
gi|514486632|gb|KE346360.1|	835443	835458	AAGGGC	15	-	2	CTTGCC
gi|514486632|gb|KE346360.1|	840685	840704	A	19	+	19	A
gi|514486632|gb|KE346360.1|	840746	840760	ATCGCC	14	+	2	GCCATC
gi|514486632|gb|KE346360.1|	840899	840916	A	17	+	17	A
gi|514486632|gb|KE346360.1|	841200	841226	A	26	+	26	A
gi|514486632|gb|KE346360.1|	842014	842028	A	14	-	14	T
gi|514486632|gb|KE346360.1|	842026	842040	AAG	14	-	4	TTC
gi|514486632|gb|KE346360.1|	842120	842141	A	21	-	21	T
gi|514486632|gb|KE346360.1|	846064	846082	A	18	+	18	A
gi|514486632|gb|KE346360.1|	848941	848957	AAACATG	16	+	2	AAACATG
gi|514486632|gb|KE346360.1|	850920	850934	A	14	+	14	A
gi|514486632|gb|KE346360.1|	851490	851514	AAC	24	-	8	TTG
gi|514486632|gb|KE346360.1|	851818	851833	A	15	+	15	A
gi|514486632|gb|KE346360.1|	851834	851849	AAAAAAT	15	+	2	AAATAAA
gi|514486632|gb|KE346360.1|	852162	852183	AG	21	+	10	AG
gi|514486632|gb|KE346360.1|	852423	852438	AAGAGC	15	+	2	CAAGAG
gi|514486632|gb|KE346360.1|	852658	852675	AG	17	+	8	AG
gi|514486632|gb|KE346360.1|	852816	852837	A	21	-	21	T
gi|514486632|gb|KE346360.1|	852857	852877	A	20	-	20	T
gi|514486632|gb|KE346360.1|	853718	853735	ACACTC	17	+	2	CACACT
gi|514486632|gb|KE346360.1|	854802	854816	ACACC	14	+	2	CCACA
gi|514486632|gb|KE346360.1|	857298	857313	AAAAGC	15	+	2	AAAGCA
gi|514486632|gb|KE346360.1|	857308	857325	AAAAAC	17	+	2	CAAAAA
gi|514486632|gb|KE346360.1|	859666	859681	CCG	15	+	5	GCC
gi|514486632|gb|KE346360.1|	859804	859819	AGCCGC	15	+	2	GCAGCC
gi|514486632|gb|KE346360.1|	861830	861844	AGCTCC	14	-	2	TGGAGC
gi|514486632|gb|KE346360.1|	863421	863445	AGAGAGG	24	+	3	GAGAGGA
gi|514486632|gb|KE346360.1|	863606	863622	AAGAG	16	+	3	GAAGA
gi|514486632|gb|KE346360.1|	863698	863712	AAAAT	14	+	2	AAAAT
gi|514486632|gb|KE346360.1|	863712	863726	AAT	14	+	4	AAT
gi|514486632|gb|KE346360.1|	863794	863810	ATCATCC	16	-	2	TGGATGA
gi|514486632|gb|KE346360.1|	863930	863949	AAAAT	19	+	3	AAAAT
gi|514486632|gb|KE346360.1|	863971	863997	A	26	+	26	A
gi|514486632|gb|KE346360.1|	864428	864447	AAG	19	+	6	GAA
gi|514486632|gb|KE346360.1|	864532	864546	AACCAG	14	+	2	ACCAGA
gi|514486632|gb|KE346360.1|	865162	865179	AATG	17	-	4	ATTC
gi|514486632|gb|KE346360.1|	866856	866871	AAAAAC	15	+	2	AAAAAC
gi|514486632|gb|KE346360.1|	871312	871332	AAAGCC	20	+	3	CAAAGC
gi|514486632|gb|KE346360.1|	871327	871343	AGAGCC	16	+	2	AGCCAG
gi|514486632|gb|KE346360.1|	871769	871786	AATG	17	-	4	ATTC
gi|514486632|gb|KE346360.1|	871818	871835	AAAAAG	17	-	2	TTTTTC
gi|514486632|gb|KE346360.1|	872004	872019	ATC	15	+	5	ATC
gi|514486632|gb|KE346360.1|	872026	872040	ATC	14	+	4	TCA
gi|514486632|gb|KE346360.1|	872052	872066	AGC	14	+	4	AGC
gi|514486632|gb|KE346360.1|	875487	875501	A	14	-	14	T
gi|514486632|gb|KE346360.1|	875962	875976	AAAAAC	14	-	2	TTTTTG
gi|514486632|gb|KE346360.1|	875977	876005	AAC	28	-	9	TTG
gi|514486632|gb|KE346360.1|	876941	876955	AAACGAC	14	-	2	GTTTGTC
gi|514486632|gb|KE346360.1|	877095	877113	ACG	18	+	6	CGA
gi|514486632|gb|KE346360.1|	878150	878168	A	18	+	18	A
gi|514486632|gb|KE346360.1|	879003	879025	AC	22	+	11	CA
gi|514486632|gb|KE346360.1|	879288	879302	A	14	+	14	A
gi|514486632|gb|KE346360.1|	879388	879408	A	20	+	20	A
gi|514486632|gb|KE346360.1|	879580	879594	CCG	14	-	4	GGC
gi|514486632|gb|KE346360.1|	879908	879922	AAGTCAC	14	-	2	TGTGACT
gi|514486632|gb|KE346360.1|	880668	880691	A	23	-	23	T
gi|514486632|gb|KE346360.1|	880925	880939	ACG	14	+	4	GAC
gi|514486632|gb|KE346360.1|	881189	881212	AGG	23	+	7	GAG
gi|514486632|gb|KE346360.1|	881351	881374	AACAGC	23	+	3	CAGCAA
gi|514486632|gb|KE346360.1|	881530	881552	ACG	22	+	7	CGA
gi|514486632|gb|KE346360.1|	882056	882087	AAAAAAT	31	-	4	TTTTTTA
gi|514486632|gb|KE346360.1|	882832	882861	ACCTGC	29	+	4	GCACCT
gi|514486632|gb|KE346360.1|	883045	883061	AACCGGC	16	+	2	ACCGGCA
gi|514486632|gb|KE346360.1|	884283	884306	AACAGC	23	+	3	CAACAG
gi|514486632|gb|KE346360.1|	884310	884325	AAC	15	+	5	CAA
gi|514486632|gb|KE346360.1|	884535	884552	AGCAGG	17	-	2	CCTGCT
gi|514486632|gb|KE346360.1|	884547	884561	AGGGGC	14	-	2	CCTGCC
gi|514486632|gb|KE346360.1|	886074	886088	AAAATC	14	-	2	TTGATT
gi|514486632|gb|KE346360.1|	886095	886112	A	17	-	17	T
gi|514486632|gb|KE346360.1|	886416	886432	A	16	-	16	T
gi|514486632|gb|KE346360.1|	886776	886796	AGAGAGC	20	+	2	CAGAGAG
gi|514486632|gb|KE346360.1|	886860	886874	AATCTCC	14	+	2	CAATCTC
gi|514486632|gb|KE346360.1|	886938	886952	AAGCAC	14	-	2	TGTGCT
gi|514486632|gb|KE346360.1|	889010	889025	AC	15	-	7	GT
gi|514486632|gb|KE346360.1|	890337	890351	AATGGC	14	-	2	CATTGC
gi|514486632|gb|KE346360.1|	891059	891076	AAAAAAT	17	+	2	AAAATAA
gi|514486632|gb|KE346360.1|	891269	891287	AAG	18	+	6	AAG
gi|514486632|gb|KE346360.1|	891602	891616	A	14	-	14	T
gi|514486632|gb|KE346360.1|	891772	891787	AAAAAAG	15	-	2	TCTTTTT
gi|514486632|gb|KE346360.1|	893394	893410	AAC	16	+	5	ACA
gi|514486632|gb|KE346360.1|	893414	893433	A	19	+	19	A
gi|514486632|gb|KE346360.1|	893594	893612	A	18	+	18	A
gi|514486632|gb|KE346360.1|	893976	894000	A	24	+	24	A
gi|514486632|gb|KE346360.1|	894030	894054	A	24	-	24	T
gi|514486632|gb|KE346360.1|	894252	894266	AAACAAC	14	+	2	ACAACAA
gi|514486632|gb|KE346360.1|	894777	894793	AGC	16	-	5	CTG
gi|514486632|gb|KE346360.1|	894788	894802	AGCGGC	14	-	2	GCTGCC
gi|514486632|gb|KE346360.1|	895393	895408	AACAAT	15	-	2	TTGTTA
gi|514486632|gb|KE346360.1|	895550	895566	AAAAT	16	-	3	TATTT
gi|514486632|gb|KE346360.1|	895594	895611	ACCCTC	17	+	2	CCCTCA
gi|514486632|gb|KE346360.1|	895620	895636	AGAGGC	16	-	2	CTCTGC
gi|514486632|gb|KE346360.1|	895663	895680	AGAGGG	17	-	2	TCTCCC
gi|514486632|gb|KE346360.1|	895675	895697	AAGGAG	22	-	3	TCTCCT
gi|514486632|gb|KE346360.1|	896107	896126	AATGCC	19	+	3	CCAATG
gi|514486632|gb|KE346360.1|	896776	896793	AAAAAG	17	-	2	TTTTTC
gi|514486632|gb|KE346360.1|	897192	897209	AGCGGC	17	-	2	GCTGCC
gi|514486632|gb|KE346360.1|	897748	897762	ACCGACG	14	+	2	CGACGAC
gi|514486632|gb|KE346360.1|	899688	899702	AGCAGG	14	+	2	GCAGGA
gi|514486632|gb|KE346360.1|	899724	899748	AGC	24	+	8	GCA
gi|514486632|gb|KE346360.1|	901989	902054	AAAAGG	65	-	10	TCCTTT
gi|514486632|gb|KE346360.1|	902376	902390	ACG	14	-	4	TCG
gi|514486632|gb|KE346360.1|	904672	904686	AAAAATG	14	+	2	ATGAAAA
gi|514486632|gb|KE346360.1|	905363	905378	AGGG	15	+	3	GGAG
gi|514486632|gb|KE346360.1|	905874	905888	AGATGC	14	+	2	GCAGAT
gi|514486632|gb|KE346360.1|	906248	906268	AAAAAT	20	+	3	AATAAA
gi|514486632|gb|KE346360.1|	906265	906279	AAAAT	14	+	2	AAAAT
gi|514486632|gb|KE346360.1|	906281	906296	AAAAAAT	15	+	2	AATAAAA
gi|514486632|gb|KE346360.1|	906424	906438	AGGGG	14	+	2	GGGAG
gi|514486632|gb|KE346360.1|	906432	906446	AAGGGG	14	+	2	AGGGGA
gi|514486632|gb|KE346360.1|	906568	906592	AGATGGG	24	+	3	ATGGGAG
gi|514486632|gb|KE346360.1|	906851	906869	AAGC	18	-	4	GCTT
gi|514486632|gb|KE346360.1|	907185	907207	ATC	22	+	7	ATC
gi|514486632|gb|KE346360.1|	907211	907225	ATC	14	+	4	CAT
gi|514486632|gb|KE346360.1|	907220	907234	AGCATC	14	+	2	CATCAG
gi|514486632|gb|KE346360.1|	907262	907277	CCG	15	+	5	CCG
gi|514486632|gb|KE346360.1|	907571	907586	CCGCGG	15	+	2	CCGCGG
gi|514486632|gb|KE346360.1|	908991	909005	ATC	14	-	4	TGA
gi|514486632|gb|KE346360.1|	909081	909095	AAT	14	-	4	TTA
gi|514486632|gb|KE346360.1|	909502	909545	AAAAC	43	-	8	TTGTT
gi|514486632|gb|KE346360.1|	910001	910023	A	22	-	22	T
gi|514486632|gb|KE346360.1|	911160	911185	AAC	25	+	8	ACA
gi|514486632|gb|KE346360.1|	911230	911244	AAAAAAC	14	+	2	AAAAACA
gi|514486632|gb|KE346360.1|	912180	912194	A	14	+	14	A
gi|514486632|gb|KE346360.1|	918230	918244	AAGAG	14	+	2	GAGAA
gi|514486632|gb|KE346360.1|	918240	918259	AGAGG	19	+	3	GAGAG
gi|514486632|gb|KE346360.1|	918516	918531	A	15	+	15	A
gi|514486632|gb|KE346360.1|	919374	919398	A	24	+	24	A
gi|514486632|gb|KE346360.1|	919413	919428	AAAAAT	15	+	2	AAATAA
gi|514486632|gb|KE346360.1|	919434	919449	A	15	+	15	A
gi|514486632|gb|KE346360.1|	919724	919742	AAAC	18	+	4	AAAC
gi|514486632|gb|KE346360.1|	920012	920026	AGCTCG	14	+	2	GCTCGA
gi|514486632|gb|KE346360.1|	920904	920918	AACGGGC	14	+	2	GGCAACG
gi|514486632|gb|KE346360.1|	921409	921428	AGG	19	-	6	CCT
gi|514486632|gb|KE346360.1|	921617	921632	AAAAC	15	+	3	AACAA
gi|514486632|gb|KE346360.1|	921994	922008	AAAAC	14	+	2	AAAAC
gi|514486632|gb|KE346360.1|	922068	922090	A	22	-	22	T
gi|514486632|gb|KE346360.1|	922456	922476	A	20	+	20	A
gi|514486632|gb|KE346360.1|	922665	922681	A	16	+	16	A
gi|514486632|gb|KE346360.1|	922763	922777	A	14	-	14	T
gi|514486632|gb|KE346360.1|	922835	922849	ATC	14	-	4	GAT
gi|514486632|gb|KE346360.1|	922915	922932	AAAGAG	17	-	2	TCTCTT
gi|514486632|gb|KE346360.1|	923148	923163	AAGC	15	-	3	CTTG
gi|514486632|gb|KE346360.1|	923472	923502	ATC	30	+	10	TCA
gi|514486632|gb|KE346360.1|	923639	923665	ACC	26	+	8	CCA
gi|514486632|gb|KE346360.1|	923937	923954	CCG	17	+	5	CGC
gi|514486632|gb|KE346360.1|	924132	924149	ACGCTG	17	+	2	CGCTGA
gi|514486632|gb|KE346360.1|	924328	924342	AGC	14	-	4	GCT
gi|514486632|gb|KE346360.1|	924343	924357	AGC	14	-	4	GCT
gi|514486632|gb|KE346360.1|	924358	924372	AGC	14	-	4	GCT
gi|514486632|gb|KE346360.1|	925161	925175	AAAAGAG	14	+	2	AGAAAAG
gi|514486632|gb|KE346360.1|	927064	927078	AAAAG	14	-	2	TTTTC
gi|514486632|gb|KE346360.1|	927103	927121	A	18	-	18	T
gi|514486632|gb|KE346360.1|	928258	928278	A	20	-	20	T
gi|514486632|gb|KE346360.1|	930290	930315	A	25	-	25	T
gi|514486632|gb|KE346360.1|	930865	930879	ACACGGT	14	-	2	TACCGTG
gi|514486632|gb|KE346360.1|	931954	931971	AC	17	-	8	TG
gi|514486632|gb|KE346360.1|	931972	931987	AC	15	-	7	TG
gi|514486632|gb|KE346360.1|	934167	934183	A	16	+	16	A
gi|514486632|gb|KE346360.1|	934318	934332	AACTCC	14	-	2	AGTTGG
gi|514486632|gb|KE346360.1|	937710	937725	AAAAAAT	15	+	2	AATAAAA
gi|514486632|gb|KE346360.1|	937731	937760	AAAAAAT	29	+	4	AATAAAA
gi|514486632|gb|KE346360.1|	938202	938216	AGAGCCC	14	-	2	CTGGGCT
gi|514486632|gb|KE346360.1|	938329	938343	A	14	+	14	A
gi|514486632|gb|KE346360.1|	938791	938810	A	19	-	19	T
gi|514486632|gb|KE346360.1|	938827	938841	A	14	-	14	T
gi|514486632|gb|KE346360.1|	938877	938891	AAAAAG	14	+	2	AAAAAG
gi|514486632|gb|KE346360.1|	939157	939171	AAAAAGT	14	-	2	ACTTTTT
gi|514486632|gb|KE346360.1|	942159	942173	AACAGC	14	-	2	TGCTGT
gi|514486632|gb|KE346360.1|	944113	944128	ACCATGG	15	+	2	GGACCAT
gi|514486632|gb|KE346360.1|	944355	944370	AAGAGC	15	-	2	TTGCTC
gi|514486632|gb|KE346360.1|	945365	945380	AGC	15	+	5	CAG
gi|514486632|gb|KE346360.1|	945497	945525	AACC	28	+	7	CCAA
gi|514486632|gb|KE346360.1|	945692	945721	ACCCAG	29	+	4	CAGACC
gi|514486632|gb|KE346360.1|	946022	946037	AC	15	+	7	CA
gi|514486632|gb|KE346360.1|	948872	948886	AACAGC	14	-	2	TGCTGT
gi|514486632|gb|KE346360.1|	948905	948932	AGC	27	-	9	TGC
gi|514486632|gb|KE346360.1|	949078	949093	ACGCGG	15	+	2	CGCGGA
gi|514486632|gb|KE346360.1|	949883	949900	AGCGGC	17	+	2	GCAGCG
gi|514486632|gb|KE346360.1|	949917	949931	AAGCCC	14	-	2	TGGGCT
gi|514486632|gb|KE346360.1|	950221	950243	AC	22	-	11	GT
gi|514486632|gb|KE346360.1|	950283	950298	AAAAG	15	+	3	AAAAG
gi|514486632|gb|KE346360.1|	950731	950746	AATCGTC	15	-	2	GACGATT
gi|514486632|gb|KE346360.1|	950840	950864	ACC	24	-	8	GGT
gi|514486632|gb|KE346360.1|	951147	951165	A	18	+	18	A
gi|514486632|gb|KE346360.1|	951167	951181	A	14	+	14	A
gi|514486632|gb|KE346360.1|	951346	951376	A	30	+	30	A
gi|514486632|gb|KE346360.1|	951543	951558	AAATC	15	+	3	AAATC
gi|514486632|gb|KE346360.1|	951762	951782	AAGAGG	20	+	3	GAGGAA
gi|514486632|gb|KE346360.1|	952382	952397	A	15	-	15	T
gi|514486632|gb|KE346360.1|	952975	953007	A	32	-	32	T
gi|514486632|gb|KE346360.1|	953678	953692	AGCGGC	14	+	2	GCAGCG
gi|514486632|gb|KE346360.1|	954739	954753	ATCGGCC	14	+	2	GCCATCG
gi|514486632|gb|KE346360.1|	956056	956071	ACCTGG	15	+	2	GGACCT
gi|514486632|gb|KE346360.1|	956508	956536	AGC	28	+	9	GCA
gi|514486632|gb|KE346360.1|	957108	957125	ACCCTG	17	-	2	AGGGTC
gi|514486632|gb|KE346360.1|	957141	957156	AATTC	15	-	3	TTGAA
gi|514486632|gb|KE346360.1|	957245	957263	A	18	+	18	A
gi|514486632|gb|KE346360.1|	957353	957373	AAGACG	20	+	3	GAAGAC
gi|514486632|gb|KE346360.1|	957430	957447	A	17	+	17	A
gi|514486632|gb|KE346360.1|	957828	957847	A	19	+	19	A
gi|514486632|gb|KE346360.1|	958062	958077	AAAATTG	15	-	2	TTTTCAA
gi|514486632|gb|KE346360.1|	958125	958140	AAG	15	+	5	AAG
gi|514486632|gb|KE346360.1|	958212	958227	A	15	-	15	T
gi|514486632|gb|KE346360.1|	958447	958464	AAT	17	-	5	TTA
gi|514486632|gb|KE346360.1|	958457	958473	AAATAAT	16	-	2	TATTATT
gi|514486632|gb|KE346360.1|	958657	958675	A	18	-	18	T
gi|514486632|gb|KE346360.1|	959093	959112	ACC	19	+	6	CAC
gi|514486632|gb|KE346360.1|	961602	961618	AAAAAC	16	-	2	TTTTTG
gi|514486632|gb|KE346360.1|	961707	961721	AAC	14	-	4	TGT
gi|514486632|gb|KE346360.1|	961719	961746	AGC	27	-	9	TGC
gi|514486632|gb|KE346360.1|	962225	962240	AC	15	-	7	TG
gi|514486632|gb|KE346360.1|	963071	963086	ACCGCTC	15	+	2	CGCTCAC
gi|514486632|gb|KE346360.1|	963577	963591	ACGAGC	14	-	2	CGTGCT
gi|514486632|gb|KE346360.1|	967663	967679	AAAAAAG	16	+	2	AAAAAGA
gi|514486632|gb|KE346360.1|	967766	967785	AAAAAAG	19	-	2	TTTTTTC
gi|514486632|gb|KE346360.1|	968001	968019	AAAAAAG	18	+	2	AAAAAAG
gi|514486632|gb|KE346360.1|	968029	968043	AAAAG	14	+	2	AAAAG
gi|514486632|gb|KE346360.1|	968079	968097	AAAAAAC	18	-	2	TTTTTGT
gi|514486632|gb|KE346360.1|	968605	968623	AAAGAG	18	+	3	AGAGAA
gi|514486632|gb|KE346360.1|	968623	968637	AAAGAGC	14	+	2	CAAAGAG
gi|514486632|gb|KE346360.1|	968816	968835	AAAAACC	19	+	2	AAAAACC
gi|514486632|gb|KE346360.1|	971346	971363	AATGC	17	-	3	TGCAT
gi|514486632|gb|KE346360.1|	972100	972116	A	16	-	16	T
gi|514486632|gb|KE346360.1|	975223	975237	ACATGC	14	+	2	ACATGC
gi|514486632|gb|KE346360.1|	975358	975380	ACTGATG	22	-	3	CAGTCAT
gi|514486632|gb|KE346360.1|	975399	975413	AATCTC	14	-	2	TGAGAT
gi|514486632|gb|KE346360.1|	975892	975906	AGC	14	+	4	AGC
gi|514486632|gb|KE346360.1|	976448	976467	AAACTC	19	+	3	CAAACT
gi|514486632|gb|KE346360.1|	979070	979086	AGC	16	-	5	TGC
gi|514486632|gb|KE346360.1|	980936	980951	AGC	15	+	5	GCA
gi|514486632|gb|KE346360.1|	982127	982142	AACACGT	15	-	2	TACGTGT
gi|514486632|gb|KE346360.1|	982215	982231	A	16	-	16	T
gi|514486632|gb|KE346360.1|	982841	982855	AGC	14	+	4	CAG
gi|514486632|gb|KE346360.1|	983149	983168	AG	19	-	9	CT
gi|514486632|gb|KE346360.1|	984181	984207	AGC	26	-	8	CTG
gi|514486632|gb|KE346360.1|	984284	984306	AGC	22	-	7	TGC
gi|514486632|gb|KE346360.1|	988285	988300	AGC	15	-	5	TGC
gi|514486632|gb|KE346360.1|	989303	989331	CCG	28	-	9	GCG
gi|514486632|gb|KE346360.1|	989833	989853	CCG	20	+	6	CGC
gi|514486632|gb|KE346360.1|	990175	990201	A	26	+	26	A
gi|514486632|gb|KE346360.1|	990299	990315	AAAAAAC	16	-	2	TTGTTTT
gi|514486632|gb|KE346360.1|	990441	990465	AAGGCG	24	-	4	CTTCGC
gi|514486632|gb|KE346360.1|	990461	990483	ACTCGC	22	+	3	TCGCAC
gi|514486632|gb|KE346360.1|	990581	990600	AG	19	-	9	TC
gi|514486632|gb|KE346360.1|	992805	992820	ACAGAG	15	+	2	AGACAG
gi|514486632|gb|KE346360.1|	994995	995013	A	18	+	18	A
gi|514486632|gb|KE346360.1|	995244	995261	A	17	+	17	A
gi|514486632|gb|KE346360.1|	995476	995500	A	24	-	24	T
gi|514486632|gb|KE346360.1|	995816	995834	A	18	+	18	A
gi|514486632|gb|KE346360.1|	997267	997281	AAC	14	-	4	TTG
gi|514486632|gb|KE346360.1|	997703	997719	AGAGGG	16	+	2	GAGAGG
gi|514486632|gb|KE346360.1|	998063	998080	A	17	+	17	A
gi|514486632|gb|KE346360.1|	999438	999454	AACATTC	16	+	2	TCAACAT
gi|514486632|gb|KE346360.1|	999976	999991	AGC	15	-	5	CTG
gi|514486632|gb|KE346360.1|	1000031	1000048	AAC	17	-	5	TGT
gi|514486632|gb|KE346360.1|	1002516	1002533	AAGCTG	17	+	2	GCTGAA
gi|514486632|gb|KE346360.1|	1002930	1002950	ACTCTG	20	+	3	GACTCT
gi|514486632|gb|KE346360.1|	1003130	1003160	AAC	30	+	10	CAA
gi|514486632|gb|KE346360.1|	1007795	1007809	AG	14	-	7	CT
gi|514486632|gb|KE346360.1|	1007846	1007860	AGAGCG	14	-	2	TCGCTC
gi|514486632|gb|KE346360.1|	1007917	1007935	A	18	-	18	T
gi|514486632|gb|KE346360.1|	1007931	1007945	AAAAG	14	-	2	TTTTC
gi|514486632|gb|KE346360.1|	1007941	1007968	AAAAACC	27	-	3	TTTTGGT
gi|514486632|gb|KE346360.1|	1007962	1007976	AAAACCC	14	-	2	TTTTGGG
gi|514486632|gb|KE346360.1|	1008502	1008526	A	24	-	24	T
gi|514486632|gb|KE346360.1|	1008715	1008740	A	25	+	25	A
gi|514486632|gb|KE346360.1|	1008764	1008782	AAAAAC	18	+	3	AAAACA
gi|514486632|gb|KE346360.1|	1008790	1008805	A	15	+	15	A
gi|514486632|gb|KE346360.1|	1008988	1009002	AAAAAC	14	-	2	GTTTTT
gi|514486632|gb|KE346360.1|	1008998	1009016	AACCAC	18	-	3	TTGTGG
gi|514486632|gb|KE346360.1|	1009527	1009542	A	15	-	15	T
gi|514486632|gb|KE346360.1|	1012893	1012909	AAG	16	+	5	AAG
gi|514486632|gb|KE346360.1|	1014342	1014370	A	28	+	28	A
gi|514486632|gb|KE346360.1|	1014882	1014896	AAAC	14	+	3	AAAC
gi|514486632|gb|KE346360.1|	1018052	1018066	AAGACG	14	-	2	TCGTCT
gi|514486632|gb|KE346360.1|	1018061	1018075	AAG	14	-	4	TCT
gi|514486632|gb|KE346360.1|	1018511	1018532	AC	21	+	10	CA
gi|514486632|gb|KE346360.1|	1018838	1018861	AACAGC	23	-	3	TGCTGT
gi|514486632|gb|KE346360.1|	1019518	1019539	AAAAAAT	21	-	3	TTTTTTA
gi|514486632|gb|KE346360.1|	1019702	1019723	A	21	-	21	T
gi|514486632|gb|KE346360.1|	1019887	1019902	AACGCGG	15	+	2	GAACGCG
gi|514486632|gb|KE346360.1|	1020603	1020652	AC	49	-	24	GT
gi|514486632|gb|KE346360.1|	1020980	1021001	AC	21	-	10	GT
gi|514486632|gb|KE346360.1|	1023027	1023043	AACTGC	16	-	2	GCAGTT
gi|514486632|gb|KE346360.1|	1024071	1024088	CCG	17	-	5	GCG
gi|514486632|gb|KE346360.1|	1024086	1024105	AGC	19	+	6	GCA
gi|514486632|gb|KE346360.1|	1025302	1025316	ACTGCG	14	+	2	GCGACT
gi|514486632|gb|KE346360.1|	1026537	1026583	AAC	46	-	15	GTT
gi|514486632|gb|KE346360.1|	1028292	1028310	A	18	+	18	A
gi|514486632|gb|KE346360.1|	1028316	1028333	A	17	+	17	A
gi|514486632|gb|KE346360.1|	1028518	1028542	A	24	+	24	A
gi|514486632|gb|KE346360.1|	1028715	1028739	A	24	+	24	A
gi|514486632|gb|KE346360.1|	1028773	1028799	A	26	+	26	A
gi|514486632|gb|KE346360.1|	1029081	1029096	ACC	15	-	5	GGT
gi|514486632|gb|KE346360.1|	1029274	1029288	AACCTC	14	-	2	GGTTGA
gi|514486632|gb|KE346360.1|	1034889	1034907	AG	18	+	9	GA
gi|514486632|gb|KE346360.1|	1035242	1035259	ACGACT	17	-	2	GTAGTC
gi|514486632|gb|KE346360.1|	1035271	1035286	AGC	15	+	5	AGC
gi|514486632|gb|KE346360.1|	1040794	1040808	AGC	14	+	4	AGC
gi|514486632|gb|KE346360.1|	1040951	1040971	ACGAGG	20	+	3	GAGGAC
gi|514486632|gb|KE346360.1|	1040966	1040989	AAGACG	23	+	3	GACGAA
gi|514486632|gb|KE346360.1|	1041375	1041389	AAATGGG	14	+	2	GGAAATG
gi|514486632|gb|KE346360.1|	1041869	1041883	ACTC	14	-	3	TGAG
gi|514486632|gb|KE346360.1|	1041941	1041961	A	20	-	20	T
gi|514486632|gb|KE346360.1|	1042027	1042061	AATCATC	34	-	4	GATGATT
gi|514486632|gb|KE346360.1|	1042165	1042182	A	17	-	17	T
gi|514486632|gb|KE346360.1|	1042241	1042270	AACAAG	29	-	4	TTCTTG
gi|514486632|gb|KE346360.1|	1042364	1042379	AGGCG	15	-	3	CCTCG
gi|514486632|gb|KE346360.1|	1042814	1042828	AAAACC	14	-	2	TGGTTT
gi|514486632|gb|KE346360.1|	1042846	1042869	AC	23	+	11	AC
gi|514486632|gb|KE346360.1|	1043125	1043143	AATGGAG	18	-	2	TTCTCCA
gi|514486632|gb|KE346360.1|	1043862	1043885	AAC	23	+	7	CAA
gi|514486632|gb|KE346360.1|	1045218	1045232	AAAAAC	14	+	2	AAAACA
gi|514486632|gb|KE346360.1|	1046751	1046773	AAC	22	+	7	CAA
gi|514486632|gb|KE346360.1|	1047481	1047496	AGCGCC	15	+	2	AGCGCC
gi|514486632|gb|KE346360.1|	1047531	1047545	AAAAAG	14	+	2	AAGAAA
gi|514486632|gb|KE346360.1|	1048091	1048113	A	22	-	22	T
gi|514486632|gb|KE346360.1|	1048454	1048476	AAAAAAT	22	-	3	TTATTTT
gi|514486632|gb|KE346360.1|	1048469	1048488	AAAAAT	19	-	3	TATTTT
gi|514486632|gb|KE346360.1|	1048481	1048495	AAAAAAT	14	-	2	TATTTTT
gi|514486632|gb|KE346360.1|	1048856	1048870	AGGG	14	-	3	CCTC
gi|514486632|gb|KE346360.1|	1049103	1049119	AAGCTG	16	-	2	CAGCTT
gi|514486632|gb|KE346360.1|	1049257	1049275	AGC	18	+	6	GCA
gi|514486632|gb|KE346360.1|	1050198	1050220	AGC	22	+	7	AGC
gi|514486632|gb|KE346360.1|	1050337	1050352	AACAGC	15	+	2	ACAGCA
gi|514486632|gb|KE346360.1|	1050347	1050375	AAC	28	+	9	CAA
gi|514486632|gb|KE346360.1|	1050464	1050479	AACAGC	15	+	2	CAGCAA
gi|514486632|gb|KE346360.1|	1053068	1053091	AGC	23	+	7	AGC
gi|514486632|gb|KE346360.1|	1053582	1053596	AAC	14	+	4	ACA
gi|514486632|gb|KE346360.1|	1053609	1053624	AAACCC	15	+	2	AAACCC
gi|514486632|gb|KE346360.1|	1053617	1053634	AAAACCC	17	+	2	ACCCAAA
gi|514486632|gb|KE346360.1|	1057179	1057194	AGAT	15	+	3	AGAT
gi|514486632|gb|KE346360.1|	1057191	1057212	AG	21	+	10	AG
gi|514486632|gb|KE346360.1|	1057213	1057237	AG	24	+	12	AG
gi|514486632|gb|KE346360.1|	1057236	1057259	AC	23	-	11	GT
gi|514486632|gb|KE346360.1|	1057310	1057326	A	16	+	16	A
gi|514486632|gb|KE346360.1|	1057328	1057345	AAC	17	+	5	ACA
gi|514486632|gb|KE346360.1|	1057652	1057667	AAAGAC	15	-	2	TCTTTG
gi|514486632|gb|KE346360.1|	1057839	1057862	AACAG	23	+	4	AGAAC
gi|514486632|gb|KE346360.1|	1057874	1057891	A	17	+	17	A
gi|514486632|gb|KE346360.1|	1058252	1058268	ACC	16	+	5	CCA
gi|514486632|gb|KE346360.1|	1058335	1058350	AACAAG	15	-	2	GTTCTT
gi|514486632|gb|KE346360.1|	1058526	1058553	ACAGCC	27	+	4	GCCACA
gi|514486632|gb|KE346360.1|	1059302	1059319	ACC	17	+	5	ACC
gi|514486632|gb|KE346360.1|	1061290	1061304	AGC	14	+	4	CAG
gi|514486632|gb|KE346360.1|	1065243	1065262	AGC	19	-	6	TGC
gi|514486632|gb|KE346360.1|	1066968	1066985	A	17	+	17	A
gi|514486632|gb|KE346360.1|	1066994	1067010	A	16	-	16	T
gi|514486632|gb|KE346360.1|	1067068	1067084	AGCGATG	16	+	2	AGCGATG
gi|514486632|gb|KE346360.1|	1067154	1067178	AAAAT	24	-	4	TTATT
gi|514486632|gb|KE346360.1|	1067171	1067185	AAAATAT	14	-	2	ATTTTAT
gi|514486632|gb|KE346360.1|	1067186	1067202	AAAAT	16	-	3	TTTTA
gi|514486632|gb|KE346360.1|	1067195	1067209	AAAATAT	14	-	2	ATTTTAT
gi|514486632|gb|KE346360.1|	1067210	1067233	AAAAT	23	-	4	TTTTA
gi|514486632|gb|KE346360.1|	1067392	1067406	AAGAGGG	14	-	2	CTTCCCT
gi|514486632|gb|KE346360.1|	1067647	1067667	ACTC	20	+	5	TCAC
gi|514486632|gb|KE346360.1|	1069136	1069152	AAAGC	16	-	3	CTTTG
gi|514486632|gb|KE346360.1|	1069637	1069651	AAAACAC	14	+	2	CAAAACA
gi|514486632|gb|KE346360.1|	1069932	1069946	A	14	+	14	A
gi|514486632|gb|KE346360.1|	1070209	1070225	ACGAG	16	+	3	ACGAG
gi|514486632|gb|KE346360.1|	1070290	1070304	ACAG	14	-	3	CTGT
gi|514486632|gb|KE346360.1|	1070808	1070825	A	17	+	17	A
gi|514486632|gb|KE346360.1|	1070924	1070938	AAAGC	14	+	2	AAGCA
gi|514486632|gb|KE346360.1|	1070934	1070950	AAGCGG	16	+	2	AAGCGG
gi|514486632|gb|KE346360.1|	1071017	1071032	A	15	+	15	A
gi|514486632|gb|KE346360.1|	1071587	1071601	AAAAT	14	+	2	AAATA
gi|514486632|gb|KE346360.1|	1071781	1071803	A	22	+	22	A
gi|514486632|gb|KE346360.1|	1071997	1072015	A	18	+	18	A
gi|514486632|gb|KE346360.1|	1072183	1072207	A	24	+	24	A
gi|514486632|gb|KE346360.1|	1072445	1072462	ACCGAG	17	-	2	TCGGTC
gi|514486632|gb|KE346360.1|	1072805	1072819	AAGAG	14	-	2	CTTCT
gi|514486632|gb|KE346360.1|	1077054	1077080	AGGG	26	-	6	CCCT
gi|514486632|gb|KE346360.1|	1077492	1077507	A	15	-	15	T
gi|514486632|gb|KE346360.1|	1077801	1077815	AGCGATG	14	+	2	GCGATGA
gi|514486632|gb|KE346360.1|	1078975	1079002	AC	27	+	13	AC
gi|514486632|gb|KE346360.1|	1081430	1081449	AAAAAC	19	+	3	AACAAA
gi|514486632|gb|KE346360.1|	1081442	1081459	AAAAC	17	+	3	AACAA
gi|514486632|gb|KE346360.1|	1081705	1081722	AAAAAG	17	+	2	AAAAAG
gi|514486632|gb|KE346360.1|	1082534	1082561	ACAG	27	+	6	GACA
gi|514486632|gb|KE346360.1|	1083239	1083253	AGC	14	-	4	TGC
gi|514486632|gb|KE346360.1|	1083280	1083297	AACGAC	17	+	2	ACGACA
gi|514486632|gb|KE346360.1|	1083315	1083329	ACGATG	14	+	2	GACGAT
gi|514486632|gb|KE346360.1|	1083403	1083418	ACGGCG	15	+	2	ACGGCG
gi|514486632|gb|KE346360.1|	1083413	1083452	ACG	39	+	13	CGA
gi|514486632|gb|KE346360.1|	1083449	1083464	AGGGCG	15	+	2	CGAGGG
gi|514486632|gb|KE346360.1|	1083865	1083879	ACCCCC	14	+	2	CCACCC
gi|514486632|gb|KE346360.1|	1084666	1084698	AAC	32	-	10	TGT
gi|514486632|gb|KE346360.1|	1084696	1084729	AGC	33	-	11	TGC
gi|514486632|gb|KE346360.1|	1086865	1086882	AGC	17	-	5	GCT
gi|514486632|gb|KE346360.1|	1089891	1089910	AAC	19	-	6	TGT
gi|514486632|gb|KE346360.1|	1090903	1090917	AAAC	14	-	3	TTGT
gi|514486632|gb|KE346360.1|	1091175	1091193	AGC	18	+	6	GCA
gi|514486632|gb|KE346360.1|	1091253	1091268	AGC	15	+	5	GCA
gi|514486632|gb|KE346360.1|	1091490	1091517	AATG	27	+	6	ATGA
gi|514486632|gb|KE346360.1|	1091823	1091854	ATC	31	-	10	ATG
gi|514486632|gb|KE346360.1|	1093226	1093243	AACGAC	17	-	2	GTTGTC
gi|514486632|gb|KE346360.1|	1093241	1093258	AACGAC	17	-	2	GTTGTC
gi|514486632|gb|KE346360.1|	1093758	1093777	AAGC	19	-	4	CTTG
gi|514486632|gb|KE346360.1|	1093783	1093799	AAAAGAG	16	-	2	TTTTCTC
gi|514486632|gb|KE346360.1|	1094181	1094195	ACCACCC	14	+	2	CACCACC
gi|514486632|gb|KE346360.1|	1094520	1094611	AAAC	91	-	22	TTTG
gi|514486632|gb|KE346360.1|	1095298	1095332	AGC	34	+	11	CAG
gi|514486632|gb|KE346360.1|	1095649	1095664	AC	15	-	7	GT
gi|514486632|gb|KE346360.1|	1095841	1095855	AAGGGG	14	+	2	GGAAGG
gi|514486632|gb|KE346360.1|	1096202	1096218	AGC	16	-	5	GCT
gi|514486632|gb|KE346360.1|	1096220	1096236	ACC	16	-	5	GGT
gi|514486632|gb|KE346360.1|	1096880	1096894	AAAAG	14	+	2	AAAAG
gi|514486632|gb|KE346360.1|	1097414	1097438	AG	24	-	12	TC
gi|514486632|gb|KE346360.1|	1097799	1097827	ACCAG	28	+	5	CAGAC
gi|514486632|gb|KE346360.1|	1097898	1097912	AAAAAAT	14	+	2	AAAAAAT
gi|514486632|gb|KE346360.1|	1098051	1098070	AG	19	+	9	AG
gi|514486632|gb|KE346360.1|	1098255	1098290	AG	35	+	17	AG
gi|514486632|gb|KE346360.1|	1098834	1098848	AAGCTC	14	+	2	GCTCAA
gi|514486632|gb|KE346360.1|	1098962	1098989	A	27	+	27	A
gi|514486632|gb|KE346360.1|	1099053	1099068	AGCTCCC	15	+	2	GCTCCCA
gi|514486632|gb|KE346360.1|	1099836	1099859	AAC	23	-	7	TTG
gi|514486632|gb|KE346360.1|	1100685	1100707	A	22	-	22	T
gi|514486632|gb|KE346360.1|	1100754	1100769	AAAGCAC	15	-	2	TGCTTTG
gi|514486632|gb|KE346360.1|	1100877	1100901	A	24	+	24	A
gi|514486632|gb|KE346360.1|	1101145	1101163	AAACCC	18	-	3	TTTGGG
gi|514486632|gb|KE346360.1|	1102801	1102824	A	23	+	23	A
gi|514486632|gb|KE346360.1|	1103118	1103132	A	14	-	14	T
gi|514486632|gb|KE346360.1|	1103126	1103140	AAAAAAG	14	-	2	TTTTTTC
gi|514486632|gb|KE346360.1|	1103193	1103209	AACAGC	16	+	2	CAACAG
gi|514486632|gb|KE346360.1|	1104040	1104057	ACGATG	17	+	2	ACGATG
gi|514486632|gb|KE346360.1|	1105075	1105092	AAAAAT	17	+	2	AAAAAT
gi|514486632|gb|KE346360.1|	1105110	1105135	A	25	+	25	A
gi|514486632|gb|KE346360.1|	1105285	1105303	AAG	18	+	6	GAA
gi|514486632|gb|KE346360.1|	1105697	1105711	A	14	+	14	A
gi|514486632|gb|KE346360.1|	1105725	1105740	A	15	+	15	A
gi|514486632|gb|KE346360.1|	1106781	1106795	AAGGCGG	14	-	2	CCGCCTT
gi|514486632|gb|KE346360.1|	1107000	1107014	A	14	-	14	T
gi|514486632|gb|KE346360.1|	1107021	1107036	A	15	-	15	T
gi|514486632|gb|KE346360.1|	1107046	1107064	AAG	18	-	6	CTT
gi|514486632|gb|KE346360.1|	1109011	1109028	AC	17	-	8	TG
gi|514486632|gb|KE346360.1|	1109873	1109887	AAG	14	-	4	TTC
gi|514486632|gb|KE346360.1|	1110628	1110650	AAC	22	-	7	TTG
gi|514486632|gb|KE346360.1|	1111223	1111250	AAAC	27	-	6	TTTG
gi|514486632|gb|KE346360.1|	1111253	1111268	AAAC	15	-	3	GTTT
gi|514486632|gb|KE346360.1|	1112847	1112865	A	18	-	18	T
gi|514486632|gb|KE346360.1|	1113622	1113645	AGC	23	+	7	CAG
gi|514486632|gb|KE346360.1|	1114345	1114368	A	23	-	23	T
gi|514486632|gb|KE346360.1|	1115049	1115066	A	17	-	17	T
gi|514486632|gb|KE346360.1|	1115161	1115175	ACGAGCC	14	-	2	CTCGTGG
gi|514486632|gb|KE346360.1|	1116365	1116383	AAAC	18	-	4	TTGT
gi|514486632|gb|KE346360.1|	1116955	1116969	A	14	-	14	T
gi|514486632|gb|KE346360.1|	1117835	1117873	A	38	-	38	T
gi|514486632|gb|KE346360.1|	1118178	1118199	ACG	21	+	7	CGA
gi|514486632|gb|KE346360.1|	1118197	1118214	ATC	17	-	5	GAT
gi|514486632|gb|KE346360.1|	1118212	1118226	ACG	14	+	4	GAC
gi|514486632|gb|KE346360.1|	1120980	1120994	AAGTGCC	14	+	2	GCCAAGT
gi|514486632|gb|KE346360.1|	1121108	1121129	AAC	21	-	7	TTG
gi|514486632|gb|KE346360.1|	1123480	1123495	AAAC	15	+	3	AAAC
gi|514486632|gb|KE346360.1|	1123488	1123502	AAAAAC	14	+	2	AAACAA
gi|514486632|gb|KE346360.1|	1123814	1123829	A	15	+	15	A
gi|514486632|gb|KE346360.1|	1124452	1124474	AC	22	+	11	AC
gi|514486632|gb|KE346360.1|	1125004	1125026	AACG	22	+	5	AACG
gi|514486632|gb|KE346360.1|	1125317	1125333	ACCTCCC	16	+	2	CCACCTC
gi|514486632|gb|KE346360.1|	1125459	1125473	AAAAGC	14	+	2	CAAAAG
gi|514486632|gb|KE346360.1|	1128122	1128136	AAAAT	14	+	2	AAAAT
gi|514486632|gb|KE346360.1|	1130305	1130319	AAAAG	14	-	2	TTTTC
gi|514486632|gb|KE346360.1|	1130315	1130330	A	15	-	15	T
gi|514486632|gb|KE346360.1|	1130771	1130787	A	16	-	16	T
gi|514486632|gb|KE346360.1|	1131326	1131349	A	23	-	23	T
gi|514486632|gb|KE346360.1|	1132150	1132164	AGCTCC	14	-	2	CTGGAG
gi|514486632|gb|KE346360.1|	1136555	1136569	AAAGATC	14	+	2	ATCAAAG
gi|514486632|gb|KE346360.1|	1137251	1137266	AAC	15	+	5	ACA
gi|514486632|gb|KE346360.1|	1137267	1137393	AAC	126	+	42	CAA
gi|514486632|gb|KE346360.1|	1138425	1138445	AAAATAC	20	+	2	ATACAAA
gi|514486632|gb|KE346360.1|	1140347	1140365	A	18	-	18	T
gi|514486632|gb|KE346360.1|	1140505	1140525	A	20	+	20	A
gi|514486632|gb|KE346360.1|	1140616	1140630	AGCTC	14	-	2	GCTGA
gi|514486632|gb|KE346360.1|	1140755	1140772	A	17	+	17	A
gi|514486632|gb|KE346360.1|	1140786	1140803	AACTC	17	-	3	AGTTG
gi|514486632|gb|KE346360.1|	1142103	1142119	AGC	16	+	5	CAG
gi|514486632|gb|KE346360.1|	1143509	1143525	ACTGCG	16	-	2	GCAGTC
gi|514486632|gb|KE346360.1|	1143573	1143587	AGC	14	+	4	CAG
gi|514486632|gb|KE346360.1|	1143633	1143648	AAACAAC	15	+	2	AACAACA
gi|514486632|gb|KE346360.1|	1143738	1143754	AC	16	-	8	TG
gi|514486632|gb|KE346360.1|	1144020	1144039	ACTG	19	+	4	ACTG
gi|514486632|gb|KE346360.1|	1144074	1144089	AG	15	-	7	CT
gi|514486632|gb|KE346360.1|	1144841	1144856	A	15	-	15	T
gi|514486632|gb|KE346360.1|	1145177	1145191	AAACC	14	-	2	TTTGG
gi|514486632|gb|KE346360.1|	1145709	1145723	AG	14	+	7	AG
gi|514486632|gb|KE346360.1|	1146571	1146592	A	21	-	21	T
gi|514486632|gb|KE346360.1|	1146588	1146602	AAAAG	14	-	2	TTTTC
gi|514486632|gb|KE346360.1|	1147247	1147261	AAACGCC	14	+	2	CCAAACG
gi|514486632|gb|KE346360.1|	1147730	1147748	ACC	18	+	6	ACC
gi|514486632|gb|KE346360.1|	1149204	1149220	AACAATC	16	+	2	ACAATCA
gi|514486632|gb|KE346360.1|	1150983	1151013	CCG	30	+	10	GCC
gi|514486632|gb|KE346360.1|	1152013	1152036	AACCCG	23	+	3	CCCGAA
gi|514486632|gb|KE346360.1|	1152044	1152060	ACCCTG	16	+	2	CTGACC
gi|514486632|gb|KE346360.1|	1156273	1156290	AAG	17	-	5	TCT
gi|514486632|gb|KE346360.1|	1156528	1156575	AG	47	-	23	TC
gi|514486632|gb|KE346360.1|	1156660	1156675	AAGACG	15	+	2	ACGAAG
gi|514486632|gb|KE346360.1|	1156920	1156934	AAAAAC	14	-	2	TGTTTT
gi|514486632|gb|KE346360.1|	1157037	1157052	AACG	15	+	3	AACG
gi|514486632|gb|KE346360.1|	1157067	1157114	A	47	+	47	A
gi|514486632|gb|KE346360.1|	1157111	1157126	AAAG	15	+	3	AAAG
gi|514486632|gb|KE346360.1|	1157169	1157183	AACTTGC	14	-	2	AAGTTGC
gi|514486632|gb|KE346360.1|	1157945	1158002	AAC	57	-	19	TTG
gi|514486632|gb|KE346360.1|	1158314	1158330	A	16	-	16	T
gi|514486632|gb|KE346360.1|	1158332	1158346	A	14	-	14	T
gi|514486632|gb|KE346360.1|	1159204	1159227	AGC	23	-	7	TGC
gi|514486632|gb|KE346360.1|	1160650	1160669	AAC	19	-	6	TTG
gi|514486632|gb|KE346360.1|	1160670	1160684	AAC	14	-	4	GTT
gi|514486632|gb|KE346360.1|	1160708	1160722	AAACAAT	14	-	2	ATTGTTT
gi|514486632|gb|KE346360.1|	1160721	1160736	AC	15	-	7	TG
gi|514486632|gb|KE346360.1|	1162817	1162833	AGAGC	16	+	3	AGCAG
gi|514486632|gb|KE346360.1|	1163518	1163550	AAGCAG	32	-	5	CTTCTG
gi|514486632|gb|KE346360.1|	1166766	1166783	AAATCTC	17	+	2	CTCAAAT
gi|514486632|gb|KE346360.1|	1170349	1170363	A	14	-	14	T
gi|514486632|gb|KE346360.1|	1170764	1170784	AC	20	-	10	TG
gi|514486632|gb|KE346360.1|	1170916	1170939	ACTGC	23	-	4	TGCAG
gi|514486632|gb|KE346360.1|	1171661	1171675	AAGGAGC	14	-	2	CCTTGCT
gi|514486632|gb|KE346360.1|	1172119	1172136	AGCGGC	17	+	2	GCAGCG
gi|514486632|gb|KE346360.1|	1172241	1172257	A	16	+	16	A
gi|514486632|gb|KE346360.1|	1172264	1172281	AAAATTG	17	-	2	TTTTCAA
gi|514486632|gb|KE346360.1|	1172282	1172305	AAAATTG	23	-	3	CAATTTT
gi|514486632|gb|KE346360.1|	1173217	1173231	AAG	14	-	4	TCT
gi|514486632|gb|KE346360.1|	1176276	1176290	A	14	+	14	A
gi|514486632|gb|KE346360.1|	1176371	1176385	ACCTC	14	+	2	CACCT
gi|514486632|gb|KE346360.1|	1176513	1176527	AAACC	14	+	2	AAACC
gi|514486632|gb|KE346360.1|	1176906	1176920	AAAGG	14	+	2	GAAAG
gi|514486632|gb|KE346360.1|	1176938	1176953	A	15	+	15	A
gi|514486632|gb|KE346360.1|	1177055	1177078	AAG	23	+	7	AAG
gi|514486632|gb|KE346360.1|	1177076	1177090	A	14	+	14	A
gi|514486632|gb|KE346360.1|	1178924	1178940	AAGG	16	+	4	AAGG
gi|514486632|gb|KE346360.1|	1178971	1179006	A	35	+	35	A
gi|514486632|gb|KE346360.1|	1180980	1180997	AAAAAG	17	+	2	AAAAAG
gi|514486632|gb|KE346360.1|	1180990	1181005	AAAAAAG	15	+	2	AGAAAAA
gi|514486632|gb|KE346360.1|	1181017	1181034	AAAAAG	17	+	2	AAAAAG
gi|514486632|gb|KE346360.1|	1181061	1181077	ATCGCC	16	-	2	GATGGC
gi|514486632|gb|KE346360.1|	1181151	1181167	AACAAG	16	+	2	AGAACA
gi|514486632|gb|KE346360.1|	1181180	1181201	A	21	+	21	A
gi|514486632|gb|KE346360.1|	1182186	1182202	AGC	16	-	5	TGC
gi|514486632|gb|KE346360.1|	1184603	1184634	A	31	-	31	T
gi|514486632|gb|KE346360.1|	1188002	1188019	ATC	17	-	5	GAT
gi|514486632|gb|KE346360.1|	1188345	1188362	ACCTGC	17	+	2	CTGCAC
gi|514486632|gb|KE346360.1|	1189044	1189063	AGC	19	+	6	GCA
gi|514486632|gb|KE346360.1|	1189796	1189819	AC	23	-	11	TG
gi|514486632|gb|KE346360.1|	1189814	1189831	AAACAC	17	-	2	TGTGTT
gi|514486632|gb|KE346360.1|	1190633	1190649	AATG	16	-	4	TTCA
gi|514486632|gb|KE346360.1|	1190731	1190745	ACC	14	-	4	TGG
gi|514486632|gb|KE346360.1|	1191356	1191370	AGC	14	-	4	TGC
gi|514486632|gb|KE346360.1|	1191371	1191415	AGC	44	-	14	TGC
gi|514486632|gb|KE346360.1|	1192922	1192942	AACAGC	20	-	3	TGTTGC
gi|514486632|gb|KE346360.1|	1193708	1193722	AAGAGG	14	-	2	TCCTCT
gi|514486632|gb|KE346360.1|	1194278	1194305	AGC	27	-	9	TGC
gi|514486632|gb|KE346360.1|	1194884	1194906	A	22	+	22	A
gi|514486632|gb|KE346360.1|	1194950	1194965	AAGGAGC	15	+	2	GCAAGGA
gi|514486632|gb|KE346360.1|	1195106	1195120	A	14	+	14	A
gi|514486632|gb|KE346360.1|	1195322	1195345	A	23	+	23	A
gi|514486632|gb|KE346360.1|	1195436	1195450	AG	14	+	7	GA
gi|514486632|gb|KE346360.1|	1195712	1195726	AAAAAC	14	+	2	AAACAA
gi|514486632|gb|KE346360.1|	1195729	1195750	AAAAAC	21	+	3	AAAAAC
gi|514486632|gb|KE346360.1|	1196467	1196481	AAAACAC	14	-	2	GTTTTGT
gi|514486632|gb|KE346360.1|	1196675	1196693	AAACTCC	18	+	2	CTCCAAA
gi|514486632|gb|KE346360.1|	1197597	1197613	A	16	+	16	A
gi|514486632|gb|KE346360.1|	1197646	1197672	A	26	+	26	A
gi|514486632|gb|KE346360.1|	1197680	1197703	A	23	-	23	T
gi|514486632|gb|KE346360.1|	1197860	1197881	AG	21	+	10	GA
gi|514486632|gb|KE346360.1|	1197900	1197918	AGG	18	+	6	GAG
gi|514486632|gb|KE346360.1|	1198264	1198278	AAAATGC	14	-	2	TTTGCAT
gi|514486632|gb|KE346360.1|	1198978	1198992	ACGATG	14	-	2	TCGTCA
gi|514486632|gb|KE346360.1|	1200933	1200950	AAAACC	17	+	2	CAAAAC
gi|514486632|gb|KE346360.1|	1201331	1201345	AACACC	14	-	2	TGTTGG
gi|514486632|gb|KE346360.1|	1202014	1202028	AGC	14	+	4	AGC
gi|514486632|gb|KE346360.1|	1202101	1202115	AGC	14	-	4	CTG
gi|514486632|gb|KE346360.1|	1202250	1202268	A	18	+	18	A
gi|514486632|gb|KE346360.1|	1203143	1203158	A	15	-	15	T
gi|514486632|gb|KE346360.1|	1203438	1203455	AAAAACC	17	-	2	GTTTTTG
gi|514486632|gb|KE346360.1|	1204229	1204246	AACAACG	17	+	2	AACGAAC
gi|514486632|gb|KE346360.1|	1207621	1207654	ACG	33	-	11	CGT
gi|514486632|gb|KE346360.1|	1207772	1207792	ACTGCT	20	+	3	CTACTG
gi|514486632|gb|KE346360.1|	1207787	1207814	AGC	27	-	9	CTG
gi|514486632|gb|KE346360.1|	1208048	1208065	AAAAAG	17	+	2	AAAAAG
gi|514486632|gb|KE346360.1|	1208128	1208147	AAC	19	+	6	AAC
gi|514486632|gb|KE346360.1|	1208269	1208303	AAGGTC	34	-	5	TGACCT
gi|514486632|gb|KE346360.1|	1209673	1209693	A	20	-	20	T
gi|514486632|gb|KE346360.1|	1210537	1210551	AG	14	+	7	GA
gi|514486632|gb|KE346360.1|	1210646	1210660	AAATTGC	14	-	2	CAATTTG
gi|514486632|gb|KE346360.1|	1210823	1210845	ATC	22	+	7	CAT
gi|514486632|gb|KE346360.1|	1211138	1211160	AGC	22	-	7	CTG
gi|514486632|gb|KE346360.1|	1212903	1212920	AAAAC	17	-	3	TTGTT
gi|514486632|gb|KE346360.1|	1212942	1212956	AAAAC	14	-	2	TTTTG
gi|514486632|gb|KE346360.1|	1213383	1213398	AGC	15	-	5	GCT
gi|514486632|gb|KE346360.1|	1215439	1215454	AGCG	15	-	3	TCGC
gi|514486632|gb|KE346360.1|	1215457	1215475	A	18	+	18	A
gi|514486632|gb|KE346360.1|	1215498	1215519	AAAACCC	21	-	3	TTGGGTT
gi|514486632|gb|KE346360.1|	1215667	1215690	A	23	+	23	A
gi|514486632|gb|KE346360.1|	1220501	1220517	AGGATG	16	+	2	GATGAG
gi|514486632|gb|KE346360.1|	1220670	1220690	AATCTC	20	-	3	TTGAGA
gi|514486632|gb|KE346360.1|	1222448	1222477	AC	29	-	14	GT
gi|514486632|gb|KE346360.1|	1222928	1222952	AGC	24	+	8	GCA
gi|514486632|gb|KE346360.1|	1223240	1223257	A	17	+	17	A
gi|514486632|gb|KE346360.1|	1223937	1223961	A	24	+	24	A
gi|514486632|gb|KE346360.1|	1224730	1224744	AAACTG	14	+	2	CTGAAA
gi|514486632|gb|KE346360.1|	1224979	1224997	AAAC	18	-	4	TTGT
gi|514486632|gb|KE346360.1|	1226457	1226480	AGC	23	+	7	AGC
gi|514486632|gb|KE346360.1|	1226879	1226893	A	14	+	14	A
gi|514486632|gb|KE346360.1|	1227256	1227286	AAG	30	-	10	TTC
gi|514486632|gb|KE346360.1|	1227408	1227427	A	19	+	19	A
gi|514486632|gb|KE346360.1|	1227449	1227464	AAAAATG	15	+	2	ATGAAAA
gi|514486632|gb|KE346360.1|	1227781	1227800	ATC	19	-	6	ATG
gi|514486632|gb|KE346360.1|	1227853	1227867	AAAGAG	14	+	2	AAGAGA
gi|514486632|gb|KE346360.1|	1227970	1227991	AAC	21	-	7	TTG
gi|514486632|gb|KE346360.1|	1228003	1228019	AACCACC	16	-	2	TGGTTGG
gi|514486632|gb|KE346360.1|	1230159	1230173	CCCCG	14	-	2	GGGGC
gi|514486632|gb|KE346360.1|	1230711	1230727	AAAAAAG	16	-	2	TTTTCTT
gi|514486632|gb|KE346360.1|	1231006	1231021	AC	15	-	7	GT
gi|514486632|gb|KE346360.1|	1232566	1232580	AAAAC	14	+	2	AAAAC
gi|514486632|gb|KE346360.1|	1233465	1233479	ACCTC	14	-	2	AGGTG
gi|514486632|gb|KE346360.1|	1234043	1234057	AAAGTC	14	+	2	TCAAAG
gi|514486632|gb|KE346360.1|	1234137	1234177	AAAAAAG	40	+	5	AAAAAAG
gi|514486632|gb|KE346360.1|	1234810	1234824	AACAAGC	14	+	2	AGCAACA
gi|514486632|gb|KE346360.1|	1234849	1234868	AAAC	19	+	4	AAAC
gi|514486632|gb|KE346360.1|	1234974	1234991	ACGCCG	17	+	2	CGCCGA
gi|514486632|gb|KE346360.1|	1236855	1236869	AAGCTGG	14	+	2	GCTGGAA
gi|514486632|gb|KE346360.1|	1238377	1238409	AGC	32	-	10	TGC
gi|514486632|gb|KE346360.1|	1239666	1239692	AAAC	26	+	6	AACA
gi|514486632|gb|KE346360.1|	1239707	1239721	AAATTCC	14	+	2	AATTCCA
gi|514486632|gb|KE346360.1|	1240582	1240604	A	22	+	22	A
gi|514486632|gb|KE346360.1|	1240830	1240848	AAAAAAC	18	-	2	TTTTTTG
gi|514486632|gb|KE346360.1|	1243829	1243845	AGC	16	+	5	AGC
gi|514486632|gb|KE346360.1|	1244045	1244073	AAAC	28	-	7	TTGT
gi|514486632|gb|KE346360.1|	1248399	1248415	AGC	16	+	5	AGC
gi|514486632|gb|KE346360.1|	1248615	1248643	AAAC	28	-	7	TTGT
gi|514486632|gb|KE346360.1|	1251597	1251611	AAC	14	-	4	TGT
gi|514486632|gb|KE346360.1|	1251867	1251885	A	18	-	18	T
gi|514486632|gb|KE346360.1|	1251967	1251981	C	14	-	14	G
gi|514486632|gb|KE346360.1|	1252124	1252142	A	18	+	18	A
gi|514486632|gb|KE346360.1|	1252329	1252351	A	22	+	22	A
gi|514486632|gb|KE346360.1|	1252546	1252578	A	32	-	32	T
gi|514486632|gb|KE346360.1|	1252935	1252958	A	23	-	23	T
gi|514486632|gb|KE346360.1|	1253529	1253546	AAGAGGG	17	-	2	CTTCCCT
gi|514486632|gb|KE346360.1|	1254674	1254693	AGGGGG	19	+	3	GGGGGA
gi|514486632|gb|KE346360.1|	1256442	1256525	AAC	83	+	27	CAA
gi|514486632|gb|KE346360.1|	1257070	1257087	CCCCG	17	+	3	GCCCC
gi|514486632|gb|KE346360.1|	1257255	1257279	AAGC	24	+	6	GCAA
gi|514486632|gb|KE346360.1|	1257522	1257554	AAGG	32	+	8	GGAA
gi|514486632|gb|KE346360.1|	1257821	1257847	AAAGCAC	26	-	3	TTGTGCT
gi|514486632|gb|KE346360.1|	1257848	1257866	AC	18	-	9	TG
gi|514486632|gb|KE346360.1|	1258125	1258144	AAAG	19	+	4	AAAG
gi|514486632|gb|KE346360.1|	1258279	1258300	AGCG	21	+	5	GAGC
gi|514486632|gb|KE346360.1|	1258615	1258636	CCCCCG	21	-	3	GGGCGG
gi|514486632|gb|KE346360.1|	1258685	1258702	ACTC	17	+	4	CACT
gi|514486632|gb|KE346360.1|	1259120	1259136	A	16	-	16	T
gi|514486632|gb|KE346360.1|	1260453	1260468	AAAATCC	15	-	2	GGATTTT
gi|514486632|gb|KE346360.1|	1260931	1260948	ACT	17	+	5	ACT
gi|514486632|gb|KE346360.1|	1261762	1261788	ATC	26	+	8	TCA
gi|514486632|gb|KE346360.1|	1262833	1262848	ACCCCAT	15	+	2	ATACCCC
gi|514486632|gb|KE346360.1|	1263002	1263017	AAAGAG	15	+	2	AGAGAA
gi|514486632|gb|KE346360.1|	1263021	1263036	AG	15	+	7	GA
gi|514486632|gb|KE346360.1|	1263201	1263228	ACT	27	-	9	AGT
gi|514486632|gb|KE346360.1|	1263610	1263625	AGAGCC	15	+	2	GAGCCA
gi|514486632|gb|KE346360.1|	1267996	1268013	ACGATG	17	-	2	TCGTCA
gi|514486632|gb|KE346360.1|	1268026	1268040	ACGATG	14	-	2	TCGTCA
gi|514486632|gb|KE346360.1|	1270152	1270171	AAAC	19	+	4	AAAC
gi|514486632|gb|KE346360.1|	1270252	1270272	AAC	20	-	6	GTT
gi|514486632|gb|KE346360.1|	1270415	1270430	ATC	15	+	5	TCA
gi|514486632|gb|KE346360.1|	1270497	1270512	AAAATC	15	+	2	AAATCA
gi|514486632|gb|KE346360.1|	1270559	1270573	AG	14	+	7	AG
gi|514486632|gb|KE346360.1|	1270568	1270591	AGAGGG	23	+	3	GAGAGG
gi|514486632|gb|KE346360.1|	1270689	1270709	A	20	+	20	A
gi|514486632|gb|KE346360.1|	1271334	1271349	A	15	-	15	T
gi|514486632|gb|KE346360.1|	1272979	1272998	AAG	19	-	6	TTC
gi|514486632|gb|KE346360.1|	1273096	1273110	AGCAGCC	14	+	2	GCCAGCA
gi|514486632|gb|KE346360.1|	1275895	1275914	AAAACAG	19	+	2	AAACAGA
gi|514486632|gb|KE346360.1|	1275908	1275922	AAAAAC	14	+	2	AAAACA
gi|514486632|gb|KE346360.1|	1275915	1275946	AAAC	31	+	7	AAAC
gi|514486632|gb|KE346360.1|	1275939	1275955	AAAAAAC	16	+	2	AAACAAA
gi|514486632|gb|KE346360.1|	1276565	1276579	AAGCGC	14	+	2	GCAAGC
gi|514486632|gb|KE346360.1|	1280236	1280250	AAAACC	14	-	2	TTTGGT
gi|514486632|gb|KE346360.1|	1280270	1280285	A	15	+	15	A
gi|514486632|gb|KE346360.1|	1280929	1280968	AG	39	+	19	AG
gi|514486632|gb|KE346360.1|	1281277	1281319	A	42	+	42	A
gi|514486632|gb|KE346360.1|	1281563	1281579	A	16	-	16	T
gi|514486632|gb|KE346360.1|	1281768	1281790	A	22	-	22	T
gi|514486632|gb|KE346360.1|	1282097	1282115	AC	18	-	9	TG
gi|514486632|gb|KE346360.1|	1282376	1282400	A	24	-	24	T
gi|514486632|gb|KE346360.1|	1282482	1282505	AAC	23	+	7	CAA
gi|514486632|gb|KE346360.1|	1282835	1282855	AAC	20	+	6	AAC
gi|514486632|gb|KE346360.1|	1283885	1283902	ACC	17	+	5	CCA
gi|514486632|gb|KE346360.1|	1283900	1283917	CCG	17	+	5	CCG
gi|514486632|gb|KE346360.1|	1284236	1284254	AGC	18	+	6	GCA
gi|514486632|gb|KE346360.1|	1284302	1284322	CCG	20	+	6	CCG
gi|514486632|gb|KE346360.1|	1284398	1284412	AGGCGG	14	-	2	CCGCCT
gi|514486632|gb|KE346360.1|	1285654	1285669	A	15	-	15	T
gi|514486632|gb|KE346360.1|	1285713	1285727	AAAAG	14	+	2	AAAAG
gi|514486632|gb|KE346360.1|	1286544	1286570	ACG	26	-	8	CGT
gi|514486632|gb|KE346360.1|	1289039	1289056	AGCG	17	+	4	GAGC
gi|514486632|gb|KE346360.1|	1289071	1289094	AC	23	+	11	CA
gi|514486632|gb|KE346360.1|	1289095	1289109	AC	14	+	7	CA
gi|514486632|gb|KE346360.1|	1289233	1289247	C	14	+	14	C
gi|514486632|gb|KE346360.1|	1289430	1289463	AAAG	33	+	8	AAGA
gi|514486632|gb|KE346360.1|	1289854	1289868	AAAAACC	14	-	2	GTTTTTG
gi|514486632|gb|KE346360.1|	1290310	1290325	AAAAGT	15	-	2	TACTTT
gi|514486632|gb|KE346360.1|	1290724	1290746	ACACAG	22	-	3	TGTGTC
gi|514486632|gb|KE346360.1|	1290747	1290762	ACACAG	15	-	2	CTGTGT
gi|514486632|gb|KE346360.1|	1292947	1292969	A	22	+	22	A
gi|514486632|gb|KE346360.1|	1293409	1293430	AAAACAC	21	-	3	GTGTTTT
gi|514486632|gb|KE346360.1|	1296976	1296990	ATC	14	-	4	TGA
gi|514486632|gb|KE346360.1|	1297067	1297082	AAAAC	15	+	3	AACAA
gi|514486632|gb|KE346360.1|	1297091	1297106	AAAAC	15	+	3	AACAA
gi|514486632|gb|KE346360.1|	1297115	1297130	AAAAC	15	+	3	AACAA
gi|514486632|gb|KE346360.1|	1297139	1297154	AAAAC	15	+	3	AACAA
gi|514486632|gb|KE346360.1|	1300891	1300911	A	20	-	20	T
gi|514486632|gb|KE346360.1|	1301290	1301315	A	25	+	25	A
gi|514486632|gb|KE346360.1|	1302656	1302681	AAC	25	+	8	ACA
gi|514486632|gb|KE346360.1|	1302755	1302769	AAAAAAG	14	+	2	AAGAAAA
gi|514486632|gb|KE346360.1|	1303144	1303254	AAAC	110	+	27	AAAC
gi|514486632|gb|KE346360.1|	1303311	1303326	AAAACAC	15	+	2	ACACAAA
gi|514486632|gb|KE346360.1|	1304192	1304207	AGG	15	+	5	AGG
gi|514486632|gb|KE346360.1|	1304312	1304327	AG	15	+	7	AG
gi|514486632|gb|KE346360.1|	1304744	1304758	AAAAAC	14	+	2	ACAAAA
gi|514486632|gb|KE346360.1|	1304893	1304910	AGATGG	17	+	2	GAGATG
gi|514486632|gb|KE346360.1|	1305290	1305307	A	17	+	17	A
gi|514486632|gb|KE346360.1|	1305403	1305418	ACCCACG	15	+	2	ACCCACG
gi|514486632|gb|KE346360.1|	1305494	1305519	A	25	-	25	T
gi|514486632|gb|KE346360.1|	1307538	1307552	AAAAAC	14	+	2	AACAAA
gi|514486632|gb|KE346360.1|	1307663	1307685	A	22	+	22	A
gi|514486632|gb|KE346360.1|	1307837	1307874	AG	37	+	18	AG
gi|514486632|gb|KE346360.1|	1310172	1310191	AACAGC	19	-	3	GCTGTT
gi|514486632|gb|KE346360.1|	1311318	1311335	AAGCAG	17	+	2	AGAAGC
gi|514486632|gb|KE346360.1|	1312600	1312617	AAG	17	+	5	GAA
gi|514486632|gb|KE346360.1|	1312842	1312856	ACGCCG	14	+	2	CGCCGA
gi|514486632|gb|KE346360.1|	1313074	1313088	AGCCGG	14	+	2	GGAGCC
gi|514486632|gb|KE346360.1|	1313515	1313532	AAC	17	-	5	TGT
gi|514486632|gb|KE346360.1|	1314164	1314179	AAGGGC	15	-	2	CCCTTG
gi|514486632|gb|KE346360.1|	1315066	1315080	AAATCC	14	+	2	AATCCA
gi|514486632|gb|KE346360.1|	1315736	1315752	A	16	+	16	A
gi|514486632|gb|KE346360.1|	1317204	1317219	ACC	15	-	5	GGT
gi|514486632|gb|KE346360.1|	1317259	1317273	AGATC	14	-	2	CTGAT
gi|514486632|gb|KE346360.1|	1317515	1317538	ACCCTG	23	-	3	AGGGTC
gi|514486632|gb|KE346360.1|	1317640	1317654	AGC	14	-	4	TGC
gi|514486632|gb|KE346360.1|	1317655	1317672	AGC	17	-	5	TGC
gi|514486632|gb|KE346360.1|	1318247	1318264	AAC	17	+	5	AAC
gi|514486632|gb|KE346360.1|	1319489	1319504	AAAAC	15	-	3	TTTTG
gi|514486632|gb|KE346360.1|	1321332	1321346	ATC	14	-	4	TGA
gi|514486632|gb|KE346360.1|	1321916	1321937	A	21	-	21	T
gi|514486632|gb|KE346360.1|	1321943	1321963	A	20	-	20	T
gi|514486632|gb|KE346360.1|	1322011	1322025	AGAGGG	14	-	2	TCTCCC
gi|514486632|gb|KE346360.1|	1322396	1322415	ACG	19	+	6	GAC
gi|514486632|gb|KE346360.1|	1322525	1322551	ACCAGC	26	+	4	GCACCA
gi|514486632|gb|KE346360.1|	1322958	1322972	ACGAGG	14	-	2	CTCGTC
gi|514486632|gb|KE346360.1|	1323329	1323348	ATCGC	19	+	3	TCGCA
gi|514486632|gb|KE346360.1|	1324091	1324111	A	20	-	20	T
gi|514486632|gb|KE346360.1|	1325501	1325518	ACGGCG	17	+	2	CGACGG
gi|514486632|gb|KE346360.1|	1326243	1326266	AGC	23	-	7	GCT
gi|514486632|gb|KE346360.1|	1326386	1326405	AC	19	-	9	TG
gi|514486632|gb|KE346360.1|	1329106	1329140	A	34	+	34	A
gi|514486632|gb|KE346360.1|	1329296	1329313	AAAAATC	17	-	2	TTTGATT
gi|514486632|gb|KE346360.1|	1329663	1329679	AGC	16	+	5	CAG
gi|514486632|gb|KE346360.1|	1329885	1329902	AGC	17	+	5	CAG
gi|514486632|gb|KE346360.1|	1329921	1329947	AACAGC	26	+	4	CAGCAA
gi|514486632|gb|KE346360.1|	1330077	1330091	AGC	14	+	4	CAG
gi|514486632|gb|KE346360.1|	1330086	1330112	AACAGC	26	+	4	CAGCAA
gi|514486632|gb|KE346360.1|	1330113	1330130	AACAGC	17	+	2	CAACAG
gi|514486632|gb|KE346360.1|	1330142	1330159	AGC	17	+	5	GCA
gi|514486632|gb|KE346360.1|	1330416	1330436	AAC	20	+	6	CAA
gi|514486632|gb|KE346360.1|	1331794	1331814	A	20	-	20	T
gi|514486632|gb|KE346360.1|	1332492	1332506	AAATCTC	14	-	2	TTGAGAT
gi|514486632|gb|KE346360.1|	1332521	1332546	AGG	25	-	8	CTC
gi|514486632|gb|KE346360.1|	1332818	1332838	AGG	20	-	6	TCC
gi|514486632|gb|KE346360.1|	1332836	1332853	AAGACG	17	-	2	TCGTCT
gi|514486632|gb|KE346360.1|	1333113	1333132	AAC	19	+	6	CAA
gi|514486632|gb|KE346360.1|	1333473	1333646	AAAC	173	+	43	ACAA
gi|514486632|gb|KE346360.1|	1334123	1334140	AAAAAC	17	+	2	CAAAAA
gi|514486632|gb|KE346360.1|	1334136	1334150	AAAAAAC	14	+	2	AAAACAA
gi|514486632|gb|KE346360.1|	1335016	1335035	ACATCGC	19	+	2	GCACATC
gi|514486632|gb|KE346360.1|	1335182	1335197	ACTGCC	15	-	2	TGGCAG
gi|514486632|gb|KE346360.1|	1335326	1335340	AACAAGC	14	+	2	GCAACAA
gi|514486632|gb|KE346360.1|	1335596	1335610	AAAAG	14	-	2	TTTTC
gi|514486632|gb|KE346360.1|	1335689	1335712	A	23	-	23	T
gi|514486632|gb|KE346360.1|	1336074	1336095	A	21	+	21	A
gi|514486632|gb|KE346360.1|	1336749	1336763	A	14	-	14	T
gi|514486632|gb|KE346360.1|	1340933	1340948	AAAAAC	15	-	2	TTTTTG
gi|514486632|gb|KE346360.1|	1340941	1341127	AAAC	186	-	46	TTTG
gi|514486632|gb|KE346360.1|	1341128	1341180	AAAC	52	-	13	GTTT
gi|514486632|gb|KE346360.1|	1341539	1341553	ACG	14	-	4	GTC
gi|514486632|gb|KE346360.1|	1341795	1341810	AAAC	15	-	3	TTTG
gi|514486632|gb|KE346360.1|	1342836	1342851	AAAAC	15	+	3	AAAAC
gi|514486632|gb|KE346360.1|	1343807	1343824	AGC	17	+	5	CAG
gi|514486632|gb|KE346360.1|	1344570	1344586	AATG	16	+	4	TGAA
gi|514486632|gb|KE346360.1|	1345455	1345472	AAGGAC	17	-	2	TGTCCT
gi|514486632|gb|KE346360.1|	1345489	1345503	AAGGAC	14	-	2	CTTGTC
gi|514486632|gb|KE346360.1|	1346038	1346057	ATC	19	+	6	CAT
gi|514486632|gb|KE346360.1|	1346055	1346069	ACG	14	-	4	TCG
gi|514486632|gb|KE346360.1|	1346233	1346259	AAGCAG	26	-	4	CTGCTT
gi|514486632|gb|KE346360.1|	1347715	1347738	A	23	-	23	T
gi|514486632|gb|KE346360.1|	1348109	1348131	AAC	22	-	7	TTG
gi|514486632|gb|KE346360.1|	1348168	1348182	A	14	-	14	T
gi|514486632|gb|KE346360.1|	1348397	1348417	A	20	+	20	A
gi|514486632|gb|KE346360.1|	1348505	1348521	ACG	16	+	5	ACG
gi|514486632|gb|KE346360.1|	1348534	1348551	AGCATC	17	-	2	TGCTGA
gi|514486632|gb|KE346360.1|	1348658	1348673	AG	15	-	7	CT
gi|514486632|gb|KE346360.1|	1348709	1348727	AACG	18	-	4	GTTC
gi|514486632|gb|KE346360.1|	1348779	1348793	ACTC	14	+	3	ACTC
gi|514486632|gb|KE346360.1|	1353894	1353908	AAAAG	14	+	2	AAAAG
gi|514486632|gb|KE346360.1|	1354774	1354796	A	22	-	22	T
gi|514486632|gb|KE346360.1|	1354790	1354804	AAAAAAC	14	-	2	TTTTTTG
gi|514486632|gb|KE346360.1|	1354888	1354907	AG	19	+	9	GA
gi|514486632|gb|KE346360.1|	1355779	1355916	AC	137	-	68	TG
gi|514486632|gb|KE346360.1|	1356863	1356877	ACAT	14	-	3	GTAT
gi|514486632|gb|KE346360.1|	1357122	1357136	ACTGATG	14	+	2	TGACTGA
gi|514486632|gb|KE346360.1|	1357139	1357164	AACTG	25	+	5	GAACT
gi|514486632|gb|KE346360.1|	1357409	1357424	AATTCG	15	+	2	TCGAAT
gi|514486632|gb|KE346360.1|	1358566	1358593	AAAC	27	-	6	TTTG
gi|514486632|gb|KE346360.1|	1358589	1358605	AAAACC	16	-	2	GTTTTG
gi|514486632|gb|KE346360.1|	1358598	1358622	AAACC	24	-	4	TTGGT
gi|514486632|gb|KE346360.1|	1360297	1360313	A	16	-	16	T
gi|514486632|gb|KE346360.1|	1360855	1360872	AGGGGC	17	+	2	GCAGGG
gi|514486632|gb|KE346360.1|	1360913	1360938	ATC	25	+	8	CAT
gi|514486632|gb|KE346360.1|	1360937	1360953	AGC	16	-	5	CTG
gi|514486632|gb|KE346360.1|	1361047	1361061	AGCGGGC	14	+	2	GCAGCGG
gi|514486632|gb|KE346360.1|	1364390	1364404	AGC	14	-	4	GCT
gi|514486632|gb|KE346360.1|	1365352	1365366	CCCCCG	14	-	2	GGCGGG
gi|514486632|gb|KE346360.1|	1365492	1365509	AAAAAAC	17	-	2	TTTGTTT
gi|514486632|gb|KE346360.1|	1366061	1366077	AAAC	16	-	4	TTGT
gi|514486632|gb|KE346360.1|	1366839	1366856	AAAAC	17	+	3	AACAA
gi|514486632|gb|KE346360.1|	1367139	1367154	AAAC	15	+	3	AAAC
gi|514486632|gb|KE346360.1|	1368205	1368222	AAAAAC	17	-	2	TTTTTG
gi|514486632|gb|KE346360.1|	1368602	1368619	A	17	+	17	A
gi|514486632|gb|KE346360.1|	1369047	1369064	CCG	17	-	5	GCG
gi|514486632|gb|KE346360.1|	1369330	1369350	AGC	20	+	6	GCA
gi|514486632|gb|KE346360.1|	1370604	1370623	A	19	-	19	T
gi|514486632|gb|KE346360.1|	1370641	1370656	AAAC	15	-	3	TTTG
gi|514486632|gb|KE346360.1|	1370665	1370681	AAG	16	-	5	CTT
gi|514486632|gb|KE346360.1|	1370791	1370808	A	17	+	17	A
gi|514486632|gb|KE346360.1|	1370825	1370847	A	22	+	22	A
gi|514486632|gb|KE346360.1|	1371036	1371050	AAAAACC	14	-	2	GGTTTTT
gi|514486632|gb|KE346360.1|	1371051	1371070	AAAAC	19	-	3	TTTTG
gi|514486632|gb|KE346360.1|	1371176	1371190	AACAGC	14	+	2	CAACAG
gi|514486632|gb|KE346360.1|	1371313	1371327	AAAAAAT	14	+	2	AAAATAA
gi|514486632|gb|KE346360.1|	1371328	1371343	AAAAAT	15	+	2	AAATAA
gi|514486632|gb|KE346360.1|	1371352	1371366	AAAAGC	14	-	2	CTTTTG
gi|514486632|gb|KE346360.1|	1371476	1371490	AGCGGC	14	-	2	CCGCTG
gi|514486632|gb|KE346360.1|	1371531	1371550	AAAAAAG	19	+	2	AAAAAGA
gi|514486632|gb|KE346360.1|	1371593	1371612	AAAAGGG	19	+	2	GAAAAGG
gi|514486632|gb|KE346360.1|	1371741	1371771	A	30	+	30	A
gi|514486632|gb|KE346360.1|	1371932	1371947	AAAAAGC	15	+	2	AGCAAAA
gi|514486632|gb|KE346360.1|	1371942	1371964	A	22	+	22	A
gi|514486632|gb|KE346360.1|	1371975	1371997	A	22	+	22	A
gi|514486632|gb|KE346360.1|	1372277	1372291	AACAAT	14	+	2	CAATAA
gi|514486632|gb|KE346360.1|	1372865	1372888	A	23	+	23	A
gi|514486632|gb|KE346360.1|	1372889	1372906	AAAC	17	+	4	CAAA
gi|514486632|gb|KE346360.1|	1374045	1374063	AAAAGG	18	-	3	TTCCTT
gi|514486632|gb|KE346360.1|	1374469	1374486	AGG	17	-	5	TCC
gi|514486632|gb|KE346360.1|	1375226	1375247	AGC	21	-	7	CTG
gi|514486632|gb|KE346360.1|	1376469	1376486	A	17	+	17	A
gi|514486632|gb|KE346360.1|	1379573	1379587	A	14	+	14	A
gi|514486632|gb|KE346360.1|	1380651	1380668	AACAAGC	17	+	2	AACAAGC
gi|514486632|gb|KE346360.1|	1381126	1381145	AGC	19	+	6	GCA
gi|514486632|gb|KE346360.1|	1381400	1381418	ATC	18	-	6	ATG
gi|514486632|gb|KE346360.1|	1381498	1381523	A	25	-	25	T
gi|514486632|gb|KE346360.1|	1381563	1381593	AATC	30	-	7	GATT
gi|514486632|gb|KE346360.1|	1382008	1382028	AAC	20	+	6	CAA
gi|514486632|gb|KE346360.1|	1382183	1382210	AATCTG	27	+	4	GAATCT
gi|514486632|gb|KE346360.1|	1382212	1382231	AATCTC	19	+	3	TCAATC
gi|514486632|gb|KE346360.1|	1384754	1384772	AAC	18	-	6	TTG
gi|514486632|gb|KE346360.1|	1384784	1384799	AAC	15	-	5	TTG
gi|514486632|gb|KE346360.1|	1384815	1384835	AAC	20	-	6	TGT
gi|514486632|gb|KE346360.1|	1385421	1385435	AACAGGC	14	+	2	CAACAGG
gi|514486632|gb|KE346360.1|	1385711	1385769	A	58	+	58	A
gi|514486632|gb|KE346360.1|	1389212	1389227	ACCACCC	15	-	2	GGTGGTG
gi|514486632|gb|KE346360.1|	1389455	1389477	A	22	+	22	A
gi|514486632|gb|KE346360.1|	1389893	1389933	A	40	+	40	A
gi|514486632|gb|KE346360.1|	1390980	1390994	CCG	14	-	4	CGG
gi|514486632|gb|KE346360.1|	1391395	1391414	AAC	19	+	6	AAC
gi|514486632|gb|KE346360.1|	1392903	1392921	AAC	18	-	6	TTG
gi|514486632|gb|KE346360.1|	1395753	1395768	AGC	15	+	5	AGC
gi|514486632|gb|KE346360.1|	1395935	1395950	AAAAC	15	-	3	TGTTT
gi|514486632|gb|KE346360.1|	1395943	1395958	AAAC	15	-	3	TTTG
gi|514486632|gb|KE346360.1|	1395951	1395968	AAAAC	17	-	3	TTTGT
gi|514486632|gb|KE346360.1|	1396048	1396066	A	18	+	18	A
gi|514486632|gb|KE346360.1|	1396109	1396132	AAAATC	23	-	3	ATTTTG
gi|514486632|gb|KE346360.1|	1396125	1396139	AAAAATC	14	-	2	TGATTTT
gi|514486632|gb|KE346360.1|	1396132	1396151	AAAATC	19	-	3	TGATTT
gi|514486632|gb|KE346360.1|	1396256	1396271	AACTG	15	+	3	TGAAC
gi|514486632|gb|KE346360.1|	1396386	1396403	AGC	17	-	5	TGC
gi|514486632|gb|KE346360.1|	1396585	1396599	AAATCTC	14	+	2	AATCTCA
gi|514486632|gb|KE346360.1|	1397331	1397350	AAC	19	-	6	TTG
gi|514486632|gb|KE346360.1|	1397889	1397908	AAAC	19	-	4	TTGT
gi|514486632|gb|KE346360.1|	1397909	1397935	AAAC	26	-	6	TGTT
gi|514486632|gb|KE346360.1|	1398399	1398414	AAC	15	+	5	CAA
gi|514486632|gb|KE346360.1|	1399827	1399846	A	19	-	19	T
gi|514486632|gb|KE346360.1|	1400214	1400231	A	17	+	17	A
gi|514486632|gb|KE346360.1|	1400629	1400654	A	25	+	25	A
gi|514486632|gb|KE346360.1|	1400857	1400874	A	17	-	17	T
gi|514486632|gb|KE346360.1|	1400978	1400996	A	18	+	18	A
gi|514486632|gb|KE346360.1|	1402215	1402235	AAAG	20	-	5	TCTT
gi|514486632|gb|KE346360.1|	1402688	1402708	AGC	20	-	6	TGC
gi|514486632|gb|KE346360.1|	1403435	1403452	A	17	-	17	T
gi|514486632|gb|KE346360.1|	1403449	1403476	AAAC	27	-	6	TTTG
gi|514486632|gb|KE346360.1|	1404265	1404282	A	17	-	17	T
gi|514486632|gb|KE346360.1|	1404773	1404787	AGCAGCG	14	-	2	CGCTGCT
gi|514486632|gb|KE346360.1|	1405697	1405714	AAAC	17	-	4	TTTG
gi|514486632|gb|KE346360.1|	1405713	1405761	AAAC	48	-	12	TGTT
gi|514486632|gb|KE346360.1|	1405786	1405800	ACTCCTC	14	+	2	CTCACTC
gi|514486632|gb|KE346360.1|	1406571	1406586	AAAAGGC	15	-	2	CTTTTGC
gi|514486632|gb|KE346360.1|	1406776	1406790	AAAAG	14	-	2	TTTTC
gi|514486632|gb|KE346360.1|	1406969	1406984	AAAACCG	15	+	2	CCGAAAA
gi|514486632|gb|KE346360.1|	1407146	1407166	CCG	20	+	6	CCG
gi|514486632|gb|KE346360.1|	1407161	1407175	AGGCGG	14	-	2	CCGCCT
gi|514486632|gb|KE346360.1|	1407682	1407707	ACCGCG	25	-	4	GCGGTC
gi|514486632|gb|KE346360.1|	1407895	1407911	AGC	16	-	5	GCT
gi|514486632|gb|KE346360.1|	1408744	1408764	AGC	20	+	6	GCA
gi|514486632|gb|KE346360.1|	1410919	1410941	ACC	22	-	7	GTG
gi|514486632|gb|KE346360.1|	1411780	1411798	AGC	18	-	6	TGC
gi|514486632|gb|KE346360.1|	1411831	1411851	AGC	20	-	6	TGC
gi|514486632|gb|KE346360.1|	1411855	1411869	AGC	14	-	4	TGC
gi|514486632|gb|KE346360.1|	1412106	1412128	A	22	+	22	A
gi|514486632|gb|KE346360.1|	1412233	1412253	AATG	20	+	5	TGAA
gi|514486632|gb|KE346360.1|	1413399	1413420	A	21	-	21	T
gi|514486632|gb|KE346360.1|	1413576	1413590	AAAC	14	-	3	TGTT
gi|514486632|gb|KE346360.1|	1413756	1413770	AAAGTTG	14	-	2	TTTCAAC
gi|514486632|gb|KE346360.1|	1414715	1414729	AAAAAC	14	-	2	TTTGTT
gi|514486632|gb|KE346360.1|	1415339	1415354	AAAAAC	15	-	2	TTTTTG
gi|514486632|gb|KE346360.1|	1418622	1418638	ACATG	16	+	3	ATGAC
gi|514486632|gb|KE346360.1|	1418917	1418933	AAAC	16	-	4	GTTT
gi|514486632|gb|KE346360.1|	1418930	1418945	A	15	-	15	T
gi|514486632|gb|KE346360.1|	1419416	1419430	A	14	+	14	A
gi|514486632|gb|KE346360.1|	1419583	1419618	AGG	35	+	11	GAG
gi|514486632|gb|KE346360.1|	1420293	1420320	A	27	-	27	T
gi|514486632|gb|KE346360.1|	1420570	1420584	ACTC	14	+	3	CTCA
gi|514486632|gb|KE346360.1|	1420587	1420619	AAGTG	32	-	6	CTTCA
gi|514486632|gb|KE346360.1|	1421340	1421358	AAAAAAT	18	+	2	AAAAAAT
gi|514486632|gb|KE346360.1|	1423751	1423765	AAAAC	14	+	2	AAAAC
gi|514486632|gb|KE346360.1|	1427750	1427768	AAT	18	-	6	TTA
gi|514486632|gb|KE346360.1|	1428035	1428050	A	15	-	15	T
gi|514486632|gb|KE346360.1|	1428254	1428268	A	14	-	14	T
gi|514486632|gb|KE346360.1|	1428506	1428520	A	14	-	14	T
gi|514486632|gb|KE346360.1|	1428764	1428782	A	18	-	18	T
gi|514486632|gb|KE346360.1|	1428975	1428990	A	15	+	15	A
gi|514486632|gb|KE346360.1|	1429028	1429044	A	16	+	16	A
gi|514486632|gb|KE346360.1|	1429787	1429809	AGCG	22	-	5	TCGC
gi|514486632|gb|KE346360.1|	1431603	1431620	AAGC	17	+	4	AAGC
gi|514486632|gb|KE346360.1|	1432296	1432322	AAAC	26	+	6	AACA
gi|514486632|gb|KE346360.1|	1432329	1432344	AAAC	15	+	3	AAAC
gi|514486632|gb|KE346360.1|	1433746	1433768	A	22	+	22	A
gi|514486632|gb|KE346360.1|	1433818	1433841	A	23	+	23	A
gi|514486632|gb|KE346360.1|	1434200	1434214	AAAT	14	+	3	AATA
gi|514486632|gb|KE346360.1|	1434241	1434269	A	28	+	28	A
gi|514486632|gb|KE346360.1|	1434314	1434338	A	24	-	24	T
gi|514486632|gb|KE346360.1|	1435005	1435026	ACCGCG	21	-	3	GTCGCG
gi|514486632|gb|KE346360.1|	1436162	1436177	ACACC	15	+	3	CACAC
gi|514486632|gb|KE346360.1|	1437585	1437602	AATGCC	17	-	2	TGGCAT
gi|514486632|gb|KE346360.1|	1437706	1437720	ATC	14	+	4	TCA
gi|514486632|gb|KE346360.1|	1437779	1437804	AGC	25	+	8	AGC
gi|514486632|gb|KE346360.1|	1440570	1440586	A	16	-	16	T
gi|514486632|gb|KE346360.1|	1440588	1440602	A	14	-	14	T
gi|514486632|gb|KE346360.1|	1440631	1440645	AAAAGG	14	-	2	CTTTTC
gi|514486632|gb|KE346360.1|	1443181	1443200	AAC	19	+	6	AAC
gi|514486632|gb|KE346360.1|	1443311	1443335	A	24	-	24	T
gi|514486632|gb|KE346360.1|	1443569	1443588	A	19	-	19	T
gi|514486632|gb|KE346360.1|	1443708	1443725	ACG	17	-	5	CGT
gi|514486632|gb|KE346360.1|	1443868	1443882	ACT	14	-	4	TAG
gi|514486632|gb|KE346360.1|	1443908	1443924	ACTATG	16	-	2	AGTCAT
gi|514486632|gb|KE346360.1|	1443953	1443970	AGC	17	+	5	AGC
gi|514486632|gb|KE346360.1|	1444382	1444408	AAAGAC	26	-	4	TCTTTG
gi|514486632|gb|KE346360.1|	1444462	1444476	AACCAC	14	+	2	CAACCA
gi|514486632|gb|KE346360.1|	1444612	1444626	ACC	14	+	4	CAC
gi|514486632|gb|KE346360.1|	1444621	1444644	ACCAGC	23	+	3	CACCAG
gi|514486632|gb|KE346360.1|	1445996	1446011	ACTCGG	15	+	2	GACTCG
gi|514486632|gb|KE346360.1|	1446030	1446044	ATCGCC	14	+	2	CGCCAT
gi|514486632|gb|KE346360.1|	1446059	1446074	AAGGAG	15	-	2	TTCTCC
gi|514486632|gb|KE346360.1|	1447222	1447237	AGCGCCC	15	-	2	CTGGGCG
gi|514486632|gb|KE346360.1|	1447508	1447524	AAAAAAC	16	-	2	TTTTGTT
gi|514486632|gb|KE346360.1|	1447582	1447626	AC	44	-	22	TG
gi|514486632|gb|KE346360.1|	1447652	1447667	AAAGAG	15	-	2	TTTCTC
gi|514486632|gb|KE346360.1|	1448117	1448141	A	24	-	24	T
gi|514486632|gb|KE346360.1|	1448332	1448367	A	35	-	35	T
gi|514486632|gb|KE346360.1|	1448362	1448376	AAAAACG	14	-	2	TTTTTCG
gi|514486632|gb|KE346360.1|	1448750	1448764	AAG	14	+	4	AAG
gi|514486632|gb|KE346360.1|	1449807	1449822	AAAAAAC	15	-	2	TTTGTTT
gi|514486632|gb|KE346360.1|	1450267	1450284	A	17	-	17	T
gi|514486632|gb|KE346360.1|	1451339	1451354	AAC	15	-	5	GTT
gi|514486632|gb|KE346360.1|	1455466	1455487	A	21	-	21	T
gi|514486632|gb|KE346360.1|	1455484	1455498	AAACATC	14	-	2	TTTGATG
gi|514486632|gb|KE346360.1|	1455829	1455854	A	25	-	25	T
gi|514486632|gb|KE346360.1|	1456165	1456185	A	20	-	20	T
gi|514486632|gb|KE346360.1|	1457811	1457827	AGG	16	+	5	GAG
gi|514486632|gb|KE346360.1|	1458339	1458356	AGCGGC	17	-	2	GCCGCT
gi|514486632|gb|KE346360.1|	1458402	1458418	ACGATG	16	+	2	GACGAT
gi|514486632|gb|KE346360.1|	1458756	1458770	AGC	14	+	4	GCA
gi|514486632|gb|KE346360.1|	1458939	1458955	AAG	16	+	5	AAG
gi|514486632|gb|KE346360.1|	1459903	1459917	AC	14	-	7	GT
gi|514486632|gb|KE346360.1|	1461637	1461655	A	18	+	18	A
gi|514486632|gb|KE346360.1|	1463816	1463830	AAAAAC	14	+	2	AAAAAC
gi|514486632|gb|KE346360.1|	1464747	1464762	ACGTCC	15	+	2	CCACGT
gi|514486632|gb|KE346360.1|	1465599	1465619	AAC	20	+	6	CAA
gi|514486632|gb|KE346360.1|	1466964	1466978	AAGTGC	14	+	2	AAGTGC
gi|514486632|gb|KE346360.1|	1466997	1467015	ACAGTC	18	+	3	CACAGT
gi|514486632|gb|KE346360.1|	1467333	1467360	A	27	+	27	A
gi|514486632|gb|KE346360.1|	1467426	1467440	AACAGC	14	-	2	TTGCTG
gi|514486632|gb|KE346360.1|	1467721	1467737	AAG	16	+	5	AGA
gi|514486632|gb|KE346360.1|	1467748	1467762	AAAAAG	14	+	2	AAAAAG
gi|514486632|gb|KE346360.1|	1467970	1467987	A	17	+	17	A
gi|514486632|gb|KE346360.1|	1468101	1468118	ACTCC	17	-	3	GGAGT
gi|514486632|gb|KE346360.1|	1468276	1468290	A	14	+	14	A
gi|514486632|gb|KE346360.1|	1468531	1468554	A	23	+	23	A
gi|514486632|gb|KE346360.1|	1468985	1469018	AG	33	-	16	CT
gi|514486632|gb|KE346360.1|	1470030	1470048	ACGAGC	18	+	3	CGAGCA
gi|514486632|gb|KE346360.1|	1476814	1476830	CCCCCG	16	+	2	CCCGCC
gi|514486632|gb|KE346360.1|	1476956	1476970	AACCTC	14	+	2	TCAACC
gi|514486632|gb|KE346360.1|	1477002	1477024	AGC	22	-	7	TGC
gi|514486632|gb|KE346360.1|	1477458	1477472	ACCACG	14	-	2	GTGGTC
gi|514486632|gb|KE346360.1|	1480521	1480535	ACCATC	14	+	2	CACCAT
gi|514486632|gb|KE346360.1|	1480533	1480550	AGC	17	+	5	CAG
gi|514486632|gb|KE346360.1|	1480791	1480810	AC	19	-	9	TG
gi|514486632|gb|KE346360.1|	1480915	1480931	AGC	16	+	5	CAG
gi|514486632|gb|KE346360.1|	1480952	1480996	AGC	44	-	14	CTG
gi|514486632|gb|KE346360.1|	1482970	1482984	AGG	14	+	4	AGG
gi|514486632|gb|KE346360.1|	1483112	1483133	AGG	21	+	7	GGA
gi|514486632|gb|KE346360.1|	1485025	1485048	AGC	23	+	7	CAG
gi|514486632|gb|KE346360.1|	1485510	1485536	A	26	-	26	T
gi|514486632|gb|KE346360.1|	1485749	1485773	A	24	-	24	T
gi|514486632|gb|KE346360.1|	1486102	1486118	A	16	+	16	A
gi|514486632|gb|KE346360.1|	1486123	1486142	A	19	+	19	A
gi|514486632|gb|KE346360.1|	1486311	1486331	A	20	-	20	T
gi|514486632|gb|KE346360.1|	1488009	1488023	AACATC	14	+	2	CAACAT
gi|514486632|gb|KE346360.1|	1488090	1488110	AACAGC	20	+	3	CAGCAA
gi|514486632|gb|KE346360.1|	1489046	1489068	AGC	22	+	7	CAG
gi|514486632|gb|KE346360.1|	1490243	1490268	A	25	+	25	A
gi|514486632|gb|KE346360.1|	1490762	1490780	A	18	-	18	T
gi|514486632|gb|KE346360.1|	1490997	1491018	A	21	-	21	T
gi|514486632|gb|KE346360.1|	1491274	1491297	A	23	-	23	T
gi|514486632|gb|KE346360.1|	1491303	1491317	AAAAATG	14	-	2	TTTTTCA
gi|514486632|gb|KE346360.1|	1497202	1497216	AAAAAG	14	-	2	TTTTCT
gi|514486632|gb|KE346360.1|	1501011	1501044	A	33	+	33	A
gi|514486632|gb|KE346360.1|	1502163	1502184	AGC	21	-	7	CTG
gi|514486632|gb|KE346360.1|	1502206	1502222	ACG	16	+	5	GAC
gi|514486632|gb|KE346360.1|	1503392	1503413	ACG	21	-	7	TCG
gi|514486632|gb|KE346360.1|	1503612	1503629	ACGGCG	17	-	2	CGCCGT
gi|514486632|gb|KE346360.1|	1503946	1503960	AAACGCG	14	-	2	TTCGCGT
gi|514486632|gb|KE346360.1|	1504140	1504154	AAC	14	-	4	TTG
gi|514486632|gb|KE346360.1|	1504160	1504174	AAAAC	14	-	2	TTTTG
gi|514486632|gb|KE346360.1|	1504173	1504187	AAAAC	14	-	2	TTTTG
gi|514486632|gb|KE346360.1|	1505121	1505142	ATC	21	+	7	CAT
gi|514486632|gb|KE346360.1|	1505144	1505163	ATC	19	+	6	TCA
gi|514486632|gb|KE346360.1|	1506256	1506271	ACC	15	+	5	CAC
gi|514486632|gb|KE346360.1|	1506833	1506848	AAT	15	-	5	ATT
gi|514486632|gb|KE346360.1|	1507463	1507478	AAAAG	15	+	3	AAAAG
gi|514486632|gb|KE346360.1|	1508899	1508925	AG	26	+	13	GA
gi|514486632|gb|KE346360.1|	1509128	1509143	AAAC	15	+	3	AAAC
gi|514486632|gb|KE346360.1|	1512581	1512607	AG	26	-	13	CT
gi|514486632|gb|KE346360.1|	1512892	1512907	A	15	+	15	A
gi|514486632|gb|KE346360.1|	1513182	1513196	AACC	14	-	3	GTTG
gi|514486632|gb|KE346360.1|	1514676	1514690	ACCCC	14	+	2	CCCCA
gi|514486632|gb|KE346360.1|	1514707	1514723	ACAGCC	16	+	2	CCACAG
gi|514486632|gb|KE346360.1|	1514742	1514759	AGCG	17	+	4	CGAG
gi|514486632|gb|KE346360.1|	1514762	1514776	A	14	+	14	A
gi|514486632|gb|KE346360.1|	1514934	1514954	A	20	+	20	A
gi|514486632|gb|KE346360.1|	1514956	1514976	A	20	+	20	A
gi|514486632|gb|KE346360.1|	1516256	1516274	AGG	18	-	6	CCT
gi|514486632|gb|KE346360.1|	1516668	1516686	A	18	-	18	T
gi|514486632|gb|KE346360.1|	1516850	1516864	AAAAATG	14	-	2	TTTTTCA
gi|514486632|gb|KE346360.1|	1519815	1519848	AGC	33	+	11	AGC
gi|514486632|gb|KE346360.1|	1520203	1520217	AGC	14	+	4	GCA
gi|514486632|gb|KE346360.1|	1520224	1520239	CCG	15	-	5	GCG
gi|514486632|gb|KE346360.1|	1520272	1520287	AGC	15	+	5	GCA
gi|514486632|gb|KE346360.1|	1521292	1521307	ACGCGG	15	+	2	GACGCG
gi|514486632|gb|KE346360.1|	1522659	1522684	A	25	+	25	A
gi|514486632|gb|KE346360.1|	1523447	1523468	ATC	21	-	7	TGA
gi|514486632|gb|KE346360.1|	1523466	1523485	ACG	19	+	6	GAC
gi|514486632|gb|KE346360.1|	1523863	1523878	AAGGGC	15	-	2	CTTGCC
gi|514486632|gb|KE346360.1|	1525375	1525389	AGCAGCG	14	+	2	GCGAGCA
gi|514486632|gb|KE346360.1|	1525608	1525624	AGCGGC	16	+	2	CAGCGG
gi|514486632|gb|KE346360.1|	1525754	1525770	ACTAGC	16	-	2	TGCTAG
gi|514486632|gb|KE346360.1|	1525903	1525933	A	30	+	30	A
gi|514486632|gb|KE346360.1|	1525954	1525968	A	14	+	14	A
gi|514486632|gb|KE346360.1|	1526294	1526309	A	15	+	15	A
gi|514486632|gb|KE346360.1|	1526385	1526402	AAAC	17	-	4	GTTT
gi|514486632|gb|KE346360.1|	1526399	1526416	AAGC	17	-	4	TTGC
gi|514486632|gb|KE346360.1|	1527155	1527169	AGAGCG	14	-	2	TCTCGC
gi|514486632|gb|KE346360.1|	1527164	1527183	AGCGCG	19	-	3	CGCTCG
gi|514486632|gb|KE346360.1|	1527228	1527242	AG	14	+	7	AG
gi|514486632|gb|KE346360.1|	1527241	1527261	AC	20	-	10	GT
gi|514486632|gb|KE346360.1|	1528479	1528494	AAGCAGC	15	-	2	CTTGCTG
gi|514486632|gb|KE346360.1|	1531219	1531240	ACGCAG	21	+	3	GCAGAC
gi|514486632|gb|KE346360.1|	1531288	1531304	ACG	16	+	5	GAC
gi|514486632|gb|KE346360.1|	1531322	1531336	AGC	14	+	4	CAG
gi|514486632|gb|KE346360.1|	1536570	1536597	A	27	+	27	A
gi|514486632|gb|KE346360.1|	1536981	1537004	A	23	-	23	T
gi|514486632|gb|KE346360.1|	1537401	1537415	AGG	14	-	4	TCC
gi|514486632|gb|KE346360.1|	1537431	1537454	ACG	23	-	7	TCG
gi|514486632|gb|KE346360.1|	1537449	1537472	AAGACG	23	-	3	TCGTCT
gi|514486632|gb|KE346360.1|	1539795	1539814	A	19	+	19	A
gi|514486632|gb|KE346360.1|	1540111	1540130	AGC	19	+	6	GCA
gi|514486632|gb|KE346360.1|	1540248	1540272	AAGGAC	24	-	4	CTTGTC
gi|514486632|gb|KE346360.1|	1543187	1543208	AAAC	21	-	5	TGTT
gi|514486632|gb|KE346360.1|	1546130	1546194	AG	64	+	32	GA
gi|514486632|gb|KE346360.1|	1546563	1546580	AAAAAGG	17	-	2	TTTCCTT
gi|514486632|gb|KE346360.1|	1547523	1547540	AATGCC	17	+	2	TGCCAA
gi|514486632|gb|KE346360.1|	1548043	1548061	A	18	+	18	A
gi|514486632|gb|KE346360.1|	1548252	1548268	A	16	+	16	A
gi|514486632|gb|KE346360.1|	1548718	1548735	AAAGAAG	17	+	2	GAAAGAA
gi|514486632|gb|KE346360.1|	1548749	1548766	AATG	17	+	4	TGAA
gi|514486632|gb|KE346360.1|	1549233	1549258	AGC	25	+	8	AGC
gi|514486632|gb|KE346360.1|	1549315	1549333	ACG	18	+	6	ACG
gi|514486632|gb|KE346360.1|	1550939	1550958	AG	19	-	9	CT
gi|514486632|gb|KE346360.1|	1550978	1551060	AC	82	+	41	CA
gi|514486632|gb|KE346360.1|	1551053	1551067	AACACAC	14	+	2	ACACACA
gi|514486632|gb|KE346360.1|	1551060	1551082	AC	22	+	11	AC
gi|514486632|gb|KE346360.1|	1553242	1553256	ACG	14	-	4	TCG
gi|514486632|gb|KE346360.1|	1553363	1553379	AGCGGG	16	+	2	GAGCGG
gi|514486632|gb|KE346360.1|	1553982	1554008	AGC	26	+	8	AGC
gi|514486632|gb|KE346360.1|	1554216	1554230	AAAAG	14	+	2	AAAAG
gi|514486632|gb|KE346360.1|	1554223	1554237	AAAAAG	14	+	2	AAGAAA
gi|514486632|gb|KE346360.1|	1554883	1554899	A	16	+	16	A
gi|514486632|gb|KE346360.1|	1554913	1554927	AACAGG	14	+	2	AACAGG
gi|514486632|gb|KE346360.1|	1555848	1555862	A	14	+	14	A
gi|514486632|gb|KE346360.1|	1560967	1560990	AAC	23	+	7	AAC
gi|514486632|gb|KE346360.1|	1561300	1561329	A	29	-	29	T
gi|514486632|gb|KE346360.1|	1561494	1561518	A	24	-	24	T
gi|514486632|gb|KE346360.1|	1561701	1561715	ACCGCGC	14	-	2	GCGGTGC
gi|514486632|gb|KE346360.1|	1561989	1562003	AAAGAAC	14	-	2	TTGTTCT
gi|514486632|gb|KE346360.1|	1562185	1562200	AAAGAAC	15	-	2	TTCTTTG
gi|514486632|gb|KE346360.1|	1562793	1562810	CCG	17	+	5	CCG
gi|514486632|gb|KE346360.1|	1563071	1563088	AGC	17	-	5	GCT
gi|514486632|gb|KE346360.1|	1563086	1563100	CCG	14	+	4	GCC
gi|514486632|gb|KE346360.1|	1563348	1563371	ACC	23	+	7	CCA
gi|514486632|gb|KE346360.1|	1563644	1563658	AGCGGC	14	-	2	GCCGCT
gi|514486632|gb|KE346360.1|	1563830	1563844	AGC	14	+	4	CAG
gi|514486632|gb|KE346360.1|	1563854	1563868	AGC	14	+	4	CAG
gi|514486632|gb|KE346360.1|	1564138	1564153	AGC	15	+	5	GCA
gi|514486632|gb|KE346360.1|	1564453	1564467	ACCCCT	14	+	2	CTACCC
gi|514486632|gb|KE346360.1|	1564742	1564757	AGGGCC	15	+	2	CAGGGC
gi|514486632|gb|KE346360.1|	1564766	1564784	ACTGCG	18	-	3	TCGCAG
gi|514486632|gb|KE346360.1|	1564784	1564801	AACAGC	17	+	2	CAGCAA
gi|514486632|gb|KE346360.1|	1565146	1565160	AAAAC	14	+	2	AAAAC
gi|514486632|gb|KE346360.1|	1565630	1565644	AGAGCG	14	+	2	CGAGAG
gi|514486632|gb|KE346360.1|	1566537	1566558	A	21	-	21	T
gi|514486632|gb|KE346360.1|	1567454	1567480	AAAAAAC	26	+	3	AAAAACA
gi|514486632|gb|KE346360.1|	1569291	1569309	A	18	-	18	T
gi|514486632|gb|KE346360.1|	1569652	1569676	A	24	+	24	A
gi|514486632|gb|KE346360.1|	1570709	1570723	AGG	14	-	4	TCC
gi|514486632|gb|KE346360.1|	1571709	1571723	AGC	14	-	4	CTG
gi|514486632|gb|KE346360.1|	1572334	1572354	AAAC	20	+	5	ACAA
gi|514486632|gb|KE346360.1|	1572720	1572734	AACCAGC	14	+	2	GCAACCA
gi|514486632|gb|KE346360.1|	1574494	1574508	AAGAGAG	14	-	2	TCTCTCT
gi|514486632|gb|KE346360.1|	1574502	1574516	AGAGAGG	14	-	2	CTCTCTC
gi|514486632|gb|KE346360.1|	1577320	1577335	AAAAAC	15	+	2	AAACAA
gi|514486632|gb|KE346360.1|	1577472	1577489	AAAGG	17	+	3	AAAGG
gi|514486632|gb|KE346360.1|	1577865	1577881	AAAAG	16	+	3	AAAGA
gi|514486632|gb|KE346360.1|	1578876	1578891	AATGAC	15	-	2	TGTCAT
gi|514486632|gb|KE346360.1|	1579114	1579128	AAAGAAC	14	-	2	TTTGTTC
gi|514486632|gb|KE346360.1|	1579660	1579674	ACCACG	14	+	2	ACGACC
gi|514486632|gb|KE346360.1|	1581712	1581726	AAAAATT	14	-	2	AATTTTT
gi|514486632|gb|KE346360.1|	1581721	1581738	A	17	-	17	T
gi|514486632|gb|KE346360.1|	1582403	1582419	AAGGGC	16	+	2	CAAGGG
gi|514486632|gb|KE346360.1|	1582478	1582504	AGC	26	-	8	TGC
gi|514486632|gb|KE346360.1|	1583605	1583619	A	14	-	14	T
gi|514486632|gb|KE346360.1|	1584391	1584408	AAG	17	+	5	AAG
gi|514486632|gb|KE346360.1|	1584960	1584978	AAAGGG	18	-	3	CTTTCC
gi|514486632|gb|KE346360.1|	1586345	1586359	AAAG	14	+	3	GAAA
gi|514486632|gb|KE346360.1|	1586356	1586375	AG	19	+	9	AG
gi|514486632|gb|KE346360.1|	1586529	1586546	AATGAGC	17	-	2	TTGCTCA
gi|514486632|gb|KE346360.1|	1586743	1586774	AGCAGG	31	+	5	GGAGCA
gi|514486632|gb|KE346360.1|	1586927	1586944	AGCCTG	17	-	2	CAGGCT
gi|514486632|gb|KE346360.1|	1587182	1587207	AAGGAC	25	+	4	ACAAGG
gi|514486632|gb|KE346360.1|	1587202	1587225	AAGGAG	23	+	3	AAGGAG
gi|514486632|gb|KE346360.1|	1587220	1587243	AAGGAC	23	+	3	AAGGAC
gi|514486632|gb|KE346360.1|	1587247	1587267	AAGGAC	20	+	3	GACAAG
gi|514486632|gb|KE346360.1|	1587268	1587291	AAGGAC	23	+	3	AAGGAC
gi|514486632|gb|KE346360.1|	1589019	1589043	A	24	-	24	T
gi|514486632|gb|KE346360.1|	1589290	1589310	AGC	20	+	6	GCA
gi|514486632|gb|KE346360.1|	1589751	1589771	AAC	20	-	6	TGT
gi|514486632|gb|KE346360.1|	1591823	1591838	AAAAAAC	15	+	2	AAAAACA
gi|514486632|gb|KE346360.1|	1592924	1592940	AAATC	16	-	3	TGATT
gi|514486632|gb|KE346360.1|	1595296	1595310	AGC	14	+	4	CAG
gi|514486632|gb|KE346360.1|	1595311	1595334	AGC	23	+	7	CAG
gi|514486632|gb|KE346360.1|	1595332	1595353	AAC	21	+	7	CAA
gi|514486632|gb|KE346360.1|	1595656	1595690	AAC	34	-	11	TTG
gi|514486632|gb|KE346360.1|	1596518	1596532	ACGCCG	14	-	2	GTCGGC
gi|514486632|gb|KE346360.1|	1597199	1597214	A	15	-	15	T
gi|514486632|gb|KE346360.1|	1597291	1597306	ACAGAG	15	-	2	TGTCTC
gi|514486632|gb|KE346360.1|	1597555	1597570	ACGAGAG	15	+	2	GAGACGA
gi|514486632|gb|KE346360.1|	1597606	1597625	ATC	19	+	6	TCA
gi|514486632|gb|KE346360.1|	1599403	1599418	AAC	15	-	5	TTG
gi|514486632|gb|KE346360.1|	1599837	1599853	AAAAAAC	16	-	2	TTTTTGT
gi|514486632|gb|KE346360.1|	1600420	1600506	AG	86	+	43	AG
gi|514486632|gb|KE346360.1|	1600525	1600539	AAAC	14	+	3	AAAC
gi|514486632|gb|KE346360.1|	1601283	1601364	ATC	81	+	27	CAT
gi|514486632|gb|KE346360.1|	1602732	1602754	ACC	22	-	7	GTG
gi|514486632|gb|KE346360.1|	1603521	1603544	A	23	-	23	T
gi|514486632|gb|KE346360.1|	1603573	1603595	A	22	-	22	T
gi|514486632|gb|KE346360.1|	1603793	1603811	A	18	-	18	T
gi|514486632|gb|KE346360.1|	1604239	1604256	A	17	-	17	T
gi|514486632|gb|KE346360.1|	1604441	1604456	AAAAAAT	15	+	2	ATAAAAA
gi|514486632|gb|KE346360.1|	1604568	1604583	ATCGC	15	-	3	GATGC
gi|514486632|gb|KE346360.1|	1604661	1604676	A	15	+	15	A
gi|514486632|gb|KE346360.1|	1605552	1605566	AACCGAC	14	+	2	ACCGACA
gi|514486632|gb|KE346360.1|	1606867	1606881	ATATGCC	14	+	2	ATGCCAT
gi|514486632|gb|KE346360.1|	1606932	1606950	A	18	-	18	T
gi|514486632|gb|KE346360.1|	1608097	1608118	AACG	21	-	5	TCGT
gi|514486632|gb|KE346360.1|	1608693	1608707	AACCGAC	14	-	2	CGGTTGT
gi|514486632|gb|KE346360.1|	1612642	1612660	AGCCGC	18	+	3	CCGCAG
gi|514486632|gb|KE346360.1|	1613874	1613900	A	26	-	26	T
gi|514486632|gb|KE346360.1|	1614098	1614130	A	32	-	32	T
gi|514486632|gb|KE346360.1|	1614507	1614532	A	25	+	25	A
gi|514486632|gb|KE346360.1|	1614527	1614550	AAAAAG	23	+	3	AAAAAG
gi|514486632|gb|KE346360.1|	1614967	1614986	AC	19	+	9	AC
gi|514486632|gb|KE346360.1|	1615766	1615781	AAAAAAC	15	-	2	TTTGTTT
gi|514486632|gb|KE346360.1|	1616778	1616792	AAGCAGC	14	+	2	GCAGCAA
gi|514486632|gb|KE346360.1|	1617201	1617217	AATCTGC	16	-	2	GCAGATT
gi|514486632|gb|KE346360.1|	1617438	1617452	AGGGGG	14	-	2	CCCCTC
gi|514486632|gb|KE346360.1|	1617574	1617615	AC	41	+	20	AC
gi|514486632|gb|KE346360.1|	1617611	1617625	ACATC	14	+	2	CACAT
gi|514486632|gb|KE346360.1|	1617815	1617831	ACG	16	+	5	GAC
gi|514486632|gb|KE346360.1|	1619025	1619186	AAC	161	-	53	TTG
gi|514486632|gb|KE346360.1|	1619790	1619806	AAGCTG	16	-	2	CTTCAG
gi|514486632|gb|KE346360.1|	1620009	1620026	AAAC	17	+	4	AAAC
gi|514486632|gb|KE346360.1|	1620044	1620058	AAAAC	14	+	2	AAAAC
gi|514486632|gb|KE346360.1|	1620622	1620656	ACAG	34	+	8	AGAC
gi|514486632|gb|KE346360.1|	1621215	1621234	A	19	+	19	A
gi|514486632|gb|KE346360.1|	1622591	1622606	ACCATGC	15	+	2	CATGCAC
gi|514486632|gb|KE346360.1|	1623096	1623112	A	16	-	16	T
gi|514486632|gb|KE346360.1|	1623441	1623460	A	19	+	19	A
gi|514486632|gb|KE346360.1|	1624678	1624693	AC	15	-	7	TG
gi|514486632|gb|KE346360.1|	1624897	1624935	AAG	38	+	12	AAG
gi|514486632|gb|KE346360.1|	1625038	1625061	A	23	+	23	A
gi|514486632|gb|KE346360.1|	1625116	1625135	AAG	19	-	6	TTC
gi|514486632|gb|KE346360.1|	1626330	1626344	AAAC	14	-	3	TTTG
gi|514486632|gb|KE346360.1|	1627906	1627920	ACGAGG	14	-	2	CCTCGT
gi|514486632|gb|KE346360.1|	1628279	1628296	AACGAC	17	-	2	GTCGTT
gi|514486632|gb|KE346360.1|	1628291	1628315	ACG	24	-	8	GTC
gi|514486632|gb|KE346360.1|	1630323	1630337	AAGGG	14	+	2	GGGAA
gi|514486632|gb|KE346360.1|	1631834	1631864	ACC	30	+	10	CCA
gi|514486632|gb|KE346360.1|	1631862	1631878	AGC	16	+	5	CAG
gi|514486632|gb|KE346360.1|	1632437	1632451	AGCCGGG	14	+	2	GAGCCGG
gi|514486632|gb|KE346360.1|	1633480	1633496	AGCGGCC	16	-	2	GCCGCTG
gi|514486632|gb|KE346360.1|	1634544	1634565	AGC	21	+	7	CAG
gi|514486632|gb|KE346360.1|	1635099	1635118	ACAGACC	19	+	2	CAGACCA
gi|514486632|gb|KE346360.1|	1635287	1635303	AAAAAAC	16	+	2	AAACAAA
gi|514486632|gb|KE346360.1|	1635296	1635315	AAAAAC	19	+	3	ACAAAA
gi|514486632|gb|KE346360.1|	1635310	1635331	A	21	+	21	A
gi|514486632|gb|KE346360.1|	1635487	1635507	ACGAGG	20	+	3	GAGGAC
gi|514486632|gb|KE346360.1|	1635839	1635855	AG	16	+	8	GA
gi|514486632|gb|KE346360.1|	1635856	1635875	AG	19	+	9	AG
gi|514486632|gb|KE346360.1|	1636027	1636045	AAGGGCG	18	+	2	GAAGGGC
gi|514486632|gb|KE346360.1|	1636221	1636243	A	22	-	22	T
gi|514486632|gb|KE346360.1|	1636468	1636482	AGC	14	-	4	GCT
gi|514486632|gb|KE346360.1|	1637393	1637407	AGC	14	-	4	CTG
gi|514486632|gb|KE346360.1|	1637719	1637734	AAG	15	-	5	TCT
gi|514486632|gb|KE346360.1|	1637735	1637749	AAG	14	-	4	CTT
gi|514486632|gb|KE346360.1|	1639085	1639104	AAG	19	-	6	CTT
gi|514486632|gb|KE346360.1|	1639339	1639354	AATG	15	-	3	TTCA
gi|514486632|gb|KE346360.1|	1639359	1639379	AAAAAAT	20	-	2	TTTTTTA
gi|514486632|gb|KE346360.1|	1639448	1639462	AACAGC	14	+	2	CAGCAA
gi|514486632|gb|KE346360.1|	1639662	1639676	AG	14	-	7	TC
gi|514486632|gb|KE346360.1|	1639677	1639696	AAAGAG	19	-	3	CTTTCT
gi|514486632|gb|KE346360.1|	1640462	1640476	AG	14	-	7	TC
gi|514486632|gb|KE346360.1|	1641275	1641303	A	28	-	28	T
gi|514486632|gb|KE346360.1|	1642658	1642672	AAACAC	14	-	2	TTGTGT
gi|514486632|gb|KE346360.1|	1642665	1642680	AAAACAC	15	-	2	TGTGTTT
gi|514486632|gb|KE346360.1|	1642695	1642711	AAAACC	16	-	2	TTGGTT
gi|514486632|gb|KE346360.1|	1643109	1643123	ACGATG	14	+	2	GATGAC
gi|514486632|gb|KE346360.1|	1643118	1643135	ACGAGG	17	+	2	GACGAG
gi|514486632|gb|KE346360.1|	1643733	1643749	CCG	16	-	5	CGG
gi|514486632|gb|KE346360.1|	1644340	1644383	AAC	43	+	14	CAA
gi|514486632|gb|KE346360.1|	1647226	1647240	AAACAAC	14	-	2	TGTTGTT
gi|514486632|gb|KE346360.1|	1647331	1647360	AC	29	-	14	GT
gi|514486632|gb|KE346360.1|	1647907	1647923	AAG	16	-	5	TCT
gi|514486632|gb|KE346360.1|	1650013	1650027	AATGGC	14	-	2	CATTGC
gi|514486632|gb|KE346360.1|	1650831	1650845	ACGCCG	14	-	2	CGTCGG
gi|514486632|gb|KE346360.1|	1651134	1651148	ACGCAG	14	-	2	CTGCGT
gi|514486632|gb|KE346360.1|	1652455	1652471	A	16	-	16	T
gi|514486632|gb|KE346360.1|	1652473	1652489	A	16	-	16	T
gi|514486632|gb|KE346360.1|	1652656	1652682	AAC	26	+	8	AAC
gi|514486632|gb|KE346360.1|	1652976	1652993	AC	17	+	8	CA
gi|514486632|gb|KE346360.1|	1654673	1654687	AATGGC	14	-	2	CATTGC
gi|514486632|gb|KE346360.1|	1656463	1656643	AG	180	-	90	TC
gi|514486632|gb|KE346360.1|	1659325	1659353	A	28	+	28	A
gi|514486632|gb|KE346360.1|	1659679	1659709	AGAGGG	30	-	5	TCTCCC
gi|514486632|gb|KE346360.1|	1659735	1659749	AGGGGG	14	+	2	AGGGGG
gi|514486632|gb|KE346360.1|	1660382	1660408	AGC	26	-	8	TGC
gi|514486632|gb|KE346360.1|	1662182	1662196	ACCCCCG	14	-	2	GGTCGGG
gi|514486632|gb|KE346360.1|	1662855	1662870	AGC	15	+	5	CAG
gi|514486632|gb|KE346360.1|	1663089	1663108	AAAAACC	19	+	2	AAAAACC
gi|514486632|gb|KE346360.1|	1665919	1665935	AACGAC	16	+	2	CAACGA
gi|514486632|gb|KE346360.1|	1665930	1666023	AAC	93	+	31	ACA
gi|514486632|gb|KE346360.1|	1666017	1666033	AACAC	16	+	3	ACAAC
gi|514486632|gb|KE346360.1|	1666027	1666074	AAC	47	+	15	ACA
gi|514486632|gb|KE346360.1|	1666494	1666510	AATTCC	16	-	2	GGAATT
gi|514486632|gb|KE346360.1|	1667182	1667201	ACGAGG	19	+	3	GGACGA
gi|514486632|gb|KE346360.1|	1667209	1667226	AGC	17	-	5	GCT
gi|514486632|gb|KE346360.1|	1667256	1667273	AACATC	17	-	2	TGTTGA
gi|514486632|gb|KE346360.1|	1667511	1667528	AAT	17	+	5	AAT
gi|514486632|gb|KE346360.1|	1667680	1667705	AG	25	+	12	AG
gi|514486632|gb|KE346360.1|	1668597	1668611	AGCAGGC	14	+	2	GCAGGCA
gi|514486632|gb|KE346360.1|	1669722	1669737	AAAAAT	15	-	2	TTTTAT
gi|514486632|gb|KE346360.1|	1669733	1669751	AAAAAAT	18	-	2	TTTTATT
gi|514486632|gb|KE346360.1|	1669892	1669910	A	18	-	18	T
gi|514486632|gb|KE346360.1|	1669923	1669942	A	19	-	19	T
gi|514486632|gb|KE346360.1|	1670133	1670161	A	28	-	28	T
gi|514486632|gb|KE346360.1|	1670208	1670222	A	14	+	14	A
gi|514486632|gb|KE346360.1|	1670358	1670375	A	17	+	17	A
gi|514486632|gb|KE346360.1|	1671708	1671723	AAC	15	-	5	TGT
gi|514486632|gb|KE346360.1|	1671739	1671756	AAC	17	-	5	GTT
gi|514486632|gb|KE346360.1|	1672550	1672577	A	27	+	27	A
gi|514486632|gb|KE346360.1|	1674013	1674028	AAACAC	15	+	2	ACAAAC
gi|514486632|gb|KE346360.1|	1674266	1674280	AAAAG	14	+	2	AAAAG
gi|514486632|gb|KE346360.1|	1674491	1674511	AAAAAT	20	-	3	TTTTTA
gi|514486632|gb|KE346360.1|	1674919	1674935	AAAAGG	16	-	2	TTTTCC
gi|514486632|gb|KE346360.1|	1675212	1675230	AAAAAAT	18	-	2	TTTTTAT
gi|514486632|gb|KE346360.1|	1675232	1675250	AAAAT	18	-	3	TTTAT
gi|514486632|gb|KE346360.1|	1676513	1676528	ACCCTC	15	+	2	TCACCC
gi|514486632|gb|KE346360.1|	1679589	1679619	AACTGC	30	+	5	ACTGCA
gi|514486632|gb|KE346360.1|	1679629	1679658	AACTAC	29	+	4	CAACTA
gi|514486632|gb|KE346360.1|	1680025	1680043	ACG	18	+	6	GAC
gi|514486632|gb|KE346360.1|	1680970	1680987	AATCCG	17	+	2	AATCCG
gi|514486632|gb|KE346360.1|	1680992	1681031	A	39	+	39	A
gi|514486632|gb|KE346360.1|	1681125	1681142	A	17	+	17	A
gi|514486632|gb|KE346360.1|	1681654	1681677	AAGAGCC	23	-	3	GCTCTTG
gi|514486632|gb|KE346360.1|	1681683	1681702	ACGCG	19	-	3	CGTCG
gi|514486632|gb|KE346360.1|	1681828	1681842	AACGGTC	14	+	2	GTCAACG
gi|514486632|gb|KE346360.1|	1682182	1682196	AACCC	14	+	2	CAACC
gi|514486632|gb|KE346360.1|	1682283	1682300	AAATCCC	17	+	2	TCCCAAA
gi|514486632|gb|KE346360.1|	1682340	1682355	ACCAGC	15	+	2	GCACCA
gi|514486632|gb|KE346360.1|	1686560	1686587	A	27	-	27	T
gi|514486632|gb|KE346360.1|	1687474	1687489	AGCCG	15	-	3	GCTCG
gi|514486632|gb|KE346360.1|	1687569	1687584	AGGCGGG	15	+	2	GGAGGCG
gi|514486632|gb|KE346360.1|	1688758	1688778	A	20	-	20	T
gi|514486632|gb|KE346360.1|	1689082	1689103	AGC	21	+	7	CAG
gi|514486632|gb|KE346360.1|	1689147	1689182	ACCAGC	35	-	5	TGCTGG
gi|514486632|gb|KE346360.1|	1689193	1689208	ACGCCG	15	+	2	GACGCC
gi|514486632|gb|KE346360.1|	1690622	1690637	ACG	15	+	5	CGA
gi|514486632|gb|KE346360.1|	1691506	1691523	AAAC	17	+	4	CAAA
gi|514486632|gb|KE346360.1|	1691539	1691560	AAC	21	+	7	ACA
gi|514486632|gb|KE346360.1|	1693210	1693241	AGGC	31	+	7	GCAG
gi|514486632|gb|KE346360.1|	1693728	1693783	AG	55	-	27	CT
gi|514486632|gb|KE346360.1|	1694070	1694105	A	35	-	35	T
gi|514486632|gb|KE346360.1|	1694290	1694307	A	17	-	17	T
gi|514486632|gb|KE346360.1|	1694667	1694683	AAAAAT	16	+	2	AAAATA
gi|514486632|gb|KE346360.1|	1695977	1696003	ACC	26	+	8	CCA
gi|514486632|gb|KE346360.1|	1696017	1696031	AGC	14	+	4	CAG
gi|514486632|gb|KE346360.1|	1696589	1696608	AAACAAC	19	+	2	AACAACA
gi|514486632|gb|KE346360.1|	1702962	1702985	ACCAGC	23	-	3	TGCTGG
gi|514486632|gb|KE346360.1|	1704047	1704064	AGCGGC	17	+	2	GCGGCA
gi|514486632|gb|KE346360.1|	1704990	1705011	AGC	21	+	7	CAG
gi|514486632|gb|KE346360.1|	1705234	1705252	AG	18	+	9	AG
gi|514486632|gb|KE346360.1|	1705665	1705682	ACGCCG	17	+	2	CCGACG
gi|514486632|gb|KE346360.1|	1705766	1705784	CCG	18	+	6	CGC
gi|514486632|gb|KE346360.1|	1705779	1705793	AGCCGC	14	+	2	GCCGCA
gi|514486632|gb|KE346360.1|	1705788	1705802	AGC	14	+	4	GCA
gi|514486632|gb|KE346360.1|	1706271	1706291	A	20	-	20	T
gi|514486632|gb|KE346360.1|	1706288	1706303	AAAC	15	-	3	TTTG
gi|514486632|gb|KE346360.1|	1706470	1706485	AAAC	15	+	3	AACA
gi|514486632|gb|KE346360.1|	1706749	1706763	AGCCGGC	14	+	2	GCAGCCG
gi|514486632|gb|KE346360.1|	1707921	1707945	AGCGCC	24	+	4	GCGCCA
gi|514486632|gb|KE346360.1|	1711941	1711961	AGC	20	+	6	CAG
gi|514486632|gb|KE346360.1|	1713018	1713033	AG	15	-	7	TC
gi|514486632|gb|KE346360.1|	1713643	1713658	CCG	15	+	5	CCG
gi|514486632|gb|KE346360.1|	1715748	1715766	AAAAAC	18	+	3	CAAAAA
gi|514486632|gb|KE346360.1|	1715797	1715812	A	15	-	15	T
gi|514486632|gb|KE346360.1|	1715826	1715844	A	18	-	18	T
gi|514486632|gb|KE346360.1|	1715872	1715890	A	18	-	18	T
gi|514486632|gb|KE346360.1|	1716051	1716081	A	30	-	30	T
gi|514486632|gb|KE346360.1|	1716290	1716314	AGC	24	+	8	CAG
gi|514486632|gb|KE346360.1|	1716419	1716434	AGC	15	+	5	CAG
gi|514486632|gb|KE346360.1|	1716591	1716610	CCG	19	-	6	CGG
gi|514486632|gb|KE346360.1|	1716605	1716620	AGCCGC	15	-	2	GCGGCT
gi|514486632|gb|KE346360.1|	1717003	1717019	ACG	16	+	5	CGA
gi|514486632|gb|KE346360.1|	1717215	1717231	AGC	16	+	5	CAG
gi|514486632|gb|KE346360.1|	1717236	1717253	AGC	17	+	5	CAG
gi|514486632|gb|KE346360.1|	1719358	1719385	AAAAAC	27	-	4	TTTTTG
gi|514486632|gb|KE346360.1|	1719386	1719405	AAAAAC	19	-	3	TGTTTT
gi|514486632|gb|KE346360.1|	1720261	1720275	AAG	14	+	4	GAA
gi|514486632|gb|KE346360.1|	1721084	1721098	ACC	14	+	4	CCA
gi|514486632|gb|KE346360.1|	1721251	1721265	AAC	14	-	4	TTG
gi|514486632|gb|KE346360.1|	1721712	1721731	A	19	-	19	T
gi|514486632|gb|KE346360.1|	1721897	1721916	A	19	-	19	T
gi|514486632|gb|KE346360.1|	1722166	1722184	A	18	-	18	T
gi|514486632|gb|KE346360.1|	1722327	1722343	AAAAAG	16	-	2	TTTTCT
gi|514486632|gb|KE346360.1|	1722382	1722403	A	21	-	21	T
gi|514486632|gb|KE346360.1|	1722495	1722510	AAGCTCC	15	+	2	CCAAGCT
gi|514486632|gb|KE346360.1|	1723949	1723963	AG	14	+	7	GA
gi|514486632|gb|KE346360.1|	1724454	1724474	A	20	-	20	T
gi|514486632|gb|KE346360.1|	1726302	1726317	AATGGTG	15	-	2	TTCACCA
gi|514486632|gb|KE346360.1|	1726510	1726524	AAGCCC	14	+	2	CCCAAG
gi|514486632|gb|KE346360.1|	1726600	1726616	A	16	+	16	A
gi|514486632|gb|KE346360.1|	1726634	1726656	AAAAAAT	22	+	3	AATAAAA
gi|514486632|gb|KE346360.1|	1727040	1727054	AAAAAAC	14	-	2	TTTTTTG
gi|514486632|gb|KE346360.1|	1727300	1727329	A	29	-	29	T
gi|514486632|gb|KE346360.1|	1727385	1727405	A	20	-	20	T
gi|514486632|gb|KE346360.1|	1727905	1727921	CCG	16	+	5	CCG
gi|514486632|gb|KE346360.1|	1728683	1728697	AAACAG	14	-	2	TTTCTG
gi|514486632|gb|KE346360.1|	1729124	1729141	AACGGC	17	+	2	GCAACG
gi|514486632|gb|KE346360.1|	1729454	1729474	AGC	20	+	6	CAG
gi|514486632|gb|KE346360.1|	1729916	1729931	AGC	15	-	5	TGC
gi|514486632|gb|KE346360.1|	1730153	1730169	AACTCC	16	+	2	CAACTC
gi|514486632|gb|KE346360.1|	1730300	1730314	AACAGC	14	+	2	CAACAG
gi|514486632|gb|KE346360.1|	1730446	1730461	AACAGC	15	+	2	ACAGCA
gi|514486632|gb|KE346360.1|	1731405	1731425	AC	20	-	10	TG
gi|514486632|gb|KE346360.1|	1731491	1731505	AAAAGAT	14	+	2	AAAAGAT
gi|514486632|gb|KE346360.1|	1731532	1731547	AGG	15	+	5	GGA
gi|514486632|gb|KE346360.1|	1732938	1732954	ACAGTGC	16	+	2	GTGCACA
gi|514486632|gb|KE346360.1|	1735088	1735102	ACTGCG	14	+	2	TGCGAC
gi|514486632|gb|KE346360.1|	1735152	1735166	AAAAAAC	14	+	2	AAAAACA
gi|514486632|gb|KE346360.1|	1735367	1735383	AAAAAAG	16	-	2	TTTTCTT
gi|514486632|gb|KE346360.1|	1735644	1735674	A	30	+	30	A
gi|514486632|gb|KE346360.1|	1735969	1735986	AGCATC	17	-	2	TGATGC
gi|514486632|gb|KE346360.1|	1735981	1736017	ATC	36	-	12	TGA
gi|514486632|gb|KE346360.1|	1736056	1736071	A	15	+	15	A
gi|514486632|gb|KE346360.1|	1736104	1736120	AC	16	+	8	CA
gi|514486632|gb|KE346360.1|	1736269	1736292	A	23	-	23	T
gi|514486632|gb|KE346360.1|	1736288	1736310	AAAAG	22	-	4	TTTTC
gi|514486632|gb|KE346360.1|	1737002	1737018	A	16	+	16	A
gi|514486632|gb|KE346360.1|	1738167	1738181	AAG	14	+	4	AAG
gi|514486632|gb|KE346360.1|	1738345	1738359	AAAGTGT	14	-	2	ACACTTT
gi|514486632|gb|KE346360.1|	1739964	1739983	A	19	+	19	A
gi|514486632|gb|KE346360.1|	1740898	1740915	ATC	17	+	5	TCA
gi|514486632|gb|KE346360.1|	1740950	1740964	AAC	14	+	4	CAA
gi|514486632|gb|KE346360.1|	1740962	1740988	AGC	26	+	8	CAG
gi|514486632|gb|KE346360.1|	1741927	1741944	ACC	17	+	5	CAC
gi|514486632|gb|KE346360.1|	1743612	1743626	AGC	14	+	4	CAG
gi|514486632|gb|KE346360.1|	1744362	1744376	AGAGAGC	14	+	2	AGAGCAG
gi|514486632|gb|KE346360.1|	1744556	1744603	AAC	47	+	15	CAA
gi|514486632|gb|KE346360.1|	1744601	1744615	AGC	14	+	4	CAG
gi|514486632|gb|KE346360.1|	1744931	1744949	A	18	-	18	T
gi|514486632|gb|KE346360.1|	1748957	1748975	CCG	18	-	6	CGG
gi|514486632|gb|KE346360.1|	1749804	1749856	ACC	52	-	17	GGT
gi|514486632|gb|KE346360.1|	1752345	1752360	AACAGC	15	-	2	TTGCTG
gi|514486632|gb|KE346360.1|	1752355	1752387	AAC	32	-	10	TGT
gi|514486632|gb|KE346360.1|	1752394	1752414	AGC	20	-	6	TGC
gi|514486632|gb|KE346360.1|	1752437	1752451	AAACTGC	14	+	2	CTGCAAA
gi|514486632|gb|KE346360.1|	1753312	1753331	AAC	19	+	6	ACA
gi|514486632|gb|KE346360.1|	1753457	1753489	A	32	-	32	T
gi|514486632|gb|KE346360.1|	1753696	1753710	ACCAGC	14	-	2	TGGTGC
gi|514486632|gb|KE346360.1|	1753810	1753824	AGCAGG	14	+	2	AGGAGC
gi|514486632|gb|KE346360.1|	1756025	1756042	AGCATC	17	+	2	CATCAG
gi|514486632|gb|KE346360.1|	1757314	1757328	AGCCGG	14	-	2	CGGCTC
gi|514486632|gb|KE346360.1|	1757611	1757626	AGCCGC	15	+	2	CCGCAG
gi|514486632|gb|KE346360.1|	1763153	1763168	A	15	+	15	A
gi|514486632|gb|KE346360.1|	1763162	1763179	AAAAAAG	17	+	2	AAAAAAG
gi|514486632|gb|KE346360.1|	1763301	1763316	AAATTGG	15	-	2	CCAATTT
gi|514486632|gb|KE346360.1|	1764304	1764362	A	58	-	58	T
gi|514486632|gb|KE346360.1|	1768244	1768258	AAAAAG	14	+	2	AAAAGA
gi|514486632|gb|KE346360.1|	1776706	1776721	AAAC	15	-	3	TTTG
gi|514486632|gb|KE346360.1|	1776765	1776787	AAAC	22	-	5	TTTG
gi|514486632|gb|KE346360.1|	1777204	1777227	AAAC	23	+	5	AAAC
gi|514486632|gb|KE346360.1|	1778837	1778851	AAGAGC	14	+	2	CAAGAG
gi|514486632|gb|KE346360.1|	1782424	1782438	AAAAC	14	+	2	ACAAA
gi|514486632|gb|KE346360.1|	1782512	1782553	ACC	41	+	13	CCA
gi|514486632|gb|KE346360.1|	1783094	1783126	AAG	32	+	10	AAG
gi|514486632|gb|KE346360.1|	1783121	1783142	AAAAAAG	21	+	3	AAGAAAA
gi|514486632|gb|KE346360.1|	1783207	1783223	A	16	+	16	A
gi|514486632|gb|KE346360.1|	1783217	1783231	AAAAAAT	14	+	2	AAAAAAT
gi|514486632|gb|KE346360.1|	1783417	1783432	AG	15	+	7	GA
gi|514486632|gb|KE346360.1|	1784572	1784586	AAAAAAC	14	-	2	TTTTTTG
gi|514486632|gb|KE346360.1|	1785173	1785187	AGC	14	-	4	CTG
gi|514486632|gb|KE346360.1|	1785661	1785676	A	15	-	15	T
gi|514486632|gb|KE346360.1|	1785675	1785776	AC	101	-	50	TG
gi|514486632|gb|KE346360.1|	1786445	1786460	A	15	-	15	T
gi|514486632|gb|KE346360.1|	1787099	1787113	AAAACAC	14	-	2	TTTGTGT
gi|514486632|gb|KE346360.1|	1788439	1788490	AAC	51	-	17	TTG
gi|514486632|gb|KE346360.1|	1789065	1789085	ACT	20	-	6	GTA
gi|514486632|gb|KE346360.1|	1789303	1789317	AAAAC	14	+	2	AAAAC
gi|514486632|gb|KE346360.1|	1789320	1789334	AAAATTC	14	+	2	ATTCAAA
gi|514486632|gb|KE346360.1|	1789782	1789805	AG	23	-	11	CT
gi|514486632|gb|KE346360.1|	1790251	1790265	AAAAC	14	+	2	AAACA
gi|514486632|gb|KE346360.1|	1791074	1791103	ACC	29	-	9	GTG
gi|514486632|gb|KE346360.1|	1791302	1791327	AGC	25	-	8	TGC
gi|514486632|gb|KE346360.1|	1791433	1791447	ACAGT	14	+	2	GTACA
gi|514486632|gb|KE346360.1|	1791692	1791710	AACG	18	+	4	GAAC
gi|514486632|gb|KE346360.1|	1791711	1791730	AACG	19	+	4	CGAA
gi|514486632|gb|KE346360.1|	1794799	1794824	A	25	-	25	T
gi|514486632|gb|KE346360.1|	1794940	1794954	A	14	-	14	T
gi|514486632|gb|KE346360.1|	1795541	1795567	AAT	26	-	8	TTA
gi|514486632|gb|KE346360.1|	1795761	1795781	AAAAAAC	20	+	2	AAAAAAC
gi|514486632|gb|KE346360.1|	1796215	1796236	AAC	21	-	7	GTT
gi|514486632|gb|KE346360.1|	1798112	1798144	AGC	32	+	10	CAG
gi|514486632|gb|KE346360.1|	1798139	1798153	ACCAGC	14	+	2	CAGCAC
gi|514486632|gb|KE346360.1|	1799969	1800000	AGC	31	-	10	TGC
gi|514486632|gb|KE346360.1|	1800440	1800465	A	25	+	25	A
gi|514486632|gb|KE346360.1|	1800634	1800653	A	19	+	19	A
gi|514486632|gb|KE346360.1|	1800705	1800720	A	15	+	15	A
gi|514486632|gb|KE346360.1|	1801253	1801282	A	29	-	29	T
gi|514486632|gb|KE346360.1|	1802551	1802565	AAAAAT	14	-	2	TTTTTA
gi|514486632|gb|KE346360.1|	1802728	1802755	A	27	+	27	A
gi|514486632|gb|KE346360.1|	1802956	1802991	A	35	-	35	T
gi|514486632|gb|KE346360.1|	1804189	1804211	AC	22	-	11	TG
gi|514486632|gb|KE346360.1|	1804595	1804627	A	32	-	32	T
gi|514486632|gb|KE346360.1|	1804623	1804638	AAAAC	15	-	3	TTTTG
gi|514486632|gb|KE346360.1|	1804937	1804957	AGG	20	+	6	GAG
gi|514486632|gb|KE346360.1|	1805135	1805149	A	14	-	14	T
gi|514486632|gb|KE346360.1|	1806818	1806835	A	17	+	17	A
gi|514486632|gb|KE346360.1|	1807520	1807552	AGC	32	-	10	GCT
gi|514486632|gb|KE346360.1|	1809547	1809568	AGG	21	+	7	GAG
gi|514486632|gb|KE346360.1|	1809645	1809659	ACAGCCC	14	-	2	GCTGTGG
gi|514486632|gb|KE346360.1|	1811952	1811968	AAGGGG	16	-	2	CCCCTT
gi|514486632|gb|KE346360.1|	1812129	1812143	ACCGCTC	14	-	2	CGGTGAG
gi|514486632|gb|KE346360.1|	1816141	1816158	A	17	-	17	T
gi|514486632|gb|KE346360.1|	1816152	1816166	AAAAAAG	14	-	2	TTTTTTC
gi|514486632|gb|KE346360.1|	1816176	1816193	AAAACG	17	-	2	TCGTTT
gi|514486632|gb|KE346360.1|	1816536	1816553	AAAAAT	17	-	2	TTTTTA
gi|514486632|gb|KE346360.1|	1816742	1816772	AG	30	-	15	TC
gi|514486632|gb|KE346360.1|	1816866	1816885	AGAGGG	19	-	3	CCTCTC
gi|514486632|gb|KE346360.1|	1816917	1816945	A	28	-	28	T
gi|514486632|gb|KE346360.1|	1817621	1817644	AAC	23	-	7	TTG
gi|514486632|gb|KE346360.1|	1818702	1818716	ACGAGC	14	+	2	GCACGA
gi|514486632|gb|KE346360.1|	1821722	1821736	AACTAC	14	-	2	GTTGTA
gi|514486632|gb|KE346360.1|	1822118	1822132	ACGCCG	14	+	2	GCCGAC
gi|514486632|gb|KE346360.1|	1822280	1822297	AGC	17	+	5	GCA
gi|514486632|gb|KE346360.1|	1822622	1822654	AGC	32	-	10	TGC
gi|514486632|gb|KE346360.1|	1825840	1825854	AGC	14	+	4	GCA
gi|514486632|gb|KE346360.1|	1827171	1827193	A	22	-	22	T
gi|514486632|gb|KE346360.1|	1827351	1827365	A	14	-	14	T
gi|514486632|gb|KE346360.1|	1827586	1827601	AAAAAT	15	-	2	TTTTTA
gi|514486632|gb|KE346360.1|	1827984	1827998	AACTG	14	+	2	CTGAA
gi|514486632|gb|KE346360.1|	1828947	1828961	ACG	14	+	4	CGA
gi|514486632|gb|KE346360.1|	1829392	1829406	AAAC	14	+	3	ACAA
gi|514486632|gb|KE346360.1|	1829406	1829423	AAAC	17	+	4	CAAA
gi|514486632|gb|KE346360.1|	1829423	1829439	AAAC	16	+	4	CAAA
gi|514486632|gb|KE346360.1|	1831437	1831452	AGCTGC	15	+	2	AGCTGC
gi|514486632|gb|KE346360.1|	1831683	1831697	ACCGAG	14	-	2	CTCGGT
gi|514486632|gb|KE346360.1|	1831847	1831864	AGCATC	17	+	2	CAGCAT
gi|514486632|gb|KE346360.1|	1833111	1833125	AGCGCG	14	+	2	GCGCGA
gi|514486632|gb|KE346360.1|	1834706	1834720	AACAGC	14	+	2	CAACAG
gi|514486632|gb|KE346360.1|	1835530	1835554	A	24	-	24	T
gi|514486632|gb|KE346360.1|	1835551	1835570	AAAC	19	-	4	TTTG
gi|514486632|gb|KE346360.1|	1836553	1836568	AAAAAAC	15	+	2	AAAACAA
gi|514486632|gb|KE346360.1|	1837829	1837844	AGC	15	+	5	AGC
gi|514486632|gb|KE346360.1|	1838824	1838844	A	20	-	20	T
gi|514486632|gb|KE346360.1|	1839162	1839183	A	21	+	21	A
gi|514486632|gb|KE346360.1|	1839364	1839384	A	20	-	20	T
gi|514486632|gb|KE346360.1|	1839741	1839768	A	27	-	27	T
gi|514486632|gb|KE346360.1|	1839769	1839785	AAAACC	16	-	2	GGTTTT
gi|514486632|gb|KE346360.1|	1839863	1839877	AATCAGC	14	-	2	CTGATTG
gi|514486632|gb|KE346360.1|	1840441	1840457	AAAATCC	16	-	2	TGGATTT
gi|514486632|gb|KE346360.1|	1844968	1844984	AAAAAAT	16	-	2	TTTTATT
gi|514486632|gb|KE346360.1|	1846052	1846074	AAC	22	-	7	GTT
gi|514486632|gb|KE346360.1|	1846396	1846411	AAACGTG	15	-	2	CGTTTCA
gi|514486632|gb|KE346360.1|	1847130	1847145	A	15	-	15	T
gi|514486632|gb|KE346360.1|	1847146	1847166	A	20	-	20	T
gi|514486632|gb|KE346360.1|	1849030	1849050	AAAC	20	-	5	TTTG
gi|514486632|gb|KE346360.1|	1849527	1849542	AAAAAAC	15	+	2	ACAAAAA
gi|514486632|gb|KE346360.1|	1850923	1850937	ACACGCG	14	-	2	GCGTGTC
gi|514486632|gb|KE346360.1|	1851999	1852022	ACTGCC	23	-	3	GTGGCA
gi|514486632|gb|KE346360.1|	1852061	1852075	ACCACG	14	-	2	GGTCGT
gi|514486632|gb|KE346360.1|	1852129	1852146	ACTAGT	17	+	2	TACTAG
gi|514486632|gb|KE346360.1|	1852262	1852284	AAC	22	-	7	TTG
gi|514486632|gb|KE346360.1|	1852689	1852712	AAGAGGG	23	-	3	CTTCCCT
gi|514486632|gb|KE346360.1|	1852839	1852859	AAG	20	-	6	CTT
gi|514486632|gb|KE346360.1|	1853037	1853054	AAAC	17	-	4	TTTG
gi|514486632|gb|KE346360.1|	1855006	1855026	AC	20	-	10	GT
gi|514486632|gb|KE346360.1|	1857670	1857684	AGC	14	-	4	TGC
gi|514486632|gb|KE346360.1|	1859148	1859167	CCG	19	-	6	GCG
gi|514486632|gb|KE346360.1|	1863145	1863163	AAACC	18	+	3	ACCAA
gi|514486632|gb|KE346360.1|	1863497	1863514	ACG	17	+	5	GAC
gi|514486632|gb|KE346360.1|	1863624	1863644	A	20	+	20	A
gi|514486632|gb|KE346360.1|	1864239	1864255	AACAC	16	+	3	ACAAC
gi|514486632|gb|KE346360.1|	1864367	1864390	AAAG	23	-	5	TTTC
gi|514486632|gb|KE346360.1|	1864556	1864585	A	29	+	29	A
gi|514486632|gb|KE346360.1|	1864618	1864633	AGGGGGG	15	-	2	CCCTCCC
gi|514486632|gb|KE346360.1|	1864742	1864766	AAG	24	+	8	GAA
gi|514486632|gb|KE346360.1|	1864962	1864981	AG	19	-	9	CT
gi|514486632|gb|KE346360.1|	1866551	1866571	AC	20	-	10	GT
gi|514486632|gb|KE346360.1|	1866676	1866691	A	15	-	15	T
gi|514486632|gb|KE346360.1|	1866714	1866731	AAG	17	-	5	TTC
gi|514486632|gb|KE346360.1|	1867123	1867140	AAAACCC	17	-	2	TGGGTTT
gi|514486632|gb|KE346360.1|	1867937	1867956	AGC	19	-	6	CTG
gi|514486632|gb|KE346360.1|	1868152	1868173	AAAC	21	-	5	TTGT
gi|514486632|gb|KE346360.1|	1868473	1868497	A	24	+	24	A
gi|514486632|gb|KE346360.1|	1868525	1868540	A	15	+	15	A
gi|514486632|gb|KE346360.1|	1868946	1868960	AAAAAG	14	-	2	TTCTTT
gi|514486632|gb|KE346360.1|	1869218	1869248	AAC	30	+	10	CAA
gi|514486632|gb|KE346360.1|	1870483	1870497	AAAG	14	-	3	TTTC
gi|514486632|gb|KE346360.1|	1871895	1871909	AGCGGC	14	+	2	GCAGCG
gi|514486632|gb|KE346360.1|	1873853	1873867	A	14	+	14	A
gi|514486632|gb|KE346360.1|	1873902	1873922	ACCCCG	20	+	3	GACCCC
gi|514486632|gb|KE346360.1|	1874685	1874702	ACTGCT	17	-	2	AGCAGT
gi|514486632|gb|KE346360.1|	1874908	1874933	A	25	+	25	A
gi|514486632|gb|KE346360.1|	1874972	1874989	A	17	-	17	T
gi|514486632|gb|KE346360.1|	1875438	1875452	ATC	14	-	4	GAT
gi|514486632|gb|KE346360.1|	1876653	1876667	A	14	+	14	A
gi|514486632|gb|KE346360.1|	1876919	1876936	AGG	17	-	5	CCT
gi|514486632|gb|KE346360.1|	1877836	1877850	AAGGGC	14	+	2	CAAGGG
gi|514486632|gb|KE346360.1|	1878481	1878501	A	20	+	20	A
gi|514486632|gb|KE346360.1|	1879422	1879451	A	29	-	29	T
gi|514486632|gb|KE346360.1|	1880163	1880183	A	20	-	20	T
gi|514486632|gb|KE346360.1|	1880185	1880209	A	24	-	24	T
gi|514486632|gb|KE346360.1|	1880565	1880580	AGCAGG	15	+	2	AGCAGG
gi|514486632|gb|KE346360.1|	1881101	1881118	AAAAAC	17	-	2	TGTTTT
gi|514486632|gb|KE346360.1|	1882001	1882015	AAACCAC	14	+	2	ACAAACC
gi|514486632|gb|KE346360.1|	1882027	1882044	AC	17	-	8	GT
gi|514486632|gb|KE346360.1|	1882506	1882520	AGGCGG	14	-	2	CCTCCG
gi|514486632|gb|KE346360.1|	1882515	1882531	CCG	16	+	5	CCG
gi|514486632|gb|KE346360.1|	1883907	1883921	AAAAC	14	+	2	AAAAC
gi|514486632|gb|KE346360.1|	1884476	1884502	A	26	+	26	A
gi|514486632|gb|KE346360.1|	1884509	1884527	AAAACAT	18	+	2	AAAACAT
gi|514486632|gb|KE346360.1|	1884568	1884587	AAC	19	-	6	TTG
gi|514486632|gb|KE346360.1|	1884588	1884602	AAC	14	-	4	GTT
gi|514486632|gb|KE346360.1|	1884611	1884626	ACTC	15	+	3	CTCA
gi|514486632|gb|KE346360.1|	1884849	1884868	AGC	19	-	6	TGC
gi|514486632|gb|KE346360.1|	1885094	1885109	ACGGGCC	15	-	2	TGGCCCG
gi|514486632|gb|KE346360.1|	1886398	1886415	A	17	-	17	T
gi|514486632|gb|KE346360.1|	1886409	1886423	AAAAAAC	14	-	2	TTTTTTG
gi|514486632|gb|KE346360.1|	1887391	1887405	A	14	+	14	A
gi|514486632|gb|KE346360.1|	1887651	1887684	AC	33	-	16	TG
gi|514486632|gb|KE346360.1|	1888059	1888095	A	36	-	36	T
gi|514486632|gb|KE346360.1|	1888132	1888147	AAGGGAG	15	-	2	CCCTTCT
gi|514486632|gb|KE346360.1|	1888348	1888362	AAAG	14	+	3	AAAG
gi|514486632|gb|KE346360.1|	1888671	1888685	ACGATG	14	+	2	GATGAC
gi|514486632|gb|KE346360.1|	1888881	1888895	ATC	14	-	4	TGA
gi|514486632|gb|KE346360.1|	1890216	1890231	AAAG	15	-	3	TTTC
gi|514486632|gb|KE346360.1|	1890240	1890263	A	23	-	23	T
gi|514486632|gb|KE346360.1|	1890310	1890324	ACGCTGG	14	+	2	GCTGGAC
gi|514486632|gb|KE346360.1|	1890858	1890872	A	14	+	14	A
gi|514486632|gb|KE346360.1|	1891119	1891134	A	15	-	15	T
gi|514486632|gb|KE346360.1|	1891778	1891831	AC	53	-	26	TG
gi|514486632|gb|KE346360.1|	1892381	1892400	AAAC	19	-	4	TTTG
gi|514486632|gb|KE346360.1|	1894388	1894407	AAC	19	-	6	GTT
gi|514486632|gb|KE346360.1|	1894496	1894510	AAGGGG	14	-	2	TTCCCC
gi|514486632|gb|KE346360.1|	1894608	1894622	AAGGGG	14	-	2	TTCCCC
gi|514486632|gb|KE346360.1|	1896486	1896501	AAAAAAC	15	-	2	TTTTTTG
gi|514486632|gb|KE346360.1|	1898343	1898357	ACG	14	+	4	GAC
gi|514486632|gb|KE346360.1|	1900365	1900385	AAC	20	+	6	AAC
gi|514486632|gb|KE346360.1|	1900473	1900487	ACT	14	+	4	CTA
gi|514486632|gb|KE346360.1|	1900598	1900614	A	16	-	16	T
gi|514486632|gb|KE346360.1|	1901904	1901953	AGAGCC	49	-	8	GCTCTG
gi|514486632|gb|KE346360.1|	1902252	1902268	AAAAAAT	16	-	2	TTTATTT
gi|514486632|gb|KE346360.1|	1902345	1902359	ACACGG	14	-	2	CGTGTC
gi|514486632|gb|KE346360.1|	1902755	1902769	CCCG	14	-	3	GGGC
gi|514486632|gb|KE346360.1|	1904730	1904752	A	22	+	22	A
gi|514486632|gb|KE346360.1|	1905150	1905168	A	18	+	18	A
gi|514486632|gb|KE346360.1|	1905184	1905200	AAAATG	16	+	2	AAAATG
gi|514486632|gb|KE346360.1|	1905744	1905763	A	19	-	19	T
gi|514486632|gb|KE346360.1|	1905945	1905959	A	14	+	14	A
gi|514486632|gb|KE346360.1|	1906118	1906133	AC	15	+	7	CA
gi|514486632|gb|KE346360.1|	1906170	1906184	AAAG	14	-	3	TTTC
gi|514486632|gb|KE346360.1|	1906464	1906479	AGCC	15	-	3	GGCT
gi|514486632|gb|KE346360.1|	1909525	1909542	ACC	17	+	5	CAC
gi|514486632|gb|KE346360.1|	1909789	1909806	AAT	17	+	5	AAT
gi|514486632|gb|KE346360.1|	1909817	1909837	AACTGAG	20	-	2	TCAGTTC
gi|514486632|gb|KE346360.1|	1910148	1910163	AGC	15	+	5	CAG
gi|514486632|gb|KE346360.1|	1912229	1912243	AGCATGC	14	-	2	CTGCATG
gi|514486632|gb|KE346360.1|	1913515	1913530	A	15	+	15	A
gi|514486632|gb|KE346360.1|	1913680	1913696	AGATG	16	-	3	TCTCA
gi|514486632|gb|KE346360.1|	1913796	1913811	A	15	-	15	T
gi|514486632|gb|KE346360.1|	1913826	1913847	A	21	-	21	T
gi|514486632|gb|KE346360.1|	1914144	1914163	ACACGC	19	+	3	CACACG
gi|514486632|gb|KE346360.1|	1915107	1915121	AAGGAC	14	+	2	GACAAG
gi|514486632|gb|KE346360.1|	1917731	1917745	AAAACCC	14	-	2	TTTGGGT
gi|514486632|gb|KE346360.1|	1918474	1918506	CCG	32	-	10	GGC
gi|514486632|gb|KE346360.1|	1918960	1918974	AAGGGGC	14	+	2	CAAGGGG
gi|514486632|gb|KE346360.1|	1920524	1920538	AAAAGGC	14	-	2	CTTTTGC
gi|514486632|gb|KE346360.1|	1922137	1922157	A	20	-	20	T
gi|514486632|gb|KE346360.1|	1922319	1922334	ACGCCG	15	-	2	CGGCGT
gi|514486632|gb|KE346360.1|	1922551	1922568	CCG	17	+	5	GCC
gi|514486632|gb|KE346360.1|	1922642	1922658	ACG	16	+	5	GAC
gi|514486632|gb|KE346360.1|	1922705	1922726	AGCCTG	21	-	3	GCTCAG
gi|514486632|gb|KE346360.1|	1925031	1925051	AC	20	+	10	CA
gi|514486632|gb|KE346360.1|	1925592	1925607	ACGCTG	15	-	2	CAGCGT
gi|514486632|gb|KE346360.1|	1925860	1925956	AC	96	+	48	CA
gi|514486632|gb|KE346360.1|	1926838	1926852	ACC	14	-	4	GGT
gi|514486632|gb|KE346360.1|	1926916	1926945	A	29	+	29	A
gi|514486632|gb|KE346360.1|	1927185	1927200	ACTCCCC	15	+	2	CTCCCCA
gi|514486632|gb|KE346360.1|	1927204	1927221	AC	17	+	8	CA
gi|514486632|gb|KE346360.1|	1927464	1927482	ACATCGG	18	+	2	ATCGGAC
gi|514486632|gb|KE346360.1|	1928266	1928281	A	15	-	15	T
gi|514486632|gb|KE346360.1|	1928277	1928291	AAAAC	14	-	2	TTTTG
gi|514486632|gb|KE346360.1|	1929236	1929260	AATGC	24	+	4	ATGCA
gi|514486632|gb|KE346360.1|	1929469	1929491	ACG	22	-	7	TCG
gi|514486632|gb|KE346360.1|	1931116	1931144	ACAG	28	+	7	ACAG
gi|514486632|gb|KE346360.1|	1932070	1932084	ATC	14	-	4	ATG
gi|514486632|gb|KE346360.1|	1932357	1932371	AAC	14	+	4	AAC
gi|514486632|gb|KE346360.1|	1932510	1932524	AATCCAT	14	-	2	ATGGATT
gi|514486632|gb|KE346360.1|	1933172	1933197	A	25	-	25	T
gi|514486632|gb|KE346360.1|	1936078	1936098	A	20	-	20	T
gi|514486632|gb|KE346360.1|	1936238	1936252	AAGCAG	14	-	2	TCTGCT
gi|514486632|gb|KE346360.1|	1936508	1936533	A	25	-	25	T
gi|514486632|gb|KE346360.1|	1937323	1937349	A	26	-	26	T
gi|514486632|gb|KE346360.1|	1938526	1938561	ACC	35	+	11	CCA
gi|514486632|gb|KE346360.1|	1940007	1940035	AGC	28	-	9	GCT
gi|514486632|gb|KE346360.1|	1943700	1943714	ACCGCG	14	+	2	GCGACC
gi|514486632|gb|KE346360.1|	1946724	1946739	AAACAGC	15	-	2	TTGCTGT
gi|514486632|gb|KE346360.1|	1946857	1946888	A	31	+	31	A
gi|514486632|gb|KE346360.1|	1947101	1947115	AAT	14	+	4	AAT
gi|514486632|gb|KE346360.1|	1947747	1947763	ATCGCC	16	+	2	TCGCCA
gi|514486632|gb|KE346360.1|	1947928	1947963	A	35	-	35	T
gi|514486632|gb|KE346360.1|	1949232	1949249	ATCCCCG	17	+	2	CCCCGAT
gi|514486632|gb|KE346360.1|	1949253	1949267	ATCCCC	14	+	2	CCATCC
gi|514486632|gb|KE346360.1|	1950268	1950285	ACAGCG	17	+	2	GCGACA
gi|514486632|gb|KE346360.1|	1950337	1950368	AC	31	-	15	GT
gi|514486632|gb|KE346360.1|	1952310	1952324	ACC	14	-	4	GTG
gi|514486632|gb|KE346360.1|	1952334	1952352	ACC	18	-	6	GTG
gi|514486632|gb|KE346360.1|	1952539	1952561	ACCAGC	22	-	3	GTGCTG
gi|514486632|gb|KE346360.1|	1952736	1952751	ACAGAGC	15	-	2	GTGCTCT
gi|514486632|gb|KE346360.1|	1952785	1952800	ACGACTG	15	+	2	GACGACT
gi|514486632|gb|KE346360.1|	1953319	1953342	ACC	23	-	7	GTG
gi|514486632|gb|KE346360.1|	1953357	1953371	ACC	14	-	4	TGG
gi|514486632|gb|KE346360.1|	1953432	1953446	AACATC	14	-	2	TGTTGA
gi|514486632|gb|KE346360.1|	1953481	1953512	AGC	31	+	10	GCA
gi|514486632|gb|KE346360.1|	1953676	1953692	AAGGGG	16	+	2	GGGGAA
gi|514486632|gb|KE346360.1|	1953695	1953845	AG	150	+	75	GA
gi|514486632|gb|KE346360.1|	1954028	1954055	A	27	+	27	A
gi|514486632|gb|KE346360.1|	1954258	1954281	A	23	+	23	A
gi|514486632|gb|KE346360.1|	1954460	1954476	ACG	16	+	5	GAC
gi|514486632|gb|KE346360.1|	1954502	1954538	A	36	+	36	A
gi|514486632|gb|KE346360.1|	1954644	1954658	AAGGGGG	14	-	2	TTCCCCC
gi|514486632|gb|KE346360.1|	1955104	1955120	A	16	+	16	A
gi|514486632|gb|KE346360.1|	1956455	1956469	AAAGG	14	+	2	AAAGG
gi|514486632|gb|KE346360.1|	1957416	1957433	A	17	+	17	A
gi|514486632|gb|KE346360.1|	1958969	1958990	A	21	+	21	A
gi|514486632|gb|KE346360.1|	1959305	1959320	A	15	+	15	A
gi|514486632|gb|KE346360.1|	1960221	1960235	A	14	+	14	A
gi|514486632|gb|KE346360.1|	1960422	1960438	AAAATGC	16	+	2	AATGCAA
gi|514486632|gb|KE346360.1|	1960440	1960457	A	17	+	17	A
gi|514486632|gb|KE346360.1|	1960673	1960695	A	22	-	22	T
gi|514486632|gb|KE346360.1|	1960875	1960889	A	14	+	14	A
gi|514486632|gb|KE346360.1|	1963098	1963116	A	18	-	18	T
gi|514486632|gb|KE346360.1|	1963995	1964009	AAACAG	14	-	2	GTTTCT
gi|514486632|gb|KE346360.1|	1964532	1964546	AGCTGC	14	+	2	GCAGCT
gi|514486632|gb|KE346360.1|	1965604	1965619	AG	15	-	7	CT
gi|514486632|gb|KE346360.1|	1968248	1968262	AAAAAG	14	-	2	TTTTCT
gi|514486632|gb|KE346360.1|	1968525	1968541	AGCC	16	+	4	CAGC
gi|514486632|gb|KE346360.1|	1970589	1970603	AGCTCG	14	+	2	GCTCGA
gi|514486632|gb|KE346360.1|	1971607	1971621	AAGCAG	14	+	2	AGCAGA
gi|514486632|gb|KE346360.1|	1972169	1972227	AAC	58	+	19	ACA
gi|514486632|gb|KE346360.1|	1974370	1974386	AGC	16	-	5	TGC
gi|514486632|gb|KE346360.1|	1974388	1974404	AGC	16	-	5	TGC
gi|514486632|gb|KE346360.1|	1978980	1978994	AAAAAAG	14	-	2	CTTTTTT
gi|514486632|gb|KE346360.1|	1979055	1979070	AAGACC	15	+	2	CAAGAC
gi|514486632|gb|KE346360.1|	1980687	1980701	A	14	-	14	T
gi|514486632|gb|KE346360.1|	1981735	1981749	AAGCAG	14	+	2	CAGAAG
gi|514486632|gb|KE346360.1|	1983290	1983307	AAGGGC	17	-	2	CCTTGC
gi|514486632|gb|KE346360.1|	1983302	1983320	AAGGCC	18	-	3	CCTTGG
gi|514486632|gb|KE346360.1|	1983568	1983585	ACGAGG	17	-	2	TCGTCC
gi|514486632|gb|KE346360.1|	1984075	1984096	ACCCTC	21	-	3	GGGTGA
gi|514486632|gb|KE346360.1|	1984639	1984658	A	19	-	19	T
gi|514486632|gb|KE346360.1|	1993831	1993852	ACC	21	-	7	GTG
gi|514486632|gb|KE346360.1|	1995768	1995793	AG	25	-	12	TC
gi|514486632|gb|KE346360.1|	1995873	1995914	A	41	+	41	A
gi|514486632|gb|KE346360.1|	1996402	1996423	A	21	+	21	A
gi|514486632|gb|KE346360.1|	1997071	1997095	A	24	+	24	A
gi|514486632|gb|KE346360.1|	1998822	1998836	AGGGGG	14	+	2	GGGAGG
gi|514486632|gb|KE346360.1|	1999371	1999385	AAAAGC	14	-	2	GCTTTT
gi|514486632|gb|KE346360.1|	1999684	1999700	AC	16	+	8	CA
gi|514486632|gb|KE346360.1|	2000290	2000313	ACG	23	+	7	GAC
gi|514486632|gb|KE346360.1|	2000331	2000348	A	17	+	17	A
gi|514486632|gb|KE346360.1|	2000346	2000363	AATG	17	+	4	AATG
gi|514486632|gb|KE346360.1|	2000365	2000379	AAAGC	14	-	2	TTGCT
gi|514486632|gb|KE346360.1|	2000664	2000685	ATCGCC	21	+	3	CCATCG
gi|514486632|gb|KE346360.1|	2007524	2007539	AAAAAC	15	+	2	AAACAA
gi|514486632|gb|KE346360.1|	2008056	2008071	AAAAC	15	+	3	ACAAA
gi|514486632|gb|KE346360.1|	2008841	2008859	AAAAC	18	+	3	AAAAC
gi|514486632|gb|KE346360.1|	2008855	2008870	AAACC	15	+	3	CAAAC
gi|514486632|gb|KE346360.1|	2008892	2008912	AAAC	20	+	5	CAAA
gi|514486632|gb|KE346360.1|	2009733	2009755	A	22	+	22	A
gi|514486632|gb|KE346360.1|	2009878	2009909	AGC	31	+	10	CAG
gi|514486632|gb|KE346360.1|	2010100	2010124	AG	24	+	12	GA
gi|514486632|gb|KE346360.1|	2010129	2010146	A	17	+	17	A
gi|514486632|gb|KE346360.1|	2013353	2013374	AC	21	+	10	CA
gi|514486632|gb|KE346360.1|	2014127	2014142	AAAAC	15	-	3	TGTTT
gi|514486632|gb|KE346360.1|	2015630	2015648	ACCATC	18	+	3	TCACCA
gi|514486632|gb|KE346360.1|	2015729	2015743	AAAAC	14	+	2	AAAAC
gi|514486632|gb|KE346360.1|	2018386	2018408	AACAAG	22	-	3	TTGTTC
gi|514486632|gb|KE346360.1|	2018571	2018588	AG	17	+	8	GA
gi|514486632|gb|KE346360.1|	2022736	2022753	AAC	17	-	5	GTT
gi|514486632|gb|KE346360.1|	2023690	2023710	AG	20	+	10	AG
gi|514486632|gb|KE346360.1|	2023785	2023800	AGGGGG	15	-	2	TCCCCC
gi|514486632|gb|KE346360.1|	2023946	2023970	A	24	-	24	T
gi|514486632|gb|KE346360.1|	2024607	2024621	AGCCGG	14	+	2	GGAGCC
gi|514486632|gb|KE346360.1|	2024736	2024750	AGGCGC	14	+	2	GGCGCA
gi|514486632|gb|KE346360.1|	2024964	2024979	ATGCCC	15	-	2	GGCATG
gi|514486632|gb|KE346360.1|	2025024	2025038	ATGCCC	14	-	2	GGCATG
gi|514486632|gb|KE346360.1|	2025060	2025075	ATGCCC	15	-	2	GGCATG
gi|514486632|gb|KE346360.1|	2025081	2025095	ATGCCC	14	-	2	GGCATG
gi|514486632|gb|KE346360.1|	2025141	2025155	ATGCCC	14	-	2	GGCATG
gi|514486632|gb|KE346360.1|	2025201	2025216	ATGCCC	15	-	2	GGCATG
gi|514486632|gb|KE346360.1|	2025222	2025243	ATGCCC	21	-	3	GGCATG
gi|514486632|gb|KE346360.1|	2025249	2025264	ATGCCC	15	-	2	GGCATG
gi|514486632|gb|KE346360.1|	2026685	2026707	ACAGCC	22	+	3	CAGCCA
gi|514486632|gb|KE346360.1|	2026703	2026732	AGC	29	+	9	CAG
gi|514486632|gb|KE346360.1|	2027754	2027773	AGC	19	+	6	AGC
gi|514486632|gb|KE346360.1|	2028555	2028571	AGC	16	+	5	AGC
gi|514486632|gb|KE346360.1|	2030078	2030093	AAAAGGC	15	-	2	GCCTTTT
gi|514486632|gb|KE346360.1|	2030463	2030477	A	14	+	14	A
gi|514486632|gb|KE346360.1|	2031347	2031367	A	20	-	20	T
gi|514486632|gb|KE346360.1|	2031899	2031917	AG	18	+	9	GA
gi|514486632|gb|KE346360.1|	2032429	2032444	AAGGG	15	-	3	CCTTC
gi|514486632|gb|KE346360.1|	2032723	2032740	AAAAAC	17	-	2	TTTTTG
gi|514486632|gb|KE346360.1|	2034081	2034098	A	17	-	17	T
gi|514486632|gb|KE346360.1|	2034310	2034327	AGC	17	-	5	TGC
gi|514486632|gb|KE346360.1|	2034322	2034336	AACAGC	14	-	2	TGCTGT
gi|514486632|gb|KE346360.1|	2034331	2034347	AAC	16	-	5	TGT
gi|514486632|gb|KE346360.1|	2035876	2035897	AGC	21	+	7	CAG
gi|514486632|gb|KE346360.1|	2035956	2035970	AGC	14	+	4	GCA
gi|514486632|gb|KE346360.1|	2036557	2036571	ACC	14	-	4	GTG
gi|514486632|gb|KE346360.1|	2036574	2036597	AACAGC	23	-	3	TGCTGT
gi|514486632|gb|KE346360.1|	2037267	2037309	AGC	42	+	14	GCA
gi|514486632|gb|KE346360.1|	2037345	2037364	ATCCGC	19	-	3	GATGCG
gi|514486632|gb|KE346360.1|	2037618	2037635	AAC	17	-	5	TGT
gi|514486632|gb|KE346360.1|	2037642	2037665	AAC	23	-	7	TGT
gi|514486632|gb|KE346360.1|	2037663	2037677	AGC	14	-	4	TGC
gi|514486632|gb|KE346360.1|	2038142	2038159	AC	17	-	8	GT
gi|514486632|gb|KE346360.1|	2038248	2038276	A	28	+	28	A
gi|514486632|gb|KE346360.1|	2038294	2038320	A	26	+	26	A
gi|514486632|gb|KE346360.1|	2041378	2041397	AAAGCTC	19	+	2	GCTCAAA
gi|514486632|gb|KE346360.1|	2042442	2042456	AGC	14	+	4	AGC
gi|514486632|gb|KE346360.1|	2044492	2044507	ACAGGC	15	+	2	CACAGG
gi|514486632|gb|KE346360.1|	2044584	2044607	A	23	-	23	T
gi|514486632|gb|KE346360.1|	2044631	2044645	AACAGG	14	-	2	CTGTTC
gi|514486632|gb|KE346360.1|	2046073	2046091	A	18	-	18	T
gi|514486632|gb|KE346360.1|	2048282	2048296	AAAAT	14	+	2	AAAAT
gi|514486632|gb|KE346360.1|	2048991	2049006	AAACG	15	+	3	CGAAA
gi|514486632|gb|KE346360.1|	2049408	2049435	CCG	27	-	9	GGC
gi|514486632|gb|KE346360.1|	2049561	2049575	CCG	14	-	4	GGC
gi|514486632|gb|KE346360.1|	2049670	2049695	CCG	25	-	8	GCG
gi|514486632|gb|KE346360.1|	2049940	2049954	CCG	14	-	4	GGC
gi|514486632|gb|KE346360.1|	2050524	2050538	AAACAC	14	-	2	TTTGTG
gi|514486632|gb|KE346360.1|	2051452	2051468	ACACAG	16	-	2	TCTGTG
gi|514486632|gb|KE346360.1|	2054968	2054983	AACGAG	15	+	2	ACGAGA
gi|514486632|gb|KE346360.1|	2055462	2055476	ACCTCC	14	+	2	CCTCCA
gi|514486632|gb|KE346360.1|	2055720	2055734	ACG	14	-	4	GTC
gi|514486632|gb|KE346360.1|	2056035	2056050	ACTC	15	-	3	GAGT
gi|514486632|gb|KE346360.1|	2056456	2056476	ACTC	20	+	5	CTCA
gi|514486632|gb|KE346360.1|	2056772	2056786	ACAGCG	14	-	2	GTCGCT
gi|514486632|gb|KE346360.1|	2056837	2056854	ATCC	17	+	4	CCAT
gi|514486632|gb|KE346360.1|	2057319	2057352	AAC	33	+	11	AAC
gi|514486632|gb|KE346360.1|	2060990	2061004	AACCCAC	14	+	2	CCACAAC
gi|514486632|gb|KE346360.1|	2061247	2061284	AGG	37	+	12	GAG
gi|514486632|gb|KE346360.1|	2061285	2061299	AGGCGG	14	+	2	GGCGGA
gi|514486632|gb|KE346360.1|	2062291	2062313	AGC	22	-	7	TGC
gi|514486632|gb|KE346360.1|	2062584	2062601	AGAGAT	17	-	2	TCTCTA
gi|514486632|gb|KE346360.1|	2062912	2062926	AACCATC	14	+	2	ACCATCA
gi|514486632|gb|KE346360.1|	2063667	2063682	AAAAGGG	15	+	2	GAAAAGG
gi|514486632|gb|KE346360.1|	2064232	2064246	ACCCCGC	14	-	2	GTGCGGG
gi|514486632|gb|KE346360.1|	2064572	2064586	AGGG	14	+	3	GAGG
gi|514486632|gb|KE346360.1|	2064931	2064957	AG	26	+	13	AG
gi|514486632|gb|KE346360.1|	2065166	2065184	ATC	18	+	6	TCA
gi|514486632|gb|KE346360.1|	2065655	2065676	AAG	21	+	7	GAA
gi|514486632|gb|KE346360.1|	2066524	2066544	AAC	20	-	6	TGT
gi|514486632|gb|KE346360.1|	2066553	2066571	AGC	18	-	6	CTG
gi|514486632|gb|KE346360.1|	2066670	2066684	AAGGCTC	14	+	2	GCTCAAG
gi|514486632|gb|KE346360.1|	2069866	2069880	AGCGGC	14	-	2	GCCGCT
gi|514486632|gb|KE346360.1|	2070878	2070895	ATC	17	-	5	TGA
gi|514486632|gb|KE346360.1|	2070935	2070949	ACCGTCG	14	-	2	TCGACGG
gi|514486632|gb|KE346360.1|	2071027	2071050	AGAGCC	23	-	3	TGGCTC
gi|514486632|gb|KE346360.1|	2071710	2071724	CCGCGCG	14	-	2	CGCGGCG
gi|514486632|gb|KE346360.1|	2072225	2072244	A	19	+	19	A
gi|514486632|gb|KE346360.1|	2072620	2072642	AAAAAAT	22	+	3	AAATAAA
gi|514486632|gb|KE346360.1|	2072852	2072869	AAAAAG	17	-	2	TTTTTC
gi|514486632|gb|KE346360.1|	2073242	2073267	A	25	+	25	A
gi|514486632|gb|KE346360.1|	2073565	2073579	ACGATCG	14	-	2	GATCGTC
gi|514486632|gb|KE346360.1|	2073856	2073871	AAGATGC	15	+	2	GCAAGAT
gi|514486632|gb|KE346360.1|	2074196	2074212	A	16	-	16	T
gi|514486632|gb|KE346360.1|	2074554	2074568	CCG	14	-	4	GCG
gi|514486632|gb|KE346360.1|	2075520	2075534	AAAAAAC	14	-	2	TTTTTTG
gi|514486632|gb|KE346360.1|	2077738	2077758	A	20	-	20	T
gi|514486632|gb|KE346360.1|	2077861	2077876	AGC	15	+	5	GCA
gi|514486632|gb|KE346360.1|	2080541	2080562	A	21	+	21	A
gi|514486632|gb|KE346360.1|	2080778	2080796	A	18	+	18	A
gi|514486632|gb|KE346360.1|	2081014	2081028	AAAAAAC	14	-	2	GTTTTTT
gi|514486632|gb|KE346360.1|	2081122	2081136	AGC	14	+	4	CAG
gi|514486632|gb|KE346360.1|	2081218	2081241	AGC	23	+	7	CAG
gi|514486632|gb|KE346360.1|	2081703	2081717	AAAC	14	-	3	TTGT
gi|514486632|gb|KE346360.1|	2081798	2081814	AAAC	16	-	4	TTTG
gi|514486632|gb|KE346360.1|	2082075	2082090	AACGAC	15	-	2	GTCGTT
gi|514486632|gb|KE346360.1|	2082241	2082256	ACAGCG	15	-	2	TCGCTG
gi|514486632|gb|KE346360.1|	2082424	2082438	ACTCGG	14	+	2	GACTCG
gi|514486632|gb|KE346360.1|	2082848	2082868	ACG	20	-	6	CGT
gi|514486632|gb|KE346360.1|	2083011	2083025	AACCCGC	14	-	2	TTGCGGG
gi|514486632|gb|KE346360.1|	2083947	2083965	AAACACG	18	+	2	AAACACG
gi|514486632|gb|KE346360.1|	2084063	2084077	AAC	14	+	4	ACA
gi|514486632|gb|KE346360.1|	2084682	2084696	AAC	14	+	4	ACA
gi|514486632|gb|KE346360.1|	2085775	2085789	ACGATC	14	-	2	ATCGTG
gi|514486632|gb|KE346360.1|	2086045	2086071	A	26	-	26	T
gi|514486632|gb|KE346360.1|	2086773	2086787	AGCAGGC	14	-	2	GCTGCCT
gi|514486632|gb|KE346360.1|	2087108	2087131	AGCCGC	23	-	3	GCTGCG
gi|514486632|gb|KE346360.1|	2088182	2088196	AAGCAG	14	-	2	CTGCTT
gi|514486632|gb|KE346360.1|	2088358	2088391	AAAC	33	+	8	CAAA
gi|514486632|gb|KE346360.1|	2089250	2089264	A	14	-	14	T
gi|514486632|gb|KE346360.1|	2089474	2089501	AGAGGGG	27	-	3	TCTCCCC
gi|514486632|gb|KE346360.1|	2089604	2089625	A	21	+	21	A
gi|514486632|gb|KE346360.1|	2089862	2089876	ACC	14	-	4	GTG
gi|514486632|gb|KE346360.1|	2090039	2090054	A	15	+	15	A
gi|514486632|gb|KE346360.1|	2091230	2091252	AGC	22	-	7	GCT
gi|514486632|gb|KE346360.1|	2091247	2091261	ACCAGC	14	-	2	TGCTGG
gi|514486632|gb|KE346360.1|	2092607	2092621	AAAGAG	14	-	2	CTTTCT
gi|514486632|gb|KE346360.1|	2093194	2093208	CCG	14	+	4	CCG
gi|514486632|gb|KE346360.1|	2094332	2094349	ACC	17	-	5	TGG
gi|514486632|gb|KE346360.1|	2094440	2094454	AAAGGG	14	-	2	TCCCTT
gi|514486632|gb|KE346360.1|	2094587	2094603	AAAAAG	16	-	2	TTTTTC
gi|514486632|gb|KE346360.1|	2095218	2095238	A	20	-	20	T
gi|514486632|gb|KE346360.1|	2096122	2096136	AAACAC	14	-	2	GTTTGT
gi|514486632|gb|KE346360.1|	2097619	2097633	AAGCTC	14	-	2	GCTTGA
gi|514486632|gb|KE346360.1|	2100374	2100391	ACG	17	+	5	CGA
gi|514486632|gb|KE346360.1|	2100539	2100556	AGCATG	17	-	2	ATGCTC
gi|514486632|gb|KE346360.1|	2100949	2100970	AAC	21	-	7	TGT
gi|514486632|gb|KE346360.1|	2102329	2102344	AACGAAG	15	+	2	AAGAACG
gi|514486632|gb|KE346360.1|	2103502	2103519	AGCGCC	17	-	2	GCTGGC
gi|514486632|gb|KE346360.1|	2103981	2103997	A	16	+	16	A
gi|514486632|gb|KE346360.1|	2104493	2104547	A	54	+	54	A
gi|514486632|gb|KE346360.1|	2106566	2106613	AC	47	+	23	CA
gi|514486632|gb|KE346360.1|	2106614	2106632	AC	18	+	9	CA
gi|514486632|gb|KE346360.1|	2106633	2106653	AC	20	+	10	AC
gi|514486632|gb|KE346360.1|	2106757	2106826	AC	69	+	34	AC
gi|514486632|gb|KE346360.1|	2107361	2107383	A	22	+	22	A
gi|514486632|gb|KE346360.1|	2107555	2107569	ACGGCGC	14	+	2	GCACGGC
gi|514486632|gb|KE346360.1|	2107866	2107881	AAG	15	-	5	CTT
gi|514486632|gb|KE346360.1|	2109409	2109435	A	26	+	26	A
gi|514486632|gb|KE346360.1|	2110070	2110084	AGAGCG	14	+	2	GAGCGA
gi|514486632|gb|KE346360.1|	2110285	2110303	AC	18	+	9	AC
gi|514486632|gb|KE346360.1|	2110382	2110398	AAAG	16	+	4	GAAA
gi|514486632|gb|KE346360.1|	2110395	2110416	A	21	+	21	A
gi|514486632|gb|KE346360.1|	2110556	2110573	ACTC	17	-	4	GTGA
gi|514486632|gb|KE346360.1|	2110980	2110995	A	15	+	15	A
gi|514486632|gb|KE346360.1|	2110991	2111005	AAAAG	14	+	2	AAAAG
gi|514486632|gb|KE346360.1|	2111026	2111040	AGATC	14	-	2	TCTGA
gi|514486632|gb|KE346360.1|	2111161	2111184	AG	23	-	11	TC
gi|514486632|gb|KE346360.1|	2111185	2111201	AAACG	16	-	3	TTCGT
gi|514486632|gb|KE346360.1|	2111326	2111353	AGCAGG	27	+	4	AGGAGC
gi|514486632|gb|KE346360.1|	2111424	2111438	AGC	14	-	4	CTG
gi|514486632|gb|KE346360.1|	2111441	2111464	AGCCGC	23	-	3	GCTGCG
gi|514486632|gb|KE346360.1|	2114362	2114382	AGC	20	+	6	GCA
gi|514486632|gb|KE346360.1|	2115011	2115028	ACC	17	-	5	TGG
gi|514486632|gb|KE346360.1|	2116596	2116610	AAAACCC	14	+	2	CAAAACC
gi|514486632|gb|KE346360.1|	2116613	2116632	AC	19	+	9	AC
gi|514486632|gb|KE346360.1|	2117017	2117070	AG	53	+	26	AG
gi|514486632|gb|KE346360.1|	2118711	2118726	AAGCTGC	15	-	2	TTGCAGC
gi|514486632|gb|KE346360.1|	2120328	2120343	AGCG	15	+	3	GCGA
gi|514486632|gb|KE346360.1|	2120930	2120945	AAAGCTG	15	-	2	GCTTTCA
gi|514486632|gb|KE346360.1|	2121130	2121147	AGC	17	-	5	TGC
gi|514486632|gb|KE346360.1|	2121148	2121162	ACCAGC	14	-	2	TGGTGC
gi|514486632|gb|KE346360.1|	2121179	2121195	AACCAC	16	-	2	GTGGTT
gi|514486632|gb|KE346360.1|	2121376	2121400	AATG	24	-	6	TCAT
gi|514486632|gb|KE346360.1|	2121490	2121505	AAGC	15	+	3	CAAG
gi|514486632|gb|KE346360.1|	2121554	2121587	A	33	-	33	T
gi|514486632|gb|KE346360.1|	2122253	2122267	AACACC	14	-	2	TGTTGG
gi|514486632|gb|KE346360.1|	2122491	2122507	AGC	16	-	5	CTG
gi|514486632|gb|KE346360.1|	2123743	2123769	A	26	-	26	T
gi|514486632|gb|KE346360.1|	2125773	2125790	AAAAAC	17	+	2	AAACAA
gi|514486632|gb|KE346360.1|	2125807	2125827	AAC	20	+	6	AAC
gi|514486632|gb|KE346360.1|	2126043	2126062	ACAGCG	19	-	3	GTCGCT
gi|514486632|gb|KE346360.1|	2128357	2128375	ACGGC	18	-	3	CCGTG
gi|514486632|gb|KE346360.1|	2130969	2130983	AGCGGC	14	-	2	GCTGCC
gi|514486632|gb|KE346360.1|	2131128	2131155	A	27	+	27	A
gi|514486632|gb|KE346360.1|	2131674	2131689	AAAC	15	+	3	AAAC
gi|514486632|gb|KE346360.1|	2131807	2131828	AG	21	+	10	AG
gi|514486632|gb|KE346360.1|	2131821	2131835	AAGAGAG	14	+	2	AGAGAGA
gi|514486632|gb|KE346360.1|	2132686	2132777	AAAC	91	+	22	AAAC
gi|514486632|gb|KE346360.1|	2132774	2132788	AAAAAT	14	+	2	AAATAA
gi|514486632|gb|KE346360.1|	2134863	2134878	AGCGGC	15	+	2	GCGGCA
gi|514486632|gb|KE346360.1|	2136351	2136367	AGCGGC	16	+	2	CGGCAG
gi|514486632|gb|KE346360.1|	2137860	2137876	AGC	16	+	5	CAG
gi|514486632|gb|KE346360.1|	2138610	2138635	A	25	+	25	A
gi|514486632|gb|KE346360.1|	2138989	2139003	AAT	14	+	4	AAT
gi|514486632|gb|KE346360.1|	2139051	2139073	A	22	+	22	A
gi|514486632|gb|KE346360.1|	2139189	2139208	CCCCCG	19	-	3	GCGGGG
gi|514486632|gb|KE346360.1|	2139442	2139458	A	16	+	16	A
gi|514486632|gb|KE346360.1|	2143268	2143285	AC	17	+	8	AC
gi|514486632|gb|KE346360.1|	2144942	2144959	AACAGC	17	+	2	CAACAG
gi|514486632|gb|KE346360.1|	2145037	2145052	ACG	15	+	5	ACG
gi|514486632|gb|KE346360.1|	2145212	2145233	A	21	+	21	A
gi|514486632|gb|KE346360.1|	2145303	2145317	AAAAAAC	14	+	2	AAACAAA
gi|514486632|gb|KE346360.1|	2145361	2145375	AACTCAG	14	+	2	AACTCAG
gi|514486632|gb|KE346360.1|	2145527	2145547	AG	20	+	10	GA
gi|514486632|gb|KE346360.1|	2146900	2146914	AAAAC	14	+	2	AAACA
gi|514486632|gb|KE346360.1|	2147860	2147915	AAAC	55	+	13	AAAC
gi|514486632|gb|KE346360.1|	2148515	2148529	A	14	+	14	A
gi|514486632|gb|KE346360.1|	2148524	2148539	AAAAAC	15	+	2	AAAAAC
gi|514486632|gb|KE346360.1|	2149457	2149479	A	22	+	22	A
gi|514486632|gb|KE346360.1|	2149550	2149573	A	23	+	23	A
gi|514486632|gb|KE346360.1|	2151965	2151981	ACTCCC	16	+	2	CTCCCA
gi|514486632|gb|KE346360.1|	2152079	2152096	A	17	+	17	A
gi|514486632|gb|KE346360.1|	2153115	2153139	A	24	-	24	T
gi|514486632|gb|KE346360.1|	2153134	2153154	AAAAACC	20	-	2	TTTTTGG
gi|514486632|gb|KE346360.1|	2153322	2153340	A	18	-	18	T
gi|514486632|gb|KE346360.1|	2153542	2153580	A	38	-	38	T
gi|514486632|gb|KE346360.1|	2155436	2155451	AAAGC	15	+	3	GCAAA
gi|514486632|gb|KE346360.1|	2155461	2155488	AAAC	27	+	6	AAAC
gi|514486632|gb|KE346360.1|	2155485	2155503	A	18	+	18	A
gi|514486632|gb|KE346360.1|	2155741	2155756	AAAGTC	15	+	2	TCAAAG
gi|514486632|gb|KE346360.1|	2156599	2156613	AGAGCG	14	+	2	AGCGAG
gi|514486632|gb|KE346360.1|	2157515	2157531	ACCCAG	16	+	2	CCAGAC
gi|514486632|gb|KE346360.1|	2157572	2157606	ACAGTC	34	-	5	GACTGT
gi|514486632|gb|KE346360.1|	2157855	2157924	AC	69	+	34	CA
gi|514486632|gb|KE346360.1|	2162283	2162301	AAC	18	+	6	AAC
gi|514486632|gb|KE346360.1|	2163050	2163072	A	22	-	22	T
gi|514486632|gb|KE346360.1|	2163677	2163694	ACCCCC	17	+	2	CCCCCA
gi|514486632|gb|KE346360.1|	2163702	2163716	AAAAAG	14	+	2	GAAAAA
gi|514486632|gb|KE346360.1|	2165071	2165090	A	19	+	19	A
gi|514486632|gb|KE346360.1|	2165089	2165103	ACTCTG	14	-	2	AGAGTC
gi|514486632|gb|KE346360.1|	2165636	2165651	AAAGAGC	15	+	2	GCAAAGA
gi|514486632|gb|KE346360.1|	2165890	2165904	A	14	+	14	A
gi|514486632|gb|KE346360.1|	2166105	2166121	ACG	16	-	5	CGT
gi|514486632|gb|KE346360.1|	2166421	2166435	ACTGAGC	14	+	2	ACTGAGC
gi|514486632|gb|KE346360.1|	2166465	2166483	A	18	+	18	A
gi|514486632|gb|KE346360.1|	2170862	2170876	ACACGT	14	+	2	GTACAC
gi|514486632|gb|KE346360.1|	2171712	2171727	A	15	-	15	T
gi|514486632|gb|KE346360.1|	2171731	2171746	AAAAAAC	15	-	2	TTGTTTT
gi|514486632|gb|KE346360.1|	2171741	2171755	AAAAAAC	14	-	2	TTTTTGT
gi|514486632|gb|KE346360.1|	2173615	2173633	ACTCTC	18	+	3	CACTCT
gi|514486632|gb|KE346360.1|	2174223	2174237	ACGCCG	14	+	2	CGCCGA
gi|514486632|gb|KE346360.1|	2174390	2174421	AAAC	31	-	7	TTTG
gi|514486632|gb|KE346360.1|	2175389	2175404	AGCGGC	15	-	2	CCGCTG
gi|514486632|gb|KE346360.1|	2179438	2179463	AAC	25	-	8	TTG
gi|514486632|gb|KE346360.1|	2179466	2179492	AGC	26	-	8	TGC
gi|514486632|gb|KE346360.1|	2180469	2180488	ACGAGG	19	+	3	GAGGAC
gi|514486632|gb|KE346360.1|	2181044	2181059	AAAAGAC	15	-	2	TTTGTCT
gi|514486632|gb|KE346360.1|	2181328	2181343	AAATGTG	15	+	2	ATGTGAA
gi|514486632|gb|KE346360.1|	2181372	2181391	A	19	-	19	T
gi|514486632|gb|KE346360.1|	2181697	2181723	AGC	26	+	8	CAG
gi|514486632|gb|KE346360.1|	2182436	2182458	AC	22	-	11	TG
gi|514486632|gb|KE346360.1|	2183054	2183068	AAAAAC	14	-	2	TTGTTT
gi|514486632|gb|KE346360.1|	2186216	2186231	AAAAAG	15	+	2	AAAGAA
gi|514486632|gb|KE346360.1|	2186853	2186881	A	28	+	28	A
gi|514486632|gb|KE346360.1|	2189826	2189846	ACG	20	+	6	CGA
gi|514486632|gb|KE346360.1|	2191033	2191050	A	17	+	17	A
gi|514486632|gb|KE346360.1|	2191225	2191250	A	25	+	25	A
gi|514486632|gb|KE346360.1|	2191281	2191301	A	20	-	20	T
gi|514486632|gb|KE346360.1|	2191305	2191322	AACTG	17	-	3	TCAGT
gi|514486632|gb|KE346360.1|	2194633	2194653	A	20	+	20	A
gi|514486632|gb|KE346360.1|	2196054	2196068	AGCCGC	14	+	2	CGCAGC
gi|514486632|gb|KE346360.1|	2197221	2197235	AGATGG	14	+	2	TGGAGA
gi|514486632|gb|KE346360.1|	2198185	2198200	AGCCGC	15	+	2	CGCAGC
gi|514486632|gb|KE346360.1|	2199925	2199945	AACAGCC	20	+	2	CCAACAG
gi|514486632|gb|KE346360.1|	2200698	2200721	AAGTGC	23	+	3	GCAAGT
gi|514486632|gb|KE346360.1|	2200738	2200752	AGC	14	+	4	GCA
gi|514486632|gb|KE346360.1|	2201534	2201619	AC	85	-	42	GT
gi|514486632|gb|KE346360.1|	2202818	2202837	A	19	-	19	T
gi|514486632|gb|KE346360.1|	2202835	2202850	AACAGC	15	-	2	TTGCTG
gi|514486632|gb|KE346360.1|	2205959	2205987	ACG	28	+	9	CGA
gi|514486632|gb|KE346360.1|	2206600	2206616	A	16	+	16	A
gi|514486632|gb|KE346360.1|	2206771	2206797	A	26	+	26	A
gi|514486632|gb|KE346360.1|	2207255	2207273	AAAAAAC	18	-	2	TTTTTGT
gi|514486632|gb|KE346360.1|	2207268	2207291	AAAAAT	23	-	3	TTTTTA
gi|514486632|gb|KE346360.1|	2207867	2207882	AAGGAGG	15	-	2	CTTCCTC
gi|514486632|gb|KE346360.1|	2209268	2209282	AAATATG	14	+	2	ATGAAAT
gi|514486632|gb|KE346360.1|	2212949	2212971	AAC	22	+	7	AAC
gi|514486632|gb|KE346360.1|	2213667	2213682	ACCC	15	-	3	TGGG
gi|514486632|gb|KE346360.1|	2215483	2215497	AGCAGG	14	+	2	AGCAGG
gi|514486632|gb|KE346360.1|	2215951	2215969	AATGGG	18	+	3	AATGGG
gi|514486632|gb|KE346360.1|	2216294	2216313	AGCTCC	19	+	3	CTCCAG
gi|514486632|gb|KE346360.1|	2216313	2216327	AATACC	14	+	2	ACCAAT
gi|514486632|gb|KE346360.1|	2218316	2218360	AGC	44	-	14	CTG
gi|514486632|gb|KE346360.1|	2220210	2220224	AGATCTC	14	+	2	CAGATCT
gi|514486632|gb|KE346360.1|	2221195	2221214	A	19	-	19	T
gi|514486632|gb|KE346360.1|	2221570	2221584	AAAAAG	14	-	2	TTTTTC
gi|514486632|gb|KE346360.1|	2221590	2221604	A	14	-	14	T
gi|514486632|gb|KE346360.1|	2221784	2221803	A	19	+	19	A
gi|514486632|gb|KE346360.1|	2221992	2222007	A	15	+	15	A
gi|514486632|gb|KE346360.1|	2222016	2222035	AAAATG	19	+	3	AAATGA
gi|514486632|gb|KE346360.1|	2222042	2222071	A	29	-	29	T
gi|514486632|gb|KE346360.1|	2222237	2222258	AAG	21	-	7	TTC
gi|514486632|gb|KE346360.1|	2222346	2222362	AC	16	-	8	TG
gi|514486632|gb|KE346360.1|	2223357	2223372	AGCGGG	15	+	2	GGGAGC
gi|514486632|gb|KE346360.1|	2225238	2225275	ACG	37	+	12	ACG
gi|514486632|gb|KE346360.1|	2226028	2226050	AAAC	22	-	5	TTGT
gi|514486632|gb|KE346360.1|	2228871	2228890	AAAC	19	-	4	TTTG
gi|514486632|gb|KE346360.1|	2229480	2229494	ACACC	14	+	2	CACCA
gi|514486632|gb|KE346360.1|	2229749	2229764	AAAAAC	15	-	2	TTTTGT
gi|514486632|gb|KE346360.1|	2230250	2230270	A	20	-	20	T
gi|514486632|gb|KE346360.1|	2230756	2230772	AAAAAAC	16	-	2	TTTTTTG
gi|514486632|gb|KE346360.1|	2231035	2231050	A	15	-	15	T
gi|514486632|gb|KE346360.1|	2231448	2231462	AAGATCC	14	-	2	TGGATCT
gi|514486632|gb|KE346360.1|	2231795	2231811	ATC	16	-	5	ATG
gi|514486632|gb|KE346360.1|	2233028	2233048	AGG	20	-	6	CTC
gi|514486632|gb|KE346360.1|	2233358	2233380	ACG	22	-	7	TCG
gi|514486632|gb|KE346360.1|	2234312	2234332	A	20	-	20	T
gi|514486632|gb|KE346360.1|	2234979	2234999	A	20	+	20	A
gi|514486632|gb|KE346360.1|	2235152	2235174	ACGTCCC	22	+	3	CCCACGT
gi|514486632|gb|KE346360.1|	2235816	2235836	A	20	+	20	A
gi|514486632|gb|KE346360.1|	2236076	2236095	A	19	-	19	T
gi|514486632|gb|KE346360.1|	2237361	2237375	AAAAAG	14	-	2	TTTTCT
gi|514486632|gb|KE346360.1|	2237472	2237486	AAGG	14	-	3	TTCC
gi|514486632|gb|KE346360.1|	2238911	2238931	AGC	20	+	6	GCA
gi|514486632|gb|KE346360.1|	2239041	2239060	ACCTGC	19	+	3	CACCTG
gi|514486632|gb|KE346360.1|	2239254	2239273	AAAC	19	-	4	TTGT
gi|514486632|gb|KE346360.1|	2239674	2239688	AAATC	14	-	2	GATTT
gi|514486632|gb|KE346360.1|	2239758	2239772	AACGATG	14	-	2	CATCGTT
gi|514486632|gb|KE346360.1|	2242668	2242690	A	22	-	22	T
gi|514486632|gb|KE346360.1|	2243291	2243321	AAGACG	30	+	5	ACGAAG
gi|514486632|gb|KE346360.1|	2243320	2243337	AGGGCG	17	+	2	GGCGAG
gi|514486632|gb|KE346360.1|	2244376	2244392	AACAC	16	-	3	TGTTG
gi|514486632|gb|KE346360.1|	2249067	2249081	A	14	+	14	A
gi|514486632|gb|KE346360.1|	2249769	2249783	A	14	+	14	A
gi|514486632|gb|KE346360.1|	2250076	2250090	AACCC	14	+	2	CAACC
gi|514486632|gb|KE346360.1|	2250518	2250532	A	14	+	14	A
gi|514486632|gb|KE346360.1|	2251090	2251106	AAAAAC	16	+	2	AAAAAC
gi|514486632|gb|KE346360.1|	2251155	2251173	A	18	+	18	A
gi|514486632|gb|KE346360.1|	2251402	2251432	A	30	+	30	A
gi|514486632|gb|KE346360.1|	2251796	2251813	AAAAAG	17	+	2	AAAAAG
gi|514486632|gb|KE346360.1|	2252027	2252044	A	17	+	17	A
gi|514486632|gb|KE346360.1|	2252242	2252266	A	24	-	24	T
gi|514486632|gb|KE346360.1|	2252442	2252458	A	16	-	16	T
gi|514486632|gb|KE346360.1|	2252472	2252489	A	17	-	17	T
gi|514486632|gb|KE346360.1|	2253093	2253111	AAGGTCC	18	-	2	ACCTTGG
gi|514486632|gb|KE346360.1|	2255603	2255621	AGC	18	+	6	GCA
gi|514486632|gb|KE346360.1|	2256242	2256256	A	14	+	14	A
gi|514486632|gb|KE346360.1|	2257482	2257498	AAAAC	16	+	3	ACAAA
gi|514486632|gb|KE346360.1|	2257491	2257505	AAAAAC	14	+	2	AACAAA
gi|514486632|gb|KE346360.1|	2259265	2259279	AAGGAC	14	-	2	TCCTTG
gi|514486632|gb|KE346360.1|	2259303	2259336	AGCAGG	33	-	5	TGCTCC
gi|514486632|gb|KE346360.1|	2259528	2259543	AATCGTC	15	+	2	CAATCGT
gi|514486632|gb|KE346360.1|	2259734	2259748	ACTGAG	14	-	2	TCAGTC
gi|514486632|gb|KE346360.1|	2260281	2260295	AGGATG	14	+	2	GAGGAT
gi|514486632|gb|KE346360.1|	2261616	2261632	ACCCCG	16	+	2	CCCCGA
gi|514486632|gb|KE346360.1|	2261797	2261815	AAAAC	18	-	3	TTTTG
gi|514486632|gb|KE346360.1|	2262545	2262559	AAC	14	-	4	TTG
gi|514486632|gb|KE346360.1|	2263819	2263847	A	28	-	28	T
gi|514486632|gb|KE346360.1|	2264174	2264191	ATCGCC	17	-	2	GGCGAT
gi|514486632|gb|KE346360.1|	2265479	2265496	AAGAGGG	17	+	2	GGGAAGA
gi|514486632|gb|KE346360.1|	2265508	2265525	AATGGGC	17	-	2	GCCCATT
gi|514486632|gb|KE346360.1|	2266308	2266322	ACGCT	14	+	2	CTACG
gi|514486632|gb|KE346360.1|	2266656	2266679	AC	23	+	11	AC
gi|514486632|gb|KE346360.1|	2268081	2268095	ACTG	14	-	3	AGTC
gi|514486632|gb|KE346360.1|	2268091	2268105	AGCCCTG	14	-	2	TCAGGGC
gi|514486632|gb|KE346360.1|	2268149	2268178	AATGCTG	29	-	4	TCAGCAT
gi|514486632|gb|KE346360.1|	2268225	2268247	A	22	+	22	A
gi|514486632|gb|KE346360.1|	2268328	2268354	AACGAC	26	+	4	ACAACG
gi|514486632|gb|KE346360.1|	2268448	2268463	ACTCTCC	15	+	2	CCACTCT
gi|514486632|gb|KE346360.1|	2268901	2268916	CCG	15	-	5	GGC
gi|514486632|gb|KE346360.1|	2269065	2269080	ATGCCC	15	-	2	GGCATG
gi|514486632|gb|KE346360.1|	2270508	2270525	ACTCGG	17	-	2	AGTCCG
gi|514486632|gb|KE346360.1|	2275030	2275044	ACAGCAG	14	-	2	TCTGCTG
gi|514486632|gb|KE346360.1|	2276433	2276448	AGC	15	+	5	GCA
gi|514486632|gb|KE346360.1|	2276556	2276570	AGC	14	+	4	CAG
gi|514486632|gb|KE346360.1|	2277413	2277436	ACG	23	-	7	TCG
gi|514486632|gb|KE346360.1|	2278098	2278117	AC	19	+	9	AC
gi|514486632|gb|KE346360.1|	2278869	2278884	ACAGCG	15	+	2	GACAGC
gi|514486632|gb|KE346360.1|	2280975	2280990	AAAAAC	15	+	2	AAAACA
gi|514486632|gb|KE346360.1|	2281076	2281103	AAC	27	+	9	ACA
gi|514486632|gb|KE346360.1|	2281159	2281174	A	15	+	15	A
gi|514486632|gb|KE346360.1|	2281312	2281328	AAGGATT	16	+	2	GGATTAA
gi|514486632|gb|KE346360.1|	2281455	2281469	AACAGCC	14	+	2	CAACAGC
gi|514486632|gb|KE346360.1|	2281631	2281652	A	21	+	21	A
gi|514486632|gb|KE346360.1|	2283358	2283383	A	25	+	25	A
gi|514486632|gb|KE346360.1|	2283452	2283468	AAC	16	+	5	AAC
gi|514486632|gb|KE346360.1|	2283882	2283899	AAAC	17	+	4	CAAA
gi|514486632|gb|KE346360.1|	2285206	2285221	A	15	+	15	A
gi|514486632|gb|KE346360.1|	2286383	2286398	ACCGATG	15	+	2	CCGATGA
gi|514486632|gb|KE346360.1|	2287658	2287678	AAAAAAG	20	+	2	AAAAAAG
gi|514486632|gb|KE346360.1|	2288205	2288291	AG	86	+	43	GA
gi|514486632|gb|KE346360.1|	2288697	2288711	AAAAGTC	14	-	2	TTTTGAC
gi|514486632|gb|KE346360.1|	2292048	2292062	AAAAT	14	+	2	AAAAT
gi|514486632|gb|KE346360.1|	2292168	2292187	AG	19	+	9	GA
gi|514486632|gb|KE346360.1|	2292186	2292205	AC	19	-	9	GT
gi|514486632|gb|KE346360.1|	2292741	2292766	A	25	+	25	A
gi|514486632|gb|KE346360.1|	2292768	2292793	A	25	+	25	A
gi|514486632|gb|KE346360.1|	2293638	2293661	AC	23	+	11	CA
gi|514486632|gb|KE346360.1|	2295719	2295734	AAATGG	15	-	2	ATTTCC
gi|514486632|gb|KE346360.1|	2296550	2296567	AC	17	+	8	CA
gi|514486632|gb|KE346360.1|	2299751	2299775	AG	24	+	12	AG
gi|514486632|gb|KE346360.1|	2300030	2300044	A	14	+	14	A
gi|514486632|gb|KE346360.1|	2300233	2300249	AAACGAG	16	+	2	CGAGAAA
gi|514486632|gb|KE346360.1|	2301074	2301098	AAC	24	+	8	CAA
gi|514486632|gb|KE346360.1|	2301209	2301226	ACAGC	17	+	3	CACAG
gi|514486632|gb|KE346360.1|	2301542	2301560	A	18	+	18	A
gi|514486632|gb|KE346360.1|	2301733	2301757	A	24	-	24	T
gi|514486632|gb|KE346360.1|	2306723	2306737	AACGTC	14	-	2	TTGACG
gi|514486632|gb|KE346360.1|	2306990	2307004	ACGGGCG	14	+	2	CGACGGG
gi|514486632|gb|KE346360.1|	2309050	2309199	AG	149	+	74	AG
gi|514486632|gb|KE346360.1|	2309730	2309854	AG	124	+	62	AG
gi|514486632|gb|KE346360.1|	2309871	2309961	AG	90	+	45	GA
gi|514486632|gb|KE346360.1|	2309961	2309976	AAAGACG	15	+	2	AAAGACG
gi|514486632|gb|KE346360.1|	2312053	2312071	AG	18	+	9	GA
gi|514486632|gb|KE346360.1|	2312262	2312291	AG	29	-	14	CT
gi|514486632|gb|KE346360.1|	2312403	2312419	AGC	16	-	5	CTG
gi|514486632|gb|KE346360.1|	2313133	2313150	AGC	17	+	5	AGC
gi|514486632|gb|KE346360.1|	2315415	2315431	ATCC	16	-	4	GATG
gi|514486632|gb|KE346360.1|	2315468	2315482	AAAAAC	14	+	2	AAAAAC
gi|514486632|gb|KE346360.1|	2317925	2317939	AAAAAG	14	-	2	TTCTTT
gi|514486632|gb|KE346360.1|	2318528	2318545	AACAAG	17	+	2	AACAAG
gi|514486632|gb|KE346360.1|	2319477	2319491	CCG	14	+	4	GCC
gi|514486632|gb|KE346360.1|	2319609	2319635	A	26	-	26	T
gi|514486632|gb|KE346360.1|	2320767	2320781	AACAGC	14	+	2	CAGCAA
gi|514486632|gb|KE346360.1|	2320785	2320802	AAC	17	+	5	CAA
gi|514486632|gb|KE346360.1|	2321540	2321554	ACGGCG	14	+	2	CGGCGA
gi|514486632|gb|KE346360.1|	2323984	2324003	AC	19	+	9	CA
gi|514486632|gb|KE346360.1|	2324004	2324023	AC	19	+	9	CA
gi|514486632|gb|KE346360.1|	2324092	2324106	AAAAAC	14	-	2	TTTGTT
gi|514486632|gb|KE346360.1|	2324512	2324529	AC	17	-	8	TG
gi|514486632|gb|KE346360.1|	2324632	2324647	AACCTTC	15	+	2	CCTTCAA
gi|514486632|gb|KE346360.1|	2325090	2325104	ACCGTGG	14	-	2	TCCACGG
gi|514486632|gb|KE346360.1|	2326095	2326112	AAC	17	-	5	TGT
gi|514486632|gb|KE346360.1|	2326368	2326386	AAAC	18	+	4	CAAA
gi|514486632|gb|KE346360.1|	2330718	2330734	AAAAAG	16	+	2	AAGAAA
gi|514486632|gb|KE346360.1|	2331409	2331425	AATCAGC	16	-	2	TGCTGAT
gi|514486632|gb|KE346360.1|	2331906	2331923	AAC	17	-	5	TGT
gi|514486632|gb|KE346360.1|	2335507	2335522	AGCG	15	-	3	CTCG
gi|514486632|gb|KE346360.1|	2336103	2336117	A	14	-	14	T
gi|514486632|gb|KE346360.1|	2336491	2336506	AACC	15	+	3	CAAC
gi|514486632|gb|KE346360.1|	2336504	2336521	AAAAC	17	+	3	AAACA
gi|514486632|gb|KE346360.1|	2337361	2337389	ACC	28	-	9	GTG
gi|514486632|gb|KE346360.1|	2337961	2337975	AGAGCTC	14	+	2	AGCTCAG
gi|514486632|gb|KE346360.1|	2340234	2340258	A	24	-	24	T
gi|514486632|gb|KE346360.1|	2342587	2342601	ACACGCG	14	-	2	TGTCGCG
gi|514486632|gb|KE346360.1|	2342711	2342729	AGC	18	-	6	TGC
gi|514486632|gb|KE346360.1|	2342814	2342831	AGCCGC	17	-	2	GCTGCG
gi|514486632|gb|KE346360.1|	2343088	2343104	AAAGCC	16	+	2	AAGCCA
gi|514486632|gb|KE346360.1|	2343547	2343576	ATC	29	+	9	CAT
gi|514486632|gb|KE346360.1|	2343609	2343623	AGC	14	+	4	GCA
gi|514486632|gb|KE346360.1|	2343706	2343720	ACC	14	+	4	ACC
gi|514486632|gb|KE346360.1|	2343723	2343746	AGC	23	+	7	CAG
gi|514486632|gb|KE346360.1|	2343753	2343767	AACAGC	14	+	2	CAGCAA
gi|514486632|gb|KE346360.1|	2344266	2344280	AAAAAAC	14	+	2	CAAAAAA
gi|514486632|gb|KE346360.1|	2345726	2345741	AC	15	-	7	GT
gi|514486632|gb|KE346360.1|	2348022	2348038	AACC	16	-	4	GTTG
gi|514486632|gb|KE346360.1|	2348359	2348374	ACG	15	-	5	CGT
gi|514486632|gb|KE346360.1|	2348414	2348429	AAAAAG	15	-	2	TTTTTC
gi|514486632|gb|KE346360.1|	2348989	2349015	A	26	-	26	T
gi|514486632|gb|KE346360.1|	2349130	2349144	AAG	14	-	4	TTC
gi|514486632|gb|KE346360.1|	2349335	2349351	AAG	16	-	5	TTC
gi|514486632|gb|KE346360.1|	2351422	2351445	AGC	23	+	7	CAG
gi|514486632|gb|KE346360.1|	2351917	2351933	AAC	16	+	5	CAA
gi|514486632|gb|KE346360.1|	2351938	2351952	AACAGC	14	+	2	CAACAG
gi|514486632|gb|KE346360.1|	2351956	2351978	AGC	22	+	7	CAG
gi|514486632|gb|KE346360.1|	2352643	2352698	AAAC	55	-	13	TTTG
gi|514486632|gb|KE346360.1|	2353861	2353875	AAAAAGG	14	-	2	TTTTTCC
gi|514486632|gb|KE346360.1|	2353945	2353959	AAAACAC	14	-	2	TGTTTTG
gi|514486632|gb|KE346360.1|	2354149	2354173	A	24	+	24	A
gi|514486632|gb|KE346360.1|	2357810	2357825	AAAGAG	15	+	2	AAAGAG
gi|514486632|gb|KE346360.1|	2358746	2358761	ACCGCC	15	+	2	GCCACC
gi|514486632|gb|KE346360.1|	2358946	2358961	ACC	15	-	5	TGG
gi|514486632|gb|KE346360.1|	2359119	2359138	AGC	19	+	6	CAG
gi|514486632|gb|KE346360.1|	2359202	2359219	ACGAGG	17	-	2	TCCTCG
gi|514486632|gb|KE346360.1|	2359512	2359531	AC	19	+	9	CA
gi|514486632|gb|KE346360.1|	2362976	2362990	ACGAGG	14	+	2	GACGAG
gi|514486632|gb|KE346360.1|	2365177	2365191	ACGCGCC	14	+	2	CGCGCCA
gi|514486632|gb|KE346360.1|	2365397	2365414	AACCCCC	17	-	2	GGGGGTT
gi|514486632|gb|KE346360.1|	2365972	2365990	A	18	-	18	T
gi|514486632|gb|KE346360.1|	2366255	2366270	AGCG	15	-	3	CTCG
gi|514486632|gb|KE346360.1|	2366309	2366324	ACT	15	-	5	AGT
gi|514486632|gb|KE346360.1|	2366408	2366428	A	20	-	20	T
gi|514486632|gb|KE346360.1|	2366745	2366761	AGGGGG	16	+	2	GGAGGG
gi|514486632|gb|KE346360.1|	2368970	2368986	AGCTCC	16	+	2	CAGCTC
gi|514486632|gb|KE346360.1|	2368982	2369001	AGC	19	+	6	CAG
gi|514486632|gb|KE346360.1|	2369131	2369146	AGC	15	+	5	GCA
gi|514486632|gb|KE346360.1|	2369807	2369831	AAAC	24	+	6	CAAA
gi|514486632|gb|KE346360.1|	2369829	2369844	AAAC	15	+	3	AAAC
gi|514486632|gb|KE346360.1|	2370898	2370924	ACG	26	-	8	TCG
gi|514486632|gb|KE346360.1|	2372105	2372119	AAGGGGG	14	-	2	TTCCCCC
gi|514486632|gb|KE346360.1|	2372210	2372231	A	21	-	21	T
gi|514486632|gb|KE346360.1|	2372403	2372417	A	14	-	14	T
gi|514486632|gb|KE346360.1|	2372622	2372636	AAAAT	14	-	2	TATTT
gi|514486632|gb|KE346360.1|	2372634	2372656	AAAAT	22	-	4	TTATT
gi|514486632|gb|KE346360.1|	2372658	2372694	AATG	36	-	9	ATTC
gi|514486632|gb|KE346360.1|	2372707	2372754	AATG	47	-	11	TTCA
gi|514486632|gb|KE346360.1|	2377384	2377401	AGCGGC	17	+	2	GCGGCA
gi|514486632|gb|KE346360.1|	2379941	2379957	AACCCT	16	-	2	AGGGTT
gi|514486632|gb|KE346360.1|	2380360	2380374	AAACC	14	+	2	AACCA
gi|514486632|gb|KE346360.1|	2380425	2380441	ACACAT	16	+	2	CACATA
gi|514486632|gb|KE346360.1|	2380436	2380453	AC	17	+	8	AC
gi|514486632|gb|KE346360.1|	2381900	2381914	AAAAAC	14	-	2	TTTTGT
gi|514486632|gb|KE346360.1|	2382820	2382835	AAAC	15	+	3	AAAC
gi|514486632|gb|KE346360.1|	2382828	2382846	AAAAC	18	+	3	AAACA
gi|514486632|gb|KE346360.1|	2383581	2383599	AATAGC	18	+	3	CAATAG
gi|514486632|gb|KE346360.1|	2385106	2385127	ACG	21	+	7	CGA
gi|514486632|gb|KE346360.1|	2386084	2386098	AG	14	-	7	CT
gi|514486632|gb|KE346360.1|	2386654	2386668	AAAAACC	14	+	2	AAAAACC
gi|514486632|gb|KE346360.1|	2386697	2386712	ACTG	15	+	3	GACT
gi|514486632|gb|KE346360.1|	2387148	2387167	AGGCCG	19	+	3	CCGAGG
gi|514486632|gb|KE346360.1|	2389587	2389602	A	15	+	15	A
gi|514486632|gb|KE346360.1|	2390421	2390444	ACG	23	-	7	GTC
gi|514486632|gb|KE346360.1|	2391957	2391971	AAGCGTG	14	+	2	TGAAGCG
gi|514486632|gb|KE346360.1|	2392298	2392314	AAGCGAC	16	-	2	GCTTGTC
gi|514486632|gb|KE346360.1|	2392473	2392493	AAG	20	+	6	AGA
gi|514486632|gb|KE346360.1|	2394064	2394081	AAAGCAC	17	+	2	CAAAGCA
gi|514486632|gb|KE346360.1|	2394172	2394187	AGCG	15	+	3	GAGC
gi|514486632|gb|KE346360.1|	2394582	2394597	AC	15	+	7	AC
gi|514486632|gb|KE346360.1|	2394596	2394625	A	29	+	29	A
gi|514486632|gb|KE346360.1|	2394954	2394970	AAACAAC	16	+	2	AACAAAC
gi|514486632|gb|KE346360.1|	2395480	2395494	AAAAC	14	+	2	AAAAC
gi|514486632|gb|KE346360.1|	2396292	2396311	ATC	19	+	6	CAT
gi|514486632|gb|KE346360.1|	2396867	2396881	AAC	14	+	4	AAC
gi|514486632|gb|KE346360.1|	2396876	2396894	AAAC	18	+	4	AACA
gi|514486632|gb|KE346360.1|	2397064	2397079	ACGC	15	-	3	TGCG
gi|514486632|gb|KE346360.1|	2397508	2397523	AACGTG	15	+	2	TGAACG
gi|514486632|gb|KE346360.1|	2397895	2397925	A	30	-	30	T
gi|514486632|gb|KE346360.1|	2398172	2398192	A	20	-	20	T
gi|514486632|gb|KE346360.1|	2399179	2399194	ACATCAG	15	-	2	TGTCTGA
gi|514486632|gb|KE346360.1|	2399896	2399970	AC	74	-	37	TG
gi|514486632|gb|KE346360.1|	2401106	2401120	ACCGC	14	-	2	GTGCG
gi|514486632|gb|KE346360.1|	2401758	2401772	AAGGGAG	14	-	2	TCTCCCT
gi|514486632|gb|KE346360.1|	2402343	2402357	AAAAC	14	-	2	TTTTG
gi|514486632|gb|KE346360.1|	2405968	2405985	AAG	17	-	5	TTC
gi|514486632|gb|KE346360.1|	2406001	2406023	AAC	22	+	7	AAC
gi|514486632|gb|KE346360.1|	2406508	2406557	A	49	+	49	A
gi|514486632|gb|KE346360.1|	2406762	2406790	A	28	-	28	T
gi|514486632|gb|KE346360.1|	2407005	2407020	AGC	15	-	5	CTG
gi|514486632|gb|KE346360.1|	2407216	2407320	AC	104	+	52	AC
gi|514486632|gb|KE346360.1|	2407862	2407876	ACAGCT	14	+	2	CAGCTA
gi|514486632|gb|KE346360.1|	2409114	2409129	AAAGAG	15	-	2	TCTTTC
gi|514486632|gb|KE346360.1|	2409712	2409726	AACGAC	14	-	2	GTTGTC
gi|514486632|gb|KE346360.1|	2410118	2410133	A	15	-	15	T
gi|514486632|gb|KE346360.1|	2410207	2410226	AAAAT	19	-	3	TTTTA
gi|514486632|gb|KE346360.1|	2412464	2412479	A	15	+	15	A
gi|514486632|gb|KE346360.1|	2413893	2413907	A	14	+	14	A
gi|514486632|gb|KE346360.1|	2415494	2415509	AG	15	+	7	GA
gi|514486632|gb|KE346360.1|	2415588	2415614	A	26	+	26	A
gi|514486632|gb|KE346360.1|	2415624	2415638	AAACAAC	14	+	2	CAAACAA
gi|514486632|gb|KE346360.1|	2415840	2415855	AGGGGGG	15	+	2	GGGAGGG
gi|514486632|gb|KE346360.1|	2415893	2415912	A	19	-	19	T
gi|514486632|gb|KE346360.1|	2416055	2416072	A	17	-	17	T
gi|514486632|gb|KE346360.1|	2416577	2416591	A	14	+	14	A
gi|514486632|gb|KE346360.1|	2416680	2416694	AGATCTC	14	+	2	ATCTCAG
gi|514486632|gb|KE346360.1|	2417195	2417214	ACC	19	-	6	GGT
gi|514486632|gb|KE346360.1|	2420099	2420114	AGGGG	15	+	3	GGGGA
gi|514486632|gb|KE346360.1|	2420314	2420328	AAAGCAG	14	-	2	TGCTTTC
gi|514486632|gb|KE346360.1|	2420465	2420484	A	19	-	19	T
gi|514486632|gb|KE346360.1|	2420497	2420529	A	32	-	32	T
gi|514486632|gb|KE346360.1|	2420856	2420870	AGCCGC	14	+	2	GCAGCC
gi|514486632|gb|KE346360.1|	2421459	2421476	AGG	17	-	5	CTC
gi|514486632|gb|KE346360.1|	2421613	2421627	A	14	-	14	T
gi|514486632|gb|KE346360.1|	2423434	2423448	AGCCCC	14	+	2	GCCCCA
gi|514486632|gb|KE346360.1|	2423447	2423461	AAC	14	+	4	CAA
gi|514486632|gb|KE346360.1|	2423456	2423473	AACAGC	17	+	2	CAACAG
gi|514486632|gb|KE346360.1|	2423468	2423536	AAC	68	+	22	CAA
gi|514486632|gb|KE346360.1|	2424243	2424271	AGC	28	-	9	CTG
gi|514486632|gb|KE346360.1|	2424455	2424472	AACAGC	17	+	2	CAGCAA
gi|514486632|gb|KE346360.1|	2424947	2424964	AACAGC	17	+	2	CAACAG
gi|514486632|gb|KE346360.1|	2424965	2424982	AGC	17	+	5	CAG
gi|514486632|gb|KE346360.1|	2425316	2425330	AATGTG	14	+	2	AATGTG
gi|514486632|gb|KE346360.1|	2425351	2425371	AGC	20	+	6	GCA
gi|514486632|gb|KE346360.1|	2425406	2425422	AACAGC	16	+	2	CAGCAA
gi|514486632|gb|KE346360.1|	2425451	2425468	AGC	17	+	5	CAG
gi|514486632|gb|KE346360.1|	2425537	2425552	ACCTCC	15	-	2	TGGAGG
gi|514486632|gb|KE346360.1|	2425670	2425687	AACAGC	17	+	2	CAGCAA
gi|514486632|gb|KE346360.1|	2425682	2425705	AGC	23	+	7	CAG
gi|514486632|gb|KE346360.1|	2425703	2425721	AAC	18	+	6	CAA
gi|514486632|gb|KE346360.1|	2428771	2428788	AAAAAC	17	+	2	AAAACA
gi|514486632|gb|KE346360.1|	2431336	2431351	AAAAAAC	15	+	2	ACAAAAA
gi|514486632|gb|KE346360.1|	2431345	2431360	A	15	+	15	A
gi|514486632|gb|KE346360.1|	2432044	2432076	AGC	32	-	10	TGC
gi|514486632|gb|KE346360.1|	2432882	2432904	AGC	22	+	7	GCA
gi|514486632|gb|KE346360.1|	2432929	2432943	AATTCC	14	-	2	TGGAAT
gi|514486632|gb|KE346360.1|	2433039	2433053	A	14	-	14	T
gi|514486632|gb|KE346360.1|	2433148	2433162	ACATGCT	14	+	2	CATGCTA
gi|514486632|gb|KE346360.1|	2433427	2433442	A	15	-	15	T
gi|514486632|gb|KE346360.1|	2433749	2433774	A	25	-	25	T
gi|514486632|gb|KE346360.1|	2433973	2433998	A	25	+	25	A
gi|514486632|gb|KE346360.1|	2434963	2434985	AAAC	22	-	5	TTGT
gi|514486632|gb|KE346360.1|	2435265	2435280	ACCCT	15	-	3	GGTAG
gi|514486632|gb|KE346360.1|	2435521	2435537	AGG	16	+	5	GAG
gi|514486632|gb|KE346360.1|	2435614	2435628	ATGCCC	14	+	2	CCCATG
gi|514486632|gb|KE346360.1|	2437046	2437060	ACTGC	14	+	2	TGCAC
gi|514486632|gb|KE346360.1|	2437194	2437211	A	17	-	17	T
gi|514486632|gb|KE346360.1|	2437212	2437231	A	19	-	19	T
gi|514486632|gb|KE346360.1|	2437242	2437258	A	16	-	16	T
gi|514486632|gb|KE346360.1|	2437268	2437283	A	15	-	15	T
gi|514486632|gb|KE346360.1|	2437550	2437565	AGGGGGG	15	-	2	CCCTCCC
gi|514486632|gb|KE346360.1|	2437718	2437738	AG	20	+	10	AG
gi|514486632|gb|KE346360.1|	2442632	2442652	ATC	20	-	6	TGA
gi|514486632|gb|KE346360.1|	2442698	2442712	AAACAAC	14	+	2	CAACAAA
gi|514486632|gb|KE346360.1|	2444852	2444866	ACCGTGC	14	+	2	CCGTGCA
gi|514486632|gb|KE346360.1|	2446776	2446794	ACG	18	-	6	TCG
gi|514486632|gb|KE346360.1|	2447533	2447556	AAAC	23	-	5	TTGT
gi|514486632|gb|KE346360.1|	2448236	2448251	AACCCC	15	-	2	TGGGGT
gi|514486632|gb|KE346360.1|	2449197	2449215	AGC	18	-	6	CTG
gi|514486632|gb|KE346360.1|	2450248	2450264	AATGATG	16	-	2	TCATCAT
gi|514486632|gb|KE346360.1|	2452104	2452118	ATGCC	14	+	2	GCCAT
gi|514486632|gb|KE346360.1|	2453296	2453310	AAGCGC	14	-	2	TGCGCT
gi|514486632|gb|KE346360.1|	2453369	2453387	AAC	18	-	6	TGT
gi|514486632|gb|KE346360.1|	2454711	2454732	ACCCTG	21	-	3	GGTCAG
gi|514486632|gb|KE346360.1|	2454737	2454751	ACCCG	14	-	2	TCGGG
gi|514486632|gb|KE346360.1|	2454851	2454865	AACACTC	14	-	2	TGTTGAG
gi|514486632|gb|KE346360.1|	2454920	2454942	ACACGC	22	+	3	CACACG
gi|514486632|gb|KE346360.1|	2454951	2454971	ACACGGC	20	+	2	GGCACAC
gi|514486632|gb|KE346360.1|	2454987	2455003	A	16	+	16	A
gi|514486632|gb|KE346360.1|	2455062	2455084	AAGCAGG	22	+	3	GAAGCAG
gi|514486632|gb|KE346360.1|	2455105	2455126	ACTGATG	21	+	3	CTGATGA
gi|514486632|gb|KE346360.1|	2455206	2455230	A	24	+	24	A
gi|514486632|gb|KE346360.1|	2455335	2455368	AAACAAC	33	-	4	TTGTTTG
gi|514486632|gb|KE346360.1|	2455386	2455403	AAATGTC	17	+	2	AAATGTC
gi|514486632|gb|KE346360.1|	2456032	2456055	ATC	23	+	7	TCA
gi|514486632|gb|KE346360.1|	2456456	2456472	ACC	16	+	5	ACC
gi|514486632|gb|KE346360.1|	2459936	2459952	ACGCCG	16	-	2	CGTCGG
gi|514486632|gb|KE346360.1|	2460662	2460676	AAGAGC	14	-	2	TGCTCT
gi|514486632|gb|KE346360.1|	2462675	2462697	AAAACAT	22	-	3	TTATGTT
gi|514486632|gb|KE346360.1|	2463582	2463605	AACAGC	23	-	3	TGTTGC
gi|514486632|gb|KE346360.1|	2463618	2463632	AAC	14	-	4	TGT
gi|514486632|gb|KE346360.1|	2464528	2464546	AAC	18	+	6	CAA
gi|514486632|gb|KE346360.1|	2465228	2465245	A	17	-	17	T
gi|514486632|gb|KE346360.1|	2465300	2465314	AAAAC	14	+	2	AAAAC
gi|514486632|gb|KE346360.1|	2465310	2465328	A	18	+	18	A
gi|514486632|gb|KE346360.1|	2465468	2465493	AAC	25	+	8	AAC
gi|514486632|gb|KE346360.1|	2465780	2465794	ACG	14	-	4	TCG
gi|514486632|gb|KE346360.1|	2465792	2465809	ATC	17	+	5	TCA
gi|514486632|gb|KE346360.1|	2465933	2465947	ACCCCTC	14	+	2	CACCCCT
gi|514486632|gb|KE346360.1|	2466030	2466044	AAGCTG	14	-	2	CAGCTT
gi|514486632|gb|KE346360.1|	2466284	2466298	ACTG	14	+	3	GACT
gi|514486632|gb|KE346360.1|	2468486	2468503	ACG	17	-	5	TCG
gi|514486632|gb|KE346360.1|	2469645	2469661	AGCCTC	16	+	2	CAGCCT
gi|514486632|gb|KE346360.1|	2472985	2472999	AAAAT	14	-	2	ATTTT
gi|514486632|gb|KE346360.1|	2473287	2473307	AAAAAAG	20	-	2	TTTTTTC
gi|514486632|gb|KE346360.1|	2474753	2474768	AATGGAT	15	-	2	TCCATTA
gi|514486632|gb|KE346360.1|	2474837	2474863	A	26	-	26	T
gi|514486632|gb|KE346360.1|	2474860	2474880	AAACC	20	-	4	TTTGG
gi|514486632|gb|KE346360.1|	2475052	2475086	A	34	-	34	T
gi|514486632|gb|KE346360.1|	2475265	2475283	A	18	+	18	A
gi|514486632|gb|KE346360.1|	2481629	2481645	AGCGGGG	16	-	2	CCGCTCC
gi|514486632|gb|KE346360.1|	2482035	2482060	ATC	25	-	8	TGA
gi|514486632|gb|KE346360.1|	2482510	2482528	AAT	18	+	6	AAT
gi|514486632|gb|KE346360.1|	2482966	2482984	AAAAAAG	18	-	2	TTTTCTT
gi|514486632|gb|KE346360.1|	2487199	2487214	AC	15	-	7	GT
gi|514486632|gb|KE346360.1|	2488048	2488062	AAC	14	-	4	TGT
gi|514486632|gb|KE346360.1|	2491643	2491657	ACTGCT	14	-	2	AGCAGT
gi|514486632|gb|KE346360.1|	2491652	2491667	ACT	15	-	5	AGT
gi|514486632|gb|KE346360.1|	2492103	2492119	ACGGGAG	16	+	2	GGAGACG
gi|514486632|gb|KE346360.1|	2492435	2492462	A	27	+	27	A
gi|514486632|gb|KE346360.1|	2493641	2493655	ACG	14	-	4	CGT
gi|514486632|gb|KE346360.1|	2493813	2493827	AAGGGC	14	-	2	GCCCTT
gi|514486632|gb|KE346360.1|	2495918	2495932	ACTGCC	14	+	2	CACTGC
gi|514486632|gb|KE346360.1|	2496178	2496195	AGCGGC	17	+	2	GCGGCA
gi|514486632|gb|KE346360.1|	2496309	2496324	ACG	15	-	5	TCG
gi|514486632|gb|KE346360.1|	2496850	2496865	ACAGCGC	15	-	2	TGTGCGC
gi|514486632|gb|KE346360.1|	2499952	2499966	ATCATG	14	+	2	ATGATC
gi|514486632|gb|KE346360.1|	2502770	2502784	ACGGCG	14	-	2	GTCGCC
gi|514486632|gb|KE346360.1|	2502790	2502821	AGC	31	+	10	AGC
gi|514486632|gb|KE346360.1|	2503054	2503068	AAGCGG	14	+	2	AGCGGA
gi|514486632|gb|KE346360.1|	2503150	2503164	AGC	14	-	4	CTG
gi|514486632|gb|KE346360.1|	2503402	2503425	AGC	23	-	7	GCT
gi|514486632|gb|KE346360.1|	2503430	2503444	AGC	14	-	4	TGC
gi|514486632|gb|KE346360.1|	2503594	2503608	A	14	+	14	A
gi|514486632|gb|KE346360.1|	2503840	2503854	AAAAG	14	-	2	TTTTC
gi|514486632|gb|KE346360.1|	2503847	2503863	AAAAAG	16	-	2	TTCTTT
gi|514486632|gb|KE346360.1|	2505945	2505960	A	15	-	15	T
gi|514486632|gb|KE346360.1|	2505961	2505975	A	14	-	14	T
gi|514486632|gb|KE346360.1|	2505976	2505998	A	22	-	22	T
gi|514486632|gb|KE346360.1|	2507980	2507995	AAC	15	-	5	TGT
gi|514486632|gb|KE346360.1|	2508332	2508355	AC	23	+	11	CA
gi|514486632|gb|KE346360.1|	2509829	2509849	CCG	20	-	6	GCG
gi|514486632|gb|KE346360.1|	2511590	2511604	ACGCGG	14	+	2	GCGGAC
gi|514486632|gb|KE346360.1|	2512319	2512336	AGG	17	-	5	TCC
gi|514486632|gb|KE346360.1|	2514603	2514620	A	17	+	17	A
gi|514486632|gb|KE346360.1|	2514937	2514954	A	17	+	17	A
gi|514486632|gb|KE346360.1|	2515219	2515233	AAAATC	14	+	2	CAAAAT
gi|514486632|gb|KE346360.1|	2515361	2515376	AGC	15	-	5	CTG
gi|514486632|gb|KE346360.1|	2515629	2515655	AAACAAC	26	+	3	AACAAAC
gi|514486632|gb|KE346360.1|	2515819	2515833	AAAATGG	14	+	2	AAATGGA
gi|514486632|gb|KE346360.1|	2517760	2517774	ACC	14	+	4	CCA
gi|514486632|gb|KE346360.1|	2517774	2517792	AGC	18	+	6	GCA
gi|514486632|gb|KE346360.1|	2517837	2517857	AGC	20	+	6	CAG
gi|514486632|gb|KE346360.1|	2518296	2518311	A	15	-	15	T
gi|514486632|gb|KE346360.1|	2518314	2518330	AAAGAAG	16	-	2	TTCTTTC
gi|514486632|gb|KE346360.1|	2518491	2518508	AAAAAG	17	-	2	TTTTTC
gi|514486632|gb|KE346360.1|	2518503	2518519	A	16	-	16	T
gi|514486632|gb|KE346360.1|	2518688	2518704	A	16	-	16	T
gi|514486632|gb|KE346360.1|	2519955	2519972	AGCCTC	17	-	2	CTGAGG
gi|514486632|gb|KE346360.1|	2520061	2520075	ATCATCC	14	-	2	GATGATG
gi|514486632|gb|KE346360.1|	2520546	2520569	AC	23	+	11	CA
gi|514486632|gb|KE346360.1|	2522504	2522521	ACC	17	-	5	TGG
gi|514486632|gb|KE346360.1|	2524783	2524797	AACGAG	14	-	2	TCGTTC
gi|514486632|gb|KE346360.1|	2526771	2526785	A	14	+	14	A
gi|514486632|gb|KE346360.1|	2527350	2527364	AC	14	-	7	TG
gi|514486632|gb|KE346360.1|	2528070	2528102	AAAC	32	-	8	TTTG
gi|514486632|gb|KE346360.1|	2530056	2530072	AATGATG	16	+	2	TGATGAA
gi|514486632|gb|KE346360.1|	2532918	2532933	AGAGCGG	15	+	2	GCGGAGA
gi|514486632|gb|KE346360.1|	2536236	2536257	ACG	21	+	7	CGA
gi|514486632|gb|KE346360.1|	2536252	2536269	ACGAGG	17	+	2	GACGAG
gi|514486632|gb|KE346360.1|	2536553	2536568	AAG	15	+	5	AAG
gi|514486632|gb|KE346360.1|	2536613	2536630	ACTGCT	17	+	2	CTGCTA
gi|514486632|gb|KE346360.1|	2536625	2536645	AGC	20	-	6	CTG
gi|514486632|gb|KE346360.1|	2536719	2536733	A	14	+	14	A
gi|514486632|gb|KE346360.1|	2536770	2536785	A	15	+	15	A
gi|514486632|gb|KE346360.1|	2536788	2536804	A	16	+	16	A
gi|514486632|gb|KE346360.1|	2537140	2537156	AGGGC	16	+	3	GCAGG
gi|514486632|gb|KE346360.1|	2537379	2537395	AG	16	-	8	TC
gi|514486632|gb|KE346360.1|	2539581	2539597	A	16	+	16	A
gi|514486632|gb|KE346360.1|	2539693	2539711	ACAGGCG	18	+	2	AGGCGAC
gi|514486632|gb|KE346360.1|	2540133	2540148	AAAAATC	15	-	2	TTGATTT
gi|514486632|gb|KE346360.1|	2540292	2540310	AGG	18	+	6	AGG
gi|514486632|gb|KE346360.1|	2541161	2541175	AACGAC	14	+	2	ACGACA
gi|514486632|gb|KE346360.1|	2541173	2541191	AACGAC	18	+	3	ACAACG
gi|514486632|gb|KE346360.1|	2542731	2542749	ACTC	18	-	4	TGAG
gi|514486632|gb|KE346360.1|	2542937	2542953	ACCGCC	16	+	2	CCGCCA
gi|514486632|gb|KE346360.1|	2543177	2543191	AGGC	14	+	3	AGGC
gi|514486632|gb|KE346360.1|	2543807	2543821	AAGACG	14	+	2	GAAGAC
gi|514486632|gb|KE346360.1|	2544457	2544478	AGC	21	+	7	CAG
gi|514486632|gb|KE346360.1|	2544476	2544492	AATAGT	16	+	2	AGTAAT
gi|514486632|gb|KE346360.1|	2544487	2544501	ACT	14	-	4	TAG
gi|514486632|gb|KE346360.1|	2548143	2548163	AAT	20	+	6	AAT
gi|514486632|gb|KE346360.1|	2548168	2548184	AAAAAAG	16	+	2	AAAAAGA
gi|514486632|gb|KE346360.1|	2548932	2548953	AAACGG	21	+	3	CGGAAA
gi|514486632|gb|KE346360.1|	2549133	2549148	AAAAC	15	+	3	AAAAC
gi|514486632|gb|KE346360.1|	2549393	2549408	AATCCAG	15	+	2	ATCCAGA
gi|514486632|gb|KE346360.1|	2549869	2549889	ACGAGG	20	-	3	CCTCGT
gi|514486632|gb|KE346360.1|	2551064	2551079	AAAC	15	-	3	TTTG
gi|514486632|gb|KE346360.1|	2551072	2551086	AAAAAC	14	-	2	TTTGTT
gi|514486632|gb|KE346360.1|	2551436	2551454	AGC	18	+	6	AGC
gi|514486632|gb|KE346360.1|	2551883	2551897	ACGATG	14	-	2	TCATCG
gi|514486632|gb|KE346360.1|	2552652	2552671	AGC	19	-	6	CTG
gi|514486632|gb|KE346360.1|	2553176	2553192	ATC	16	-	5	GAT
gi|514486632|gb|KE346360.1|	2554807	2554821	A	14	+	14	A
gi|514486632|gb|KE346360.1|	2556354	2556374	ATC	20	-	6	GAT
gi|514486632|gb|KE346360.1|	2556801	2556815	AAGCGC	14	-	2	CTTGCG
gi|514486632|gb|KE346360.1|	2557425	2557450	ACAG	25	-	6	GTCT
gi|514486632|gb|KE346360.1|	2558375	2558391	A	16	+	16	A
gi|514486632|gb|KE346360.1|	2558661	2558679	AAAGCC	18	-	3	TTGGCT
gi|514486632|gb|KE346360.1|	2560081	2560105	AGC	24	-	8	GCT
gi|514486632|gb|KE346360.1|	2560101	2560117	AAAAAGC	16	-	2	TGCTTTT
gi|514486632|gb|KE346360.1|	2560619	2560637	A	18	-	18	T
gi|514486632|gb|KE346360.1|	2560861	2560886	AC	25	+	12	CA
gi|514486632|gb|KE346360.1|	2561311	2561325	ACACGTC	14	-	2	GTGTGAC
gi|514486632|gb|KE346360.1|	2561390	2561405	AAGATGC	15	-	2	TTGCATC
gi|514486632|gb|KE346360.1|	2564023	2564037	AAAAAAC	14	-	2	TTTTTTG
gi|514486632|gb|KE346360.1|	2564238	2564263	A	25	-	25	T
gi|514486632|gb|KE346360.1|	2564308	2564328	AG	20	-	10	TC
gi|514486632|gb|KE346360.1|	2565559	2565573	ACC	14	+	4	CAC
gi|514486632|gb|KE346360.1|	2565568	2565585	ACCAGC	17	+	2	CACCAG
gi|514486632|gb|KE346360.1|	2567384	2567398	AAACCAC	14	-	2	TGGTTTG
gi|514486632|gb|KE346360.1|	2567696	2567710	AAG	14	+	4	GAA
gi|514486632|gb|KE346360.1|	2568609	2568623	ATCGCCG	14	-	2	TCGGCGA
gi|514486632|gb|KE346360.1|	2569580	2569595	AAAC	15	+	3	AAAC
gi|514486632|gb|KE346360.1|	2570066	2570080	AGAGCC	14	-	2	TGGCTC
gi|514486632|gb|KE346360.1|	2570297	2570337	AGC	40	-	13	CTG
gi|514486632|gb|KE346360.1|	2570576	2570591	AGCCAT	15	+	2	CCATAG
gi|514486632|gb|KE346360.1|	2570698	2570712	AAGCAG	14	+	2	AGCAGA
gi|514486632|gb|KE346360.1|	2570882	2570899	ACC	17	+	5	CCA
gi|514486632|gb|KE346360.1|	2571365	2571379	AGC	14	-	4	TGC
gi|514486632|gb|KE346360.1|	2573338	2573353	AAG	15	+	5	AGA
gi|514486632|gb|KE346360.1|	2573411	2573425	AACACC	14	-	2	TGGTGT
gi|514486632|gb|KE346360.1|	2573426	2573440	AACAGC	14	-	2	TGCTGT
gi|514486632|gb|KE346360.1|	2573531	2573545	AACAGC	14	-	2	GCTGTT
gi|514486632|gb|KE346360.1|	2574383	2574399	A	16	+	16	A
gi|514486632|gb|KE346360.1|	2574594	2574628	A	34	-	34	T
gi|514486632|gb|KE346360.1|	2574708	2574725	ACTC	17	-	4	GAGT
gi|514486632|gb|KE346360.1|	2574722	2574736	AC	14	-	7	GT
gi|514486632|gb|KE346360.1|	2576910	2576926	AAAAC	16	-	3	TTGTT
gi|514486632|gb|KE346360.1|	2578131	2578172	AC	41	+	20	CA
gi|514486632|gb|KE346360.1|	2578171	2578187	AG	16	-	8	CT
gi|514486632|gb|KE346360.1|	2578665	2578688	AAC	23	-	7	TTG
gi|514486632|gb|KE346360.1|	2578681	2578695	AAACAAC	14	-	2	TGTTGTT
gi|514486632|gb|KE346360.1|	2579157	2579173	AAAAGAC	16	-	2	TTTTGTC
gi|514486632|gb|KE346360.1|	2579269	2579288	A	19	-	19	T
gi|514486632|gb|KE346360.1|	2579452	2579472	ACCACTC	20	-	2	GAGTGGT
gi|514486632|gb|KE346360.1|	2579516	2579542	A	26	+	26	A
gi|514486632|gb|KE346360.1|	2579741	2579757	ACAGTC	16	-	2	GTGACT
gi|514486632|gb|KE346360.1|	2579860	2579880	AAGGGG	20	+	3	GGGAAG
gi|514486632|gb|KE346360.1|	2580237	2580251	AAAAAGG	14	-	2	TTTTTCC
gi|514486632|gb|KE346360.1|	2580599	2580617	AAAAAAC	18	-	2	TTTTGTT
gi|514486632|gb|KE346360.1|	2580927	2580942	AAAAAC	15	+	2	AACAAA
gi|514486632|gb|KE346360.1|	2582164	2582181	AGAGCG	17	+	2	GAGAGC
gi|514486632|gb|KE346360.1|	2582828	2582846	ACGCAG	18	+	3	GCAGAC
gi|514486632|gb|KE346360.1|	2582876	2582896	AGC	20	+	6	GCA
gi|514486632|gb|KE346360.1|	2582959	2582974	AGC	15	+	5	AGC
gi|514486632|gb|KE346360.1|	2583159	2583174	ACC	15	-	5	GTG
gi|514486632|gb|KE346360.1|	2583202	2583222	AGG	20	+	6	AGG
gi|514486632|gb|KE346360.1|	2583648	2583663	ACACACC	15	-	2	GTGTGGT
gi|514486632|gb|KE346360.1|	2584540	2584611	AC	71	-	35	GT
gi|514486632|gb|KE346360.1|	2586526	2586551	A	25	+	25	A
gi|514486632|gb|KE346360.1|	2586771	2586788	A	17	-	17	T
gi|514486632|gb|KE346360.1|	2587548	2587563	AAAC	15	+	3	AAAC
gi|514486632|gb|KE346360.1|	2589479	2589493	ACGCTCG	14	+	2	GCTCGAC
gi|514486632|gb|KE346360.1|	2590028	2590052	A	24	-	24	T
gi|514486632|gb|KE346360.1|	2593045	2593059	AGC	14	-	4	TGC
gi|514486632|gb|KE346360.1|	2593718	2593737	AAAAC	19	-	3	TTTTG
gi|514486632|gb|KE346360.1|	2595177	2595192	AAAAAT	15	-	2	TTTATT
gi|514486632|gb|KE346360.1|	2595185	2595200	AAAAAAT	15	-	2	TATTTTT
gi|514486632|gb|KE346360.1|	2595607	2595628	AGC	21	+	7	CAG
gi|514486632|gb|KE346360.1|	2595709	2595734	ACAGGG	25	-	4	GTCCCT
gi|514486632|gb|KE346360.1|	2596088	2596117	AC	29	-	14	GT
gi|514486632|gb|KE346360.1|	2596157	2596173	AAAGAC	16	-	2	TGTCTT
gi|514486632|gb|KE346360.1|	2596447	2596474	A	27	-	27	T
gi|514486632|gb|KE346360.1|	2597296	2597313	ACTCGG	17	+	2	TCGGAC
gi|514486632|gb|KE346360.1|	2597903	2597921	AAAAAAC	18	-	2	TTTTTGT
gi|514486632|gb|KE346360.1|	2599871	2599886	AG	15	-	7	CT
gi|514486632|gb|KE346360.1|	2600432	2600446	AAGCGC	14	+	2	AGCGCA
gi|514486632|gb|KE346360.1|	2602215	2602238	AG	23	+	11	AG
gi|514486632|gb|KE346360.1|	2604756	2604770	ACG	14	+	4	GAC
gi|514486632|gb|KE346360.1|	2607437	2607452	ACACACG	15	-	2	GTGTGTC
gi|514486632|gb|KE346360.1|	2607498	2607512	AACAAGC	14	+	2	AAGCAAC
gi|514486632|gb|KE346360.1|	2608719	2608736	AGG	17	+	5	GAG
gi|514486632|gb|KE346360.1|	2608737	2608751	AGG	14	+	4	GAG
gi|514486632|gb|KE346360.1|	2608895	2608913	ACG	18	-	6	CGT
gi|514486632|gb|KE346360.1|	2608929	2608944	ACTCCTC	15	-	2	GAGGAGT
gi|514486632|gb|KE346360.1|	2609123	2609147	AAAAAAC	24	+	3	AAACAAA
gi|514486632|gb|KE346360.1|	2609451	2609468	AGC	17	+	5	GCA
gi|514486632|gb|KE346360.1|	2612824	2612849	ATC	25	+	8	ATC
gi|514486632|gb|KE346360.1|	2613000	2613016	AAAGC	16	-	3	GCTTT
gi|514486632|gb|KE346360.1|	2613110	2613129	A	19	-	19	T
gi|514486632|gb|KE346360.1|	2613433	2613447	AGC	14	-	4	TGC
gi|514486632|gb|KE346360.1|	2613551	2613566	AAGAATG	15	+	2	AATGAAG
gi|514486632|gb|KE346360.1|	2613768	2613784	ACTC	16	+	4	TCAC
gi|514486632|gb|KE346360.1|	2614123	2614137	ACGAGC	14	-	2	CGTGCT
gi|514486632|gb|KE346360.1|	2614180	2614197	AGC	17	+	5	CAG
gi|514486632|gb|KE346360.1|	2615084	2615098	AAC	14	-	4	GTT
gi|514486632|gb|KE346360.1|	2617355	2617369	AAGCGGC	14	-	2	CGCTTGC
gi|514486632|gb|KE346360.1|	2617766	2617787	ACC	21	+	7	CAC
gi|514486632|gb|KE346360.1|	2619000	2619022	AGG	22	-	7	CCT
gi|514486632|gb|KE346360.1|	2619203	2619218	ATGC	15	+	3	TGCA
gi|514486632|gb|KE346360.1|	2619861	2619882	AG	21	-	10	CT
gi|514486632|gb|KE346360.1|	2620016	2620035	A	19	-	19	T
gi|514486632|gb|KE346360.1|	2620461	2620481	A	20	+	20	A
gi|514486632|gb|KE346360.1|	2620516	2620533	AGC	17	+	5	AGC
gi|514486632|gb|KE346360.1|	2620715	2620729	AGAGAGG	14	-	2	CTCTCTC
gi|514486632|gb|KE346360.1|	2620724	2620738	AGAGAGG	14	-	2	CTCTCTC
gi|514486632|gb|KE346360.1|	2620731	2620751	AG	20	-	10	CT
gi|514486632|gb|KE346360.1|	2620922	2620939	AC	17	+	8	CA
gi|514486632|gb|KE346360.1|	2625242	2625258	AACG	16	-	4	TTCG
gi|514486632|gb|KE346360.1|	2626304	2626325	AAAGCAT	21	+	3	AAAGCAT
gi|514486632|gb|KE346360.1|	2626984	2627000	AGGATG	16	-	2	CATCCT
gi|514486632|gb|KE346360.1|	2627011	2627032	ACAGAG	21	+	3	AGAGAC
gi|514486632|gb|KE346360.1|	2628257	2628273	AGC	16	+	5	CAG
gi|514486632|gb|KE346360.1|	2628281	2628295	AGC	14	+	4	AGC
gi|514486632|gb|KE346360.1|	2629148	2629165	AGCCGC	17	+	2	GCCGCA
gi|514486632|gb|KE346360.1|	2630310	2630325	AAAAT	15	-	3	ATTTT
gi|514486632|gb|KE346360.1|	2630333	2630348	AACAGC	15	-	2	TTGCTG
gi|514486632|gb|KE346360.1|	2630343	2630371	AAC	28	-	9	TGT
gi|514486632|gb|KE346360.1|	2630364	2630378	AAACAAC	14	-	2	TGTTGTT
gi|514486632|gb|KE346360.1|	2631513	2631530	AC	17	-	8	TG
gi|514486632|gb|KE346360.1|	2632092	2632106	ACAGCC	14	+	2	GCCACA
gi|514486632|gb|KE346360.1|	2632335	2632349	ACTGGC	14	-	2	GTGCCA
gi|514486632|gb|KE346360.1|	2632608	2632623	AGCGGC	15	+	2	GCAGCG
gi|514486632|gb|KE346360.1|	2632800	2632817	ATCCCC	17	+	2	ATCCCC
gi|514486632|gb|KE346360.1|	2633642	2633659	ACT	17	+	5	ACT
gi|514486632|gb|KE346360.1|	2633980	2634000	ACG	20	-	6	GTC
gi|514486632|gb|KE346360.1|	2634832	2634855	AC	23	+	11	AC
gi|514486632|gb|KE346360.1|	2634848	2634862	AACACAC	14	+	2	ACACACA
gi|514486632|gb|KE346360.1|	2634855	2634889	AC	34	+	17	AC
gi|514486632|gb|KE346360.1|	2636161	2636177	AGC	16	+	5	GCA
gi|514486632|gb|KE346360.1|	2636450	2636464	A	14	+	14	A
gi|514486632|gb|KE346360.1|	2637719	2637733	AC	14	-	7	TG
gi|514486632|gb|KE346360.1|	2639195	2639218	A	23	-	23	T
gi|514486632|gb|KE346360.1|	2639701	2639715	AAC	14	-	4	TGT
gi|514486632|gb|KE346360.1|	2640720	2640743	AC	23	+	11	AC
gi|514486632|gb|KE346360.1|	2641127	2641146	AGC	19	-	6	TGC
gi|514486632|gb|KE346360.1|	2641156	2641173	ACTCG	17	+	3	CTCGA
gi|514486632|gb|KE346360.1|	2643658	2643672	AAC	14	+	4	ACA
gi|514486632|gb|KE346360.1|	2644326	2644340	ATC	14	+	4	CAT
gi|514486632|gb|KE346360.1|	2644338	2644355	AAC	17	+	5	CAA
gi|514486632|gb|KE346360.1|	2644350	2644373	AACATC	23	+	3	CAACAT
gi|514486632|gb|KE346360.1|	2644643	2644657	AGC	14	+	4	CAG
gi|514486632|gb|KE346360.1|	2646789	2646805	AAAC	16	+	4	AAAC
gi|514486632|gb|KE346360.1|	2649865	2649881	AACGAC	16	+	2	ACGACA
gi|514486632|gb|KE346360.1|	2650052	2650067	AAGGAG	15	+	2	GGAGAA
gi|514486632|gb|KE346360.1|	2651787	2651811	A	24	+	24	A
gi|514486632|gb|KE346360.1|	2651838	2651862	AACTG	24	-	4	CAGTT
gi|514486632|gb|KE346360.1|	2652260	2652276	ACGCAG	16	+	2	GCAGAC
gi|514486632|gb|KE346360.1|	2653119	2653133	ACCTCTG	14	+	2	ACCTCTG
gi|514486632|gb|KE346360.1|	2655572	2655603	A	31	-	31	T
gi|514486632|gb|KE346360.1|	2655598	2655612	AAAAACC	14	-	2	TTTTTGG
gi|514486632|gb|KE346360.1|	2655760	2655781	A	21	-	21	T
gi|514486632|gb|KE346360.1|	2655963	2655983	AAAAAAG	20	+	2	AAAAAAG
gi|514486632|gb|KE346360.1|	2655982	2656006	AAAAAAG	24	+	3	AAAAAAG
gi|514486632|gb|KE346360.1|	2656180	2656195	AAAC	15	+	3	CAAA
gi|514486632|gb|KE346360.1|	2656196	2656222	A	26	-	26	T
gi|514486632|gb|KE346360.1|	2656579	2656598	A	19	-	19	T
gi|514486632|gb|KE346360.1|	2656636	2656657	A	21	-	21	T
gi|514486632|gb|KE346360.1|	2656858	2656872	A	14	-	14	T
gi|514486632|gb|KE346360.1|	2656933	2656950	A	17	-	17	T
gi|514486632|gb|KE346360.1|	2657110	2657124	A	14	-	14	T
gi|514486632|gb|KE346360.1|	2657191	2657212	A	21	-	21	T
gi|514486632|gb|KE346360.1|	2657574	2657588	A	14	-	14	T
gi|514486632|gb|KE346360.1|	2657761	2657788	A	27	-	27	T
gi|514486632|gb|KE346360.1|	2657791	2657816	A	25	-	25	T
gi|514486632|gb|KE346360.1|	2659454	2659470	AAGAGG	16	-	2	CCTCTT
gi|514486632|gb|KE346360.1|	2660807	2660825	A	18	+	18	A
gi|514486632|gb|KE346360.1|	2661544	2661571	AAAAC	27	+	5	AAACA
gi|514486632|gb|KE346360.1|	2662534	2662551	AC	17	-	8	TG
gi|514486632|gb|KE346360.1|	2662546	2662560	ACACAG	14	-	2	TGTGTC
gi|514486632|gb|KE346360.1|	2662597	2662620	A	23	+	23	A
gi|514486632|gb|KE346360.1|	2662634	2662660	A	26	+	26	A
gi|514486632|gb|KE346360.1|	2663124	2663156	AGC	32	-	10	CTG
gi|514486632|gb|KE346360.1|	2665661	2665675	AGC	14	+	4	GCA
gi|514486632|gb|KE346360.1|	2665880	2665899	ACG	19	+	6	GAC
gi|514486632|gb|KE346360.1|	2665924	2665942	AC	18	+	9	CA
gi|514486632|gb|KE346360.1|	2667405	2667422	A	17	-	17	T
gi|514486632|gb|KE346360.1|	2668602	2668619	ACG	17	+	5	CGA
gi|514486632|gb|KE346360.1|	2668620	2668634	ATC	14	-	4	TGA
gi|514486632|gb|KE346360.1|	2671480	2671497	AACCCCC	17	+	2	CAACCCC
gi|514486632|gb|KE346360.1|	2674131	2674147	A	16	+	16	A
gi|514486632|gb|KE346360.1|	2674156	2674170	AAAAAAG	14	+	2	GAAAAAA
gi|514486632|gb|KE346360.1|	2674185	2674207	A	22	-	22	T
gi|514486632|gb|KE346360.1|	2674734	2674748	AGGG	14	+	3	GGAG
gi|514486632|gb|KE346360.1|	2675151	2675181	A	30	+	30	A
gi|514486632|gb|KE346360.1|	2675377	2675400	A	23	+	23	A
gi|514486632|gb|KE346360.1|	2675851	2675876	AC	25	+	12	AC
gi|514486632|gb|KE346360.1|	2678585	2678600	AAGCAGC	15	+	2	AGCAAGC
gi|514486632|gb|KE346360.1|	2679279	2679310	AAC	31	+	10	AAC
gi|514486632|gb|KE346360.1|	2679684	2679700	AAGGGG	16	+	2	GGGAAG
gi|514486632|gb|KE346360.1|	2679870	2679886	AAG	16	+	5	GAA
gi|514486632|gb|KE346360.1|	2681756	2681771	AAAAAAC	15	+	2	AACAAAA
gi|514486632|gb|KE346360.1|	2681794	2681809	AAC	15	+	5	CAA
gi|514486632|gb|KE346360.1|	2682385	2682410	A	25	+	25	A
gi|514486632|gb|KE346360.1|	2684294	2684308	AATCGCC	14	+	2	CCAATCG
gi|514486632|gb|KE346360.1|	2685183	2685203	AAC	20	+	6	CAA
gi|514486632|gb|KE346360.1|	2685814	2685828	AC	14	-	7	TG
gi|514486632|gb|KE346360.1|	2686609	2686623	AAGCTG	14	-	2	TCAGCT
gi|514486632|gb|KE346360.1|	2687480	2687494	CCG	14	+	4	CCG
gi|514486632|gb|KE346360.1|	2687737	2687766	ACGAGG	29	+	4	GACGAG
gi|514486632|gb|KE346360.1|	2687848	2687877	ACG	29	+	9	GAC
gi|514486632|gb|KE346360.1|	2687875	2687897	ATC	22	-	7	GAT
gi|514486632|gb|KE346360.1|	2687913	2687934	ACG	21	+	7	CGA
gi|514486632|gb|KE346360.1|	2691143	2691157	AGC	14	-	4	CTG
gi|514486632|gb|KE346360.1|	2691728	2691743	AAAAAAG	15	+	2	AAAAAAG
gi|514486632|gb|KE346360.1|	2692009	2692030	A	21	+	21	A
gi|514486632|gb|KE346360.1|	2692643	2692661	A	18	+	18	A
gi|514486632|gb|KE346360.1|	2692662	2692677	A	15	+	15	A
gi|514486632|gb|KE346360.1|	2692899	2692915	A	16	+	16	A
gi|514486632|gb|KE346360.1|	2693196	2693210	AGGCCG	14	+	2	GGCCGA
gi|514486632|gb|KE346360.1|	2693984	2694001	AAAAAAC	17	-	2	TTTGTTT
gi|514486632|gb|KE346360.1|	2695385	2695401	AAAC	16	+	4	CAAA
gi|514486632|gb|KE346360.1|	2695995	2696018	AG	23	+	11	GA
gi|514486632|gb|KE346360.1|	2696156	2696179	A	23	+	23	A
gi|514486632|gb|KE346360.1|	2696295	2696315	A	20	-	20	T
gi|514486632|gb|KE346360.1|	2696550	2696570	A	20	-	20	T
gi|514486632|gb|KE346360.1|	2696948	2696962	AGAGC	14	-	2	GCTCT
gi|514486632|gb|KE346360.1|	2697405	2697419	AGCCCCG	14	+	2	CGAGCCC
gi|514486632|gb|KE346360.1|	2701959	2701983	AAAC	24	+	6	CAAA
gi|514486632|gb|KE346360.1|	2703105	2703127	AGC	22	-	7	TGC
gi|514486632|gb|KE346360.1|	2707955	2707969	AAAGAC	14	-	2	TCTTTG
gi|514486632|gb|KE346360.1|	2708362	2708377	AAC	15	-	5	TTG
gi|514486632|gb|KE346360.1|	2708807	2708823	AAAC	16	+	4	CAAA
gi|514486632|gb|KE346360.1|	2709044	2709065	A	21	-	21	T
gi|514486632|gb|KE346360.1|	2709121	2709146	ACG	25	-	8	TCG
gi|514486632|gb|KE346360.1|	2709209	2709227	ACGC	18	+	4	CGCA
gi|514486632|gb|KE346360.1|	2709233	2709252	A	19	-	19	T
gi|514486632|gb|KE346360.1|	2709654	2709670	A	16	-	16	T
gi|514486632|gb|KE346360.1|	2711019	2711033	ACGATG	14	-	2	TCGTCA
gi|514486632|gb|KE346360.1|	2711039	2711061	ATC	22	+	7	ATC
gi|514486632|gb|KE346360.1|	2711062	2711076	ATC	14	+	4	CAT
gi|514486632|gb|KE346360.1|	2711077	2711091	ATC	14	+	4	CAT
gi|514486632|gb|KE346360.1|	2711134	2711153	ACGAGG	19	-	3	CGTCCT
gi|514486632|gb|KE346360.1|	2711575	2711589	ACACTC	14	-	2	GTGTGA
gi|514486632|gb|KE346360.1|	2712380	2712394	ACACGCC	14	-	2	GCGTGTG
gi|514486632|gb|KE346360.1|	2712443	2712459	AAG	16	-	5	CTT
gi|514486632|gb|KE346360.1|	2712634	2712658	A	24	-	24	T
gi|514486632|gb|KE346360.1|	2712672	2712686	AAAACGC	14	-	2	TTTGCGT
gi|514486632|gb|KE346360.1|	2712830	2712846	A	16	+	16	A
gi|514486632|gb|KE346360.1|	2712897	2712913	AAACCC	16	+	2	CCAAAC
gi|514486632|gb|KE346360.1|	2712939	2712954	A	15	+	15	A
gi|514486632|gb|KE346360.1|	2713786	2713800	ACACC	14	+	2	CACAC
gi|514486632|gb|KE346360.1|	2713858	2713876	AC	18	+	9	CA
gi|514486632|gb|KE346360.1|	2714211	2714226	ACG	15	-	5	TCG
gi|514486632|gb|KE346360.1|	2714613	2714627	AAGACG	14	-	2	TCGTCT
gi|514486632|gb|KE346360.1|	2714653	2714672	AGC	19	-	6	TGC
gi|514486632|gb|KE346360.1|	2715395	2715418	AGC	23	-	7	GCT
gi|514486632|gb|KE346360.1|	2715533	2715550	AGCCGC	17	+	2	GCAGCC
gi|514486632|gb|KE346360.1|	2715822	2715838	CCGGCG	16	+	2	CGCCGG
gi|514486632|gb|KE346360.1|	2715879	2715904	CCG	25	-	8	GCG
gi|514486632|gb|KE346360.1|	2719806	2719822	AGGGGG	16	-	2	CCCCCT
gi|514486632|gb|KE346360.1|	2720011	2720027	AACAAGC	16	-	2	TTGTTGC
gi|514486632|gb|KE346360.1|	2721173	2721193	ACCGCC	20	-	3	GGCGGT
gi|514486632|gb|KE346360.1|	2721599	2721618	AG	19	-	9	CT
gi|514486632|gb|KE346360.1|	2721914	2721928	AGC	14	-	4	GCT
gi|514486632|gb|KE346360.1|	2721967	2721992	AGC	25	-	8	TGC
gi|514486632|gb|KE346360.1|	2723632	2723646	ACCCC	14	+	2	CCCCA
gi|514486632|gb|KE346360.1|	2724731	2724748	AACCTC	17	-	2	GGTTGA
gi|514486632|gb|KE346360.1|	2724899	2724914	AGGG	15	+	3	GAGG
gi|514486632|gb|KE346360.1|	2724911	2724925	AG	14	+	7	GA
gi|514486632|gb|KE346360.1|	2724926	2724940	AATGGG	14	-	2	CCCATT
gi|514486632|gb|KE346360.1|	2724980	2724997	ACC	17	+	5	CCA
gi|514486632|gb|KE346360.1|	2725014	2725030	ACTGCG	16	-	2	AGTCGC
gi|514486632|gb|KE346360.1|	2725168	2725194	A	26	+	26	A
gi|514486632|gb|KE346360.1|	2725592	2725610	AGCTC	18	-	3	GCTGA
gi|514486632|gb|KE346360.1|	2727532	2727556	ACC	24	+	8	ACC
gi|514486632|gb|KE346360.1|	2727616	2727631	AAAAAC	15	+	2	AAAACA
gi|514486632|gb|KE346360.1|	2727636	2727651	A	15	+	15	A
gi|514486632|gb|KE346360.1|	2728458	2728472	AACCAAG	14	+	2	AACCAAG
gi|514486632|gb|KE346360.1|	2728864	2728879	A	15	+	15	A
gi|514486632|gb|KE346360.1|	2729542	2729570	A	28	+	28	A
gi|514486632|gb|KE346360.1|	2729891	2729912	AAAC	21	+	5	AAAC
gi|514486632|gb|KE346360.1|	2729913	2729928	AAAC	15	+	3	ACAA
gi|514486632|gb|KE346360.1|	2730205	2730219	A	14	+	14	A
gi|514486632|gb|KE346360.1|	2732320	2732344	AAC	24	-	8	TGT
gi|514486632|gb|KE346360.1|	2732339	2732353	AACCAC	14	-	2	GTTGTG
gi|514486632|gb|KE346360.1|	2732368	2732391	AGC	23	-	7	TGC
gi|514486632|gb|KE346360.1|	2733144	2733172	A	28	+	28	A
gi|514486632|gb|KE346360.1|	2733628	2733649	A	21	+	21	A
gi|514486632|gb|KE346360.1|	2733844	2733858	AAAAG	14	-	2	TTTTC
gi|514486632|gb|KE346360.1|	2733854	2733869	A	15	-	15	T
gi|514486632|gb|KE346360.1|	2733863	2733879	AAAAAAC	16	-	2	TTTTTTG
gi|514486632|gb|KE346360.1|	2733895	2733917	A	22	-	22	T
gi|514486632|gb|KE346360.1|	2734111	2734128	A	17	+	17	A
gi|514486632|gb|KE346360.1|	2734509	2734542	A	33	+	33	A
gi|514486632|gb|KE346360.1|	2735816	2735838	A	22	+	22	A
gi|514486632|gb|KE346360.1|	2736039	2736055	A	16	-	16	T
gi|514486632|gb|KE346360.1|	2736288	2736311	A	23	+	23	A
gi|514486632|gb|KE346360.1|	2736594	2736615	A	21	-	21	T
gi|514486632|gb|KE346360.1|	2736632	2736648	A	16	-	16	T
gi|514486632|gb|KE346360.1|	2736799	2736814	AAAGTC	15	+	2	AAGTCA
gi|514486632|gb|KE346360.1|	2741140	2741154	CCCCG	14	+	2	CCCCG
gi|514486632|gb|KE346360.1|	2742340	2742354	ACCGCG	14	+	2	GCGACC
gi|514486632|gb|KE346360.1|	2743554	2743611	A	57	-	57	T
gi|514486632|gb|KE346360.1|	2744196	2744225	A	29	+	29	A
gi|514486632|gb|KE346360.1|	2745622	2745636	ACTCGC	14	+	2	CTCGCA
gi|514486632|gb|KE346360.1|	2745988	2746013	ACC	25	+	8	CAC
gi|514486632|gb|KE346360.1|	2747290	2747304	AATCCAG	14	-	2	TTCTGGA
gi|514486632|gb|KE346360.1|	2747612	2747641	A	29	-	29	T
gi|514486632|gb|KE346360.1|	2747862	2747881	AAAC	19	+	4	CAAA
gi|514486632|gb|KE346360.1|	2748155	2748178	AGC	23	-	7	TGC
gi|514486632|gb|KE346360.1|	2748176	2748190	AAC	14	-	4	TGT
gi|514486632|gb|KE346360.1|	2748549	2748566	A	17	-	17	T
gi|514486632|gb|KE346360.1|	2748647	2748662	AATGCTC	15	+	2	CTCAATG
gi|514486632|gb|KE346360.1|	2748899	2748926	AGC	27	-	9	GCT
gi|514486632|gb|KE346360.1|	2748948	2748963	AGC	15	-	5	CTG
gi|514486632|gb|KE346360.1|	2752119	2752133	AAC	14	-	4	TTG
gi|514486632|gb|KE346360.1|	2752798	2752853	AC	55	-	27	TG
gi|514486632|gb|KE346360.1|	2753195	2753215	AAG	20	-	6	TTC
gi|514486632|gb|KE346360.1|	2753507	2753526	AAAAAC	19	-	3	GTTTTT
gi|514486632|gb|KE346360.1|	2755392	2755411	A	19	-	19	T
gi|514486632|gb|KE346360.1|	2755785	2755805	A	20	-	20	T
gi|514486632|gb|KE346360.1|	2756023	2756038	AAG	15	-	5	CTT
gi|514486632|gb|KE346360.1|	2756051	2756069	AG	18	-	9	TC
gi|514486632|gb|KE346360.1|	2756518	2756532	AAC	14	+	4	CAA
gi|514486632|gb|KE346360.1|	2757131	2757148	A	17	+	17	A
gi|514486632|gb|KE346360.1|	2758001	2758019	AGC	18	-	6	TGC
gi|514486632|gb|KE346360.1|	2758123	2758139	ACTCGG	16	-	2	AGTCCG
gi|514486632|gb|KE346360.1|	2758201	2758215	AAT	14	+	4	AAT
gi|514486632|gb|KE346360.1|	2758240	2758256	AC	16	-	8	TG
gi|514486632|gb|KE346360.1|	2758582	2758597	AAGCCCC	15	-	2	TGGGGCT
gi|514486632|gb|KE346360.1|	2758963	2758979	AAAAAAC	16	-	2	TTGTTTT
gi|514486632|gb|KE346360.1|	2759041	2759080	AG	39	+	19	AG
gi|514486632|gb|KE346360.1|	2759081	2759111	AG	30	+	15	AG
gi|514486632|gb|KE346360.1|	2759110	2759129	AC	19	-	9	GT
gi|514486632|gb|KE346360.1|	2760305	2760331	AGC	26	+	8	GCA
gi|514486632|gb|KE346360.1|	2761701	2761715	A	14	-	14	T
gi|514486632|gb|KE346360.1|	2761761	2761789	A	28	-	28	T
gi|514486632|gb|KE346360.1|	2761813	2761827	AAG	14	+	4	AGA
gi|514486632|gb|KE346360.1|	2761954	2761977	A	23	+	23	A
gi|514486632|gb|KE346360.1|	2762595	2762609	AAC	14	+	4	AAC
gi|514486632|gb|KE346360.1|	2762607	2762622	A	15	+	15	A
gi|514486632|gb|KE346360.1|	2762630	2762644	AATCCAC	14	-	2	ATTGTGG
gi|514486632|gb|KE346360.1|	2762701	2762716	AAGGGG	15	+	2	GGGGAA
gi|514486632|gb|KE346360.1|	2763127	2763143	AAAACT	16	+	2	AAAACT
gi|514486632|gb|KE346360.1|	2764548	2764572	AC	24	-	12	TG
gi|514486632|gb|KE346360.1|	2766130	2766145	ACTG	15	-	3	CAGT
gi|514486632|gb|KE346360.1|	2766234	2766259	AC	25	-	12	GT
gi|514486632|gb|KE346360.1|	2766434	2766448	AAG	14	-	4	TTC
gi|514486632|gb|KE346360.1|	2766470	2766523	A	53	-	53	T
gi|514486632|gb|KE346360.1|	2766821	2766842	CCG	21	-	7	CGG
gi|514486632|gb|KE346360.1|	2767254	2767274	ACG	20	-	6	TCG
gi|514486632|gb|KE346360.1|	2768958	2768973	AAAAC	15	-	3	GTTTT
gi|514486632|gb|KE346360.1|	2768972	2768987	AAC	15	-	5	TTG
gi|514486632|gb|KE346360.1|	2771561	2771584	AAC	23	-	7	GTT
gi|514486632|gb|KE346360.1|	2771582	2771599	ACC	17	-	5	GTG
gi|514486632|gb|KE346360.1|	2771976	2771991	CCG	15	-	5	CGG
gi|514486632|gb|KE346360.1|	2772608	2772635	A	27	+	27	A
gi|514486632|gb|KE346360.1|	2772651	2772665	AAAACCC	14	-	2	TTTTGGG
gi|514486632|gb|KE346360.1|	2772992	2773017	A	25	+	25	A
gi|514486632|gb|KE346360.1|	2773310	2773324	AATCAC	14	+	2	AATCAC
gi|514486632|gb|KE346360.1|	2773335	2773349	AACTGAG	14	-	2	CTCAGTT
gi|514486632|gb|KE346360.1|	2773343	2773360	AAAACTG	17	-	2	TCAGTTT
gi|514486632|gb|KE346360.1|	2773360	2773389	AACTGAG	29	-	4	TCAGTTC
gi|514486632|gb|KE346360.1|	2773388	2773402	A	14	-	14	T
gi|514486632|gb|KE346360.1|	2774079	2774094	A	15	+	15	A
gi|514486632|gb|KE346360.1|	2775778	2775844	ACG	66	+	22	CGA
gi|514486632|gb|KE346360.1|	2778415	2778430	ACCGCC	15	+	2	CACCGC
gi|514486632|gb|KE346360.1|	2779290	2779305	AAAAAAC	15	-	2	TTTGTTT
gi|514486632|gb|KE346360.1|	2779679	2779693	AACTCG	14	+	2	CTCGAA
gi|514486632|gb|KE346360.1|	2780502	2780519	AGCC	17	-	4	GCTG
gi|514486632|gb|KE346360.1|	2781331	2781346	ATCC	15	+	3	CATC
gi|514486632|gb|KE346360.1|	2781710	2781731	A	21	-	21	T
gi|514486632|gb|KE346360.1|	2782065	2782079	A	14	-	14	T
gi|514486632|gb|KE346360.1|	2782320	2782357	A	37	-	37	T
gi|514486632|gb|KE346360.1|	2782724	2782740	ACTC	16	+	4	CTCA
gi|514486632|gb|KE346360.1|	2782770	2782794	A	24	-	24	T
gi|514486632|gb|KE346360.1|	2782924	2782942	AGC	18	-	6	CTG
gi|514486632|gb|KE346360.1|	2782983	2783088	AG	105	-	52	TC
gi|514486632|gb|KE346360.1|	2783685	2783699	ACCGTCG	14	-	2	GACGGTC
gi|514486632|gb|KE346360.1|	2784981	2785000	AAG	19	-	6	CTT
gi|514486632|gb|KE346360.1|	2785883	2785897	AAGCAGC	14	+	2	AAGCAGC
gi|514486632|gb|KE346360.1|	2786173	2786190	AG	17	-	8	CT
gi|514486632|gb|KE346360.1|	2786455	2786474	A	19	-	19	T
gi|514486632|gb|KE346360.1|	2786469	2786500	AAAAAC	31	-	5	TTTTTG
gi|514486632|gb|KE346360.1|	2787780	2787806	AC	26	+	13	CA
gi|514486632|gb|KE346360.1|	2789407	2789435	AAAAAC	28	-	4	TTTTTG
gi|514486632|gb|KE346360.1|	2794579	2794593	AACCCG	14	-	2	GGTTCG
gi|514486632|gb|KE346360.1|	2794687	2794701	AATGAC	14	-	2	TCATTG
gi|514486632|gb|KE346360.1|	2796028	2796047	AAAAAAT	19	-	2	TTTTTAT
gi|514486632|gb|KE346360.1|	2796049	2796063	AAAAAT	14	-	2	TTATTT
gi|514486632|gb|KE346360.1|	2796111	2796134	AAAAAT	23	-	3	TTTTTA
gi|514486632|gb|KE346360.1|	2796357	2796377	AAAAAAG	20	+	2	AAAAAAG
gi|514486632|gb|KE346360.1|	2796381	2796399	AAAAAAG	18	+	2	AAAAGAA
gi|514486632|gb|KE346360.1|	2797275	2797291	AAAAT	16	+	3	AAAAT
gi|514486632|gb|KE346360.1|	2800106	2800121	AAAT	15	-	3	TTTA
gi|514486632|gb|KE346360.1|	2800131	2800147	AAAAAAT	16	-	2	TTATTTT
gi|514486632|gb|KE346360.1|	2803552	2803587	ACG	35	+	11	GAC
gi|514486632|gb|KE346360.1|	2803644	2803658	AAGCTCG	14	-	2	CGAGCTT
gi|514486632|gb|KE346360.1|	2806434	2806451	AAAAAT	17	+	2	AAAAAT
gi|514486632|gb|KE346360.1|	2806444	2806459	AAAAAAT	15	+	2	ATAAAAA
gi|514486632|gb|KE346360.1|	2806475	2806493	AAAAT	18	+	3	AAAAT
gi|514486632|gb|KE346360.1|	2812291	2812305	AGGCGGC	14	-	2	CCGCCTG
gi|514486632|gb|KE346360.1|	2813219	2813238	ACG	19	-	6	TCG
gi|514486632|gb|KE346360.1|	2813440	2813457	AACGGC	17	-	2	GTTGCC
gi|514486632|gb|KE346360.1|	2813468	2813483	AACGGC	15	-	2	CCGTTG
gi|514486632|gb|KE346360.1|	2814559	2814575	AAATG	16	+	3	AAATG
gi|514486632|gb|KE346360.1|	2816345	2816365	A	20	+	20	A
gi|514486632|gb|KE346360.1|	2816693	2816709	A	16	+	16	A
gi|514486632|gb|KE346360.1|	2817134	2817154	AAACAAG	20	+	2	AAACAAG
gi|514486632|gb|KE346360.1|	2817176	2817191	AAACAAC	15	+	2	AAACAAC
gi|514486632|gb|KE346360.1|	2818238	2818259	A	21	-	21	T
gi|514486632|gb|KE346360.1|	2818618	2818633	AAAACC	15	+	2	CCAAAA
gi|514486632|gb|KE346360.1|	2818629	2818652	ACC	23	+	7	ACC
gi|514486632|gb|KE346360.1|	2819080	2819097	A	17	+	17	A
gi|514486632|gb|KE346360.1|	2820654	2820668	AAAAAAC	14	+	2	ACAAAAA
gi|514486632|gb|KE346360.1|	2820661	2820676	AAAAAC	15	+	2	ACAAAA
gi|514486632|gb|KE346360.1|	2820811	2820827	A	16	-	16	T
gi|514486632|gb|KE346360.1|	2822000	2822054	A	54	+	54	A
gi|514486632|gb|KE346360.1|	2822321	2822335	AAAAG	14	-	2	TTTTC
gi|514486632|gb|KE346360.1|	2822673	2822695	AAC	22	+	7	AAC
gi|514486632|gb|KE346360.1|	2823191	2823205	AGCAGCC	14	-	2	TGGCTGC
gi|514486632|gb|KE346360.1|	2823457	2823475	A	18	-	18	T
gi|514486632|gb|KE346360.1|	2823512	2823529	AAAAAT	17	-	2	TTTTTA
gi|514486632|gb|KE346360.1|	2823581	2823600	AAC	19	-	6	TTG
gi|514486632|gb|KE346360.1|	2823833	2823849	A	16	-	16	T
gi|514486632|gb|KE346360.1|	2824384	2824402	AGC	18	+	6	CAG
gi|514486632|gb|KE346360.1|	2824411	2824425	AGC	14	+	4	CAG
gi|514486632|gb|KE346360.1|	2824429	2824443	AGC	14	+	4	CAG
gi|514486632|gb|KE346360.1|	2826371	2826388	AGC	17	+	5	AGC
gi|514486632|gb|KE346360.1|	2828076	2828114	AATC	38	+	9	CAAT
gi|514486632|gb|KE346360.1|	2829002	2829023	A	21	+	21	A
gi|514486632|gb|KE346360.1|	2829849	2829869	A	20	-	20	T
gi|514486632|gb|KE346360.1|	2830308	2830329	ACC	21	-	7	GGT
gi|514486632|gb|KE346360.1|	2830429	2830446	AGC	17	-	5	TGC
gi|514486632|gb|KE346360.1|	2830467	2830481	ACTC	14	+	3	TCAC
gi|514486632|gb|KE346360.1|	2834169	2834183	AGC	14	-	4	GCT
gi|514486632|gb|KE346360.1|	2834187	2834201	AGGCGG	14	-	2	CCGCCT
gi|514486632|gb|KE346360.1|	2835635	2835650	ACCGCC	15	+	2	CCGCCA
gi|514486632|gb|KE346360.1|	2836736	2836751	AGAGGC	15	-	2	TCTGCC
gi|514486632|gb|KE346360.1|	2838241	2838276	AAC	35	-	11	TTG
gi|514486632|gb|KE346360.1|	2838508	2838532	A	24	-	24	T
gi|514486632|gb|KE346360.1|	2838696	2838711	AAC	15	-	5	GTT
gi|514486632|gb|KE346360.1|	2838927	2838941	ACGG	14	-	3	GTCC
gi|514486632|gb|KE346360.1|	2839706	2839726	A	20	-	20	T
gi|514486632|gb|KE346360.1|	2839740	2839761	AAGG	21	-	5	CCTT
gi|514486632|gb|KE346360.1|	2841599	2841614	AATGTC	15	+	2	TCAATG
gi|514486632|gb|KE346360.1|	2841807	2841821	AAGG	14	-	3	TTCC
gi|514486632|gb|KE346360.1|	2841819	2841840	A	21	-	21	T
gi|514486632|gb|KE346360.1|	2841925	2841955	ATC	30	+	10	TCA
gi|514486632|gb|KE346360.1|	2842257	2842284	A	27	+	27	A
gi|514486632|gb|KE346360.1|	2842589	2842611	AAACCC	22	-	3	GGGTTT
gi|514486632|gb|KE346360.1|	2842612	2842628	AACCCT	16	-	2	GGGTTA
gi|514486632|gb|KE346360.1|	2842761	2842778	AC	17	-	8	GT
gi|514486632|gb|KE346360.1|	2845526	2845544	AG	18	-	9	CT
gi|514486632|gb|KE346360.1|	2848813	2848840	AGC	27	+	9	AGC
gi|514486632|gb|KE346360.1|	2850443	2850457	AAAAGAG	14	+	2	AAAGAGA
gi|514486632|gb|KE346360.1|	2851414	2851432	AG	18	+	9	GA
gi|514486632|gb|KE346360.1|	2853229	2853246	AACAGC	17	-	2	CTGTTG
gi|514486632|gb|KE346360.1|	2853638	2853658	ACT	20	+	6	CTA
gi|514486632|gb|KE346360.1|	2853653	2853667	ACTGCT	14	+	2	CTACTG
gi|514486632|gb|KE346360.1|	2853881	2853899	AAAT	18	+	4	AAAT
gi|514486632|gb|KE346360.1|	2853906	2853920	AAAAG	14	+	2	AAAAG
gi|514486632|gb|KE346360.1|	2854247	2854262	AGC	15	+	5	AGC
gi|514486632|gb|KE346360.1|	2854600	2854615	AAGGGG	15	+	2	GGGGAA
gi|514486632|gb|KE346360.1|	2858018	2858042	ACG	24	+	8	CGA
gi|514486632|gb|KE346360.1|	2860780	2860799	AAAC	19	-	4	TTGT
gi|514486632|gb|KE346360.1|	2861123	2861141	AAAATTG	18	-	2	TCAATTT
gi|514486632|gb|KE346360.1|	2861248	2861262	ACGATGC	14	+	2	CACGATG
gi|514486632|gb|KE346360.1|	2861408	2861428	AG	20	-	10	CT
gi|514486632|gb|KE346360.1|	2862218	2862237	AC	19	+	9	CA
gi|514486632|gb|KE346360.1|	2862236	2862293	AG	57	-	28	CT
gi|514486632|gb|KE346360.1|	2862789	2862806	AAAT	17	-	4	TATT
gi|514486632|gb|KE346360.1|	2862799	2862820	AAAAAT	21	-	3	TTTATT
gi|514486632|gb|KE346360.1|	2862847	2862870	A	23	-	23	T
gi|514486632|gb|KE346360.1|	2863270	2863285	ACCG	15	-	3	CGGT
gi|514486632|gb|KE346360.1|	2863424	2863457	AAAAAAT	33	-	4	TTTTTTA
gi|514486632|gb|KE346360.1|	2863452	2863485	AAAAAAT	33	-	4	TTTTTAT
gi|514486632|gb|KE346360.1|	2863491	2863505	AAAAAT	14	-	2	TTTATT
gi|514486632|gb|KE346360.1|	2863702	2863731	A	29	+	29	A
gi|514486632|gb|KE346360.1|	2863769	2863786	AAAAAAT	17	+	2	AAAATAA
gi|514486632|gb|KE346360.1|	2863970	2863984	A	14	+	14	A
gi|514486632|gb|KE346360.1|	2863997	2864015	A	18	+	18	A
gi|514486632|gb|KE346360.1|	2864194	2864209	A	15	+	15	A
gi|514486632|gb|KE346360.1|	2864205	2864227	AAAATC	22	+	3	AAAATC
gi|514486632|gb|KE346360.1|	2864448	2864465	AACGTG	17	+	2	GTGAAC
gi|514486632|gb|KE346360.1|	2864501	2864518	AACGTG	17	+	2	GTGAAC
gi|514486632|gb|KE346360.1|	2864525	2864561	AC	36	-	18	GT
gi|514486632|gb|KE346360.1|	2864910	2864927	AACAG	17	-	3	TGTTC
gi|514486632|gb|KE346360.1|	2866258	2866278	AAAC	20	-	5	TTTG
gi|514486632|gb|KE346360.1|	2866279	2866294	AAAC	15	-	3	TTGT
gi|514486632|gb|KE346360.1|	2866627	2866641	AAAAG	14	-	2	TTTTC
gi|514486632|gb|KE346360.1|	2866637	2866653	A	16	-	16	T
gi|514486632|gb|KE346360.1|	2868804	2868826	AGC	22	+	7	GCA
gi|514486632|gb|KE346360.1|	2870364	2870393	AGC	29	-	9	TGC
gi|514486632|gb|KE346360.1|	2870846	2870870	AGC	24	+	8	AGC
gi|514486632|gb|KE346360.1|	2871341	2871355	ACG	14	+	4	CGA
gi|514486632|gb|KE346360.1|	2871507	2871521	AGG	14	-	4	TCC
gi|514486632|gb|KE346360.1|	2872132	2872153	AACAGC	21	-	3	TGTTGC
gi|514486632|gb|KE346360.1|	2872810	2872834	A	24	-	24	T
gi|514486632|gb|KE346360.1|	2874651	2874665	AATCCTC	14	+	2	CAATCCT
gi|514486632|gb|KE346360.1|	2874695	2874716	A	21	+	21	A
gi|514486632|gb|KE346360.1|	2875130	2875146	A	16	+	16	A
gi|514486632|gb|KE346360.1|	2875228	2875251	AC	23	-	11	GT
gi|514486632|gb|KE346360.1|	2875812	2875846	A	34	-	34	T
gi|514486632|gb|KE346360.1|	2876216	2876232	A	16	+	16	A
gi|514486632|gb|KE346360.1|	2876892	2876921	A	29	-	29	T
gi|514486632|gb|KE346360.1|	2877088	2877102	AGCGGC	14	+	2	GCAGCG
gi|514486632|gb|KE346360.1|	2877495	2877514	AGC	19	+	6	AGC
gi|514486632|gb|KE346360.1|	2877764	2877782	ACC	18	+	6	CAC
gi|514486632|gb|KE346360.1|	2878650	2878664	AGC	14	+	4	CAG
gi|514486632|gb|KE346360.1|	2878683	2878697	AACAGC	14	+	2	CAGCAA
gi|514486632|gb|KE346360.1|	2878709	2878723	AAC	14	+	4	ACA
gi|514486632|gb|KE346360.1|	2879983	2880017	A	34	-	34	T
gi|514486632|gb|KE346360.1|	2881320	2881338	AAAAAAC	18	+	2	AACAAAA
gi|514486632|gb|KE346360.1|	2881365	2881384	AAACAC	19	-	3	GTGTTT
gi|514486632|gb|KE346360.1|	2881380	2881396	AAAACC	16	-	2	TTTGGT
gi|514486632|gb|KE346360.1|	2881597	2881617	AC	20	+	10	CA
gi|514486632|gb|KE346360.1|	2882006	2882020	ATC	14	+	4	TCA
gi|514486632|gb|KE346360.1|	2882018	2882032	ACG	14	-	4	TCG
gi|514486632|gb|KE346360.1|	2882310	2882327	ATC	17	-	5	ATG
gi|514486632|gb|KE346360.1|	2883036	2883050	AATGAG	14	-	2	TCTCAT
gi|514486632|gb|KE346360.1|	2883067	2883087	AAAATC	20	-	3	TGATTT
gi|514486632|gb|KE346360.1|	2883291	2883306	AAC	15	+	5	CAA
gi|514486632|gb|KE346360.1|	2885650	2885664	AATGCG	14	+	2	GAATGC
gi|514486632|gb|KE346360.1|	2885662	2885676	AATTCTC	14	-	2	GAGAATT
gi|514486632|gb|KE346360.1|	2885793	2885807	ACCTCG	14	-	2	GTCGAG
gi|514486632|gb|KE346360.1|	2887579	2887600	A	21	+	21	A
gi|514486632|gb|KE346360.1|	2888680	2888698	A	18	+	18	A
gi|514486632|gb|KE346360.1|	2888699	2888713	A	14	+	14	A
gi|514486632|gb|KE346360.1|	2889254	2889269	AG	15	+	7	AG
gi|514486632|gb|KE346360.1|	2889341	2889358	A	17	+	17	A
gi|514486632|gb|KE346360.1|	2889375	2889389	AAATGG	14	+	2	AATGGA
gi|514486632|gb|KE346360.1|	2890917	2890931	AGC	14	-	4	TGC
gi|514486632|gb|KE346360.1|	2892613	2892631	AG	18	-	9	TC
gi|514486632|gb|KE346360.1|	2892640	2892717	AG	77	-	38	CT
gi|514486632|gb|KE346360.1|	2892859	2892879	AAGCAGC	20	-	2	CTTGCTG
gi|514486632|gb|KE346360.1|	2892875	2892891	AAGCAGC	16	-	2	TGCTTGC
gi|514486632|gb|KE346360.1|	2893019	2893038	A	19	+	19	A
gi|514486632|gb|KE346360.1|	2894028	2894042	AC	14	+	7	CA
gi|514486632|gb|KE346360.1|	2894094	2894137	AG	43	+	21	GA
gi|514486632|gb|KE346360.1|	2895380	2895394	AAAATC	14	+	2	AATCAA
gi|514486632|gb|KE346360.1|	2896130	2896150	AGC	20	-	6	TGC
gi|514486632|gb|KE346360.1|	2898510	2898524	ACGGCG	14	-	2	CGTCGC
gi|514486632|gb|KE346360.1|	2898730	2898753	AAC	23	-	7	GTT
gi|514486632|gb|KE346360.1|	2898751	2898769	ACG	18	-	6	GTC
gi|514486632|gb|KE346360.1|	2899456	2899470	AAGCAG	14	+	2	AGCAGA
gi|514486632|gb|KE346360.1|	2900574	2900588	AAAG	14	+	3	GAAA
gi|514486632|gb|KE346360.1|	2901514	2901529	AGCGGC	15	-	2	GCTGCC
gi|514486632|gb|KE346360.1|	2902127	2902153	AAC	26	-	8	TGT
gi|514486632|gb|KE346360.1|	2903552	2903572	A	20	+	20	A
gi|514486632|gb|KE346360.1|	2904030	2904045	AAC	15	+	5	ACA
gi|514486632|gb|KE346360.1|	2904482	2904498	AAAAAAT	16	+	2	AAAAATA
gi|514486632|gb|KE346360.1|	2904519	2904551	A	32	-	32	T
gi|514486632|gb|KE346360.1|	2904874	2904890	AAATAAT	16	+	2	AAATAAT
gi|514486632|gb|KE346360.1|	2905105	2905139	A	34	-	34	T
gi|514486632|gb|KE346360.1|	2905312	2905326	AAT	14	+	4	AAT
gi|514486632|gb|KE346360.1|	2905319	2905334	AAATAAT	15	+	2	ATAATAA
gi|514486632|gb|KE346360.1|	2905328	2905344	AAAAAAT	16	+	2	AATAAAA
gi|514486632|gb|KE346360.1|	2905707	2905728	A	21	+	21	A
gi|514486632|gb|KE346360.1|	2905889	2905904	ACG	15	-	5	TCG
gi|514486632|gb|KE346360.1|	2907619	2907636	AAAACAC	17	+	2	ACAAAAC
gi|514486632|gb|KE346360.1|	2909351	2909368	A	17	+	17	A
gi|514486632|gb|KE346360.1|	2909738	2909759	A	21	+	21	A
gi|514486632|gb|KE346360.1|	2909820	2909839	A	19	+	19	A
gi|514486632|gb|KE346360.1|	2910032	2910056	A	24	-	24	T
gi|514486632|gb|KE346360.1|	2910090	2910113	AAAAAG	23	-	3	TTTTTC
gi|514486632|gb|KE346360.1|	2910255	2910278	A	23	+	23	A
gi|514486632|gb|KE346360.1|	2910460	2910478	A	18	+	18	A
gi|514486632|gb|KE346360.1|	2912194	2912209	AGC	15	+	5	AGC
gi|514486632|gb|KE346360.1|	2914842	2914857	AAGATGC	15	-	2	GCATCTT
gi|514486632|gb|KE346360.1|	2915116	2915194	AAC	78	+	26	AAC
gi|514486632|gb|KE346360.1|	2917345	2917363	AAAATC	18	+	3	CAAAAT
gi|514486632|gb|KE346360.1|	2917430	2917445	A	15	+	15	A
gi|514486632|gb|KE346360.1|	2917997	2918013	AAAAAAG	16	-	2	TTCTTTT
gi|514486632|gb|KE346360.1|	2919323	2919351	AGG	28	-	9	CCT
gi|514486632|gb|KE346360.1|	2919916	2919930	AAAAAAC	14	-	2	GTTTTTT
gi|514486632|gb|KE346360.1|	2920186	2920202	AAAG	16	+	4	GAAA
gi|514486632|gb|KE346360.1|	2920210	2920224	A	14	-	14	T
gi|514486632|gb|KE346360.1|	2920380	2920399	A	19	+	19	A
gi|514486632|gb|KE346360.1|	2920426	2920443	A	17	-	17	T
gi|514486632|gb|KE346360.1|	2920852	2920868	AGCGGC	16	-	2	CCGCTG
gi|514486632|gb|KE346360.1|	2923313	2923327	AACGAC	14	-	2	GTTGTC
gi|514486632|gb|KE346360.1|	2923322	2923357	ACG	35	-	11	GTC
gi|514486632|gb|KE346360.1|	2923398	2923412	ACC	14	-	4	GTG
gi|514486632|gb|KE346360.1|	2923720	2923734	AGAGGG	14	-	2	CCCTCT
gi|514486632|gb|KE346360.1|	2923848	2923862	AAGCAT	14	-	2	TTATGC
gi|514486632|gb|KE346360.1|	2923858	2923880	AAAGCC	22	-	3	GCTTTG
gi|514486632|gb|KE346360.1|	2924192	2924209	AGCCTC	17	+	2	CTCAGC
gi|514486632|gb|KE346360.1|	2924272	2924292	CCG	20	+	6	CCG
gi|514486632|gb|KE346360.1|	2924306	2924321	AGC	15	+	5	GCA
gi|514486632|gb|KE346360.1|	2924316	2924332	ACCAGC	16	+	2	CAGCAC
gi|514486632|gb|KE346360.1|	2926272	2926286	ACACGG	14	+	2	CACGGA
gi|514486632|gb|KE346360.1|	2926351	2926366	A	15	-	15	T
gi|514486632|gb|KE346360.1|	2927095	2927110	ACGCTC	15	+	2	CACGCT
gi|514486632|gb|KE346360.1|	2927199	2927213	ACGCAG	14	+	2	GCAGAC
gi|514486632|gb|KE346360.1|	2929803	2929825	A	22	+	22	A
gi|514486632|gb|KE346360.1|	2929988	2930003	AAGCGC	15	-	2	TGCGCT
gi|514486632|gb|KE346360.1|	2931441	2931457	AAAAGCC	16	+	2	CCAAAAG
gi|514486632|gb|KE346360.1|	2932538	2932552	AATGAGC	14	+	2	GCAATGA
gi|514486632|gb|KE346360.1|	2932905	2932919	AAAGAAT	14	+	2	AAAGAAT
gi|514486632|gb|KE346360.1|	2933129	2933146	AAGAGG	17	-	2	TCTTCC
gi|514486632|gb|KE346360.1|	2933671	2933700	A	29	+	29	A
gi|514486632|gb|KE346360.1|	2933978	2933993	AAAAAC	15	-	2	TTTTTG
gi|514486632|gb|KE346360.1|	2934430	2934445	A	15	+	15	A
gi|514486632|gb|KE346360.1|	2934644	2934665	A	21	-	21	T
gi|514486632|gb|KE346360.1|	2935018	2935032	AATG	14	-	3	TTCA
gi|514486632|gb|KE346360.1|	2935083	2935098	AAAAACC	15	-	2	GTTTTTG
gi|514486632|gb|KE346360.1|	2935206	2935220	AAGCTC	14	+	2	AGCTCA
gi|514486632|gb|KE346360.1|	2935600	2935629	AAG	29	-	9	CTT
gi|514486632|gb|KE346360.1|	2935627	2935643	AGC	16	-	5	CTG
gi|514486632|gb|KE346360.1|	2935698	2935716	ATGCCC	18	-	3	GGCATG
gi|514486632|gb|KE346360.1|	2936209	2936228	AGC	19	+	6	AGC
gi|514486632|gb|KE346360.1|	2936226	2936240	AAC	14	+	4	CAA
gi|514486632|gb|KE346360.1|	2936400	2936415	AGC	15	-	5	TGC
gi|514486632|gb|KE346360.1|	2939038	2939052	AAAGTC	14	+	2	TCAAAG
gi|514486632|gb|KE346360.1|	2940310	2940324	CCG	14	-	4	CGG
gi|514486632|gb|KE346360.1|	2940585	2940612	AGC	27	-	9	GCT
gi|514486632|gb|KE346360.1|	2940733	2940747	AGCATC	14	+	2	CATCAG
gi|514486632|gb|KE346360.1|	2941612	2941627	AAAAAAC	15	-	2	TTGTTTT
gi|514486632|gb|KE346360.1|	2941997	2942011	ACG	14	-	4	CGT
gi|514486632|gb|KE346360.1|	2942608	2942622	AAATCAC	14	+	2	TCACAAA
gi|514486632|gb|KE346360.1|	2942730	2942745	AATGAC	15	-	2	ATTGTC
gi|514486632|gb|KE346360.1|	2942805	2942819	AAAAG	14	-	2	TTTTC
gi|514486632|gb|KE346360.1|	2942812	2942826	AAAAAG	14	-	2	TTCTTT
gi|514486632|gb|KE346360.1|	2943090	2943142	A	52	+	52	A
gi|514486632|gb|KE346360.1|	2948218	2948233	AAAAC	15	+	3	CAAAA
gi|514486632|gb|KE346360.1|	2948229	2948243	A	14	+	14	A
gi|514486632|gb|KE346360.1|	2948669	2948685	AAAGCC	16	+	2	CAAAGC
gi|514486632|gb|KE346360.1|	2948942	2948957	AGC	15	-	5	TGC
gi|514486632|gb|KE346360.1|	2949644	2949687	A	43	-	43	T
gi|514486632|gb|KE346360.1|	2951504	2951521	AAATG	17	-	3	ATTTC
gi|514486632|gb|KE346360.1|	2951721	2951735	AG	14	+	7	AG
gi|514486632|gb|KE346360.1|	2951844	2951867	A	23	-	23	T
gi|514486632|gb|KE346360.1|	2955134	2955154	CCG	20	-	6	GGC
gi|514486632|gb|KE346360.1|	2955733	2955750	AACACC	17	+	2	CAACAC
gi|514486632|gb|KE346360.1|	2956172	2956187	AC	15	-	7	TG
gi|514486632|gb|KE346360.1|	2956797	2956816	AATC	19	+	4	AATC
gi|514486632|gb|KE346360.1|	2956875	2956893	AG	18	+	9	GA
gi|514486632|gb|KE346360.1|	2956929	2956946	AGCC	17	+	4	CCAG
gi|514486632|gb|KE346360.1|	2957128	2957142	AAAAAGC	14	+	2	AAGCAAA
gi|514486632|gb|KE346360.1|	2957140	2957154	AAGCAGC	14	+	2	AAGCAGC
gi|514486632|gb|KE346360.1|	2957464	2957483	A	19	-	19	T
gi|514486632|gb|KE346360.1|	2957514	2957531	AAAGC	17	-	3	CTTTG
gi|514486632|gb|KE346360.1|	2958056	2958075	ACTC	19	-	4	GTGA
gi|514486632|gb|KE346360.1|	2958072	2958087	AC	15	-	7	GT
gi|514486632|gb|KE346360.1|	2958666	2958683	AAAAC	17	-	3	TTTGT
gi|514486632|gb|KE346360.1|	2958695	2958709	AAACCG	14	-	2	TTCGGT
gi|514486632|gb|KE346360.1|	2959775	2959791	A	16	+	16	A
gi|514486632|gb|KE346360.1|	2959941	2959965	A	24	-	24	T
gi|514486632|gb|KE346360.1|	2960530	2960557	A	27	-	27	T
gi|514486632|gb|KE346360.1|	2964049	2964063	ACGATG	14	+	2	ACGATG
gi|514486632|gb|KE346360.1|	2964193	2964207	AAAAAG	14	-	2	TTCTTT
gi|514486632|gb|KE346360.1|	2964632	2964646	A	14	+	14	A
gi|514486632|gb|KE346360.1|	2964650	2964664	AAAAAAC	14	+	2	AAACAAA
gi|514486632|gb|KE346360.1|	2966126	2966140	ACCCC	14	-	2	GGGGT
gi|514486632|gb|KE346360.1|	2966576	2966591	ACT	15	+	5	ACT
gi|514486632|gb|KE346360.1|	2966872	2966887	A	15	+	15	A
gi|514486632|gb|KE346360.1|	2966923	2966948	A	25	+	25	A
gi|514486632|gb|KE346360.1|	2968224	2968248	AAAC	24	+	6	AAAC
gi|514486632|gb|KE346360.1|	2970860	2970874	ACATGC	14	-	2	TGTGCA
gi|514486632|gb|KE346360.1|	2971299	2971329	ACG	30	+	10	ACG
gi|514486632|gb|KE346360.1|	2971331	2971357	AAGATC	26	+	4	GATCAA
gi|514486632|gb|KE346360.1|	2971361	2971387	AAGATC	26	+	4	GATCAA
gi|514486632|gb|KE346360.1|	2971442	2971468	ACG	26	+	8	GAC
gi|514486632|gb|KE346360.1|	2971677	2971696	ACGATG	19	+	3	ATGACG
gi|514486632|gb|KE346360.1|	2971703	2971722	ACGATG	19	+	3	GATGAC
gi|514486632|gb|KE346360.1|	2973553	2973567	AAACC	14	-	2	TTTGG
gi|514486632|gb|KE346360.1|	2974575	2974594	AAG	19	+	6	AAG
gi|514486632|gb|KE346360.1|	2975112	2975126	A	14	+	14	A
gi|514486632|gb|KE346360.1|	2975329	2975347	A	18	+	18	A
gi|514486632|gb|KE346360.1|	2975367	2975391	A	24	+	24	A
gi|514486632|gb|KE346360.1|	2975398	2975427	A	29	+	29	A
gi|514486632|gb|KE346360.1|	2975435	2975463	ACG	28	+	9	GAC
gi|514486632|gb|KE346360.1|	2975600	2975617	A	17	-	17	T
gi|514486632|gb|KE346360.1|	2975748	2975762	AAAAG	14	+	2	AAAAG
gi|514486632|gb|KE346360.1|	2975972	2975986	AAAG	14	-	3	TTTC
gi|514486632|gb|KE346360.1|	2980382	2980396	ACTG	14	-	3	AGTC
gi|514486632|gb|KE346360.1|	2980472	2980489	ACC	17	+	5	CCA
gi|514486632|gb|KE346360.1|	2980750	2980765	AAAAAT	15	+	2	AAAATA
gi|514486632|gb|KE346360.1|	2980769	2980787	A	18	+	18	A
gi|514486632|gb|KE346360.1|	2981937	2981951	AAAAAG	14	+	2	AAGAAA
gi|514486632|gb|KE346360.1|	2984389	2984524	AC	135	-	67	TG
gi|514486632|gb|KE346360.1|	2984525	2984578	AC	53	-	26	TG
gi|514486632|gb|KE346360.1|	2985044	2985066	AG	22	+	11	AG
gi|514486632|gb|KE346360.1|	2985812	2985827	AAAC	15	+	3	AAAC
gi|514486632|gb|KE346360.1|	2985981	2985996	ACTC	15	-	3	GAGT
gi|514486632|gb|KE346360.1|	2986087	2986104	AGAGGG	17	+	2	GAGAGG
gi|514486632|gb|KE346360.1|	2986101	2986126	AGAGGG	25	+	4	GAGAGG
gi|514486632|gb|KE346360.1|	2986299	2986318	AAAAT	19	+	3	AAAAT
gi|514486632|gb|KE346360.1|	2986557	2986575	ACTC	18	+	4	TCAC
gi|514486632|gb|KE346360.1|	2986638	2986652	AAAAGGC	14	+	2	GCAAAAG
gi|514486632|gb|KE346360.1|	2987021	2987035	AATGC	14	-	2	ATTGC
gi|514486632|gb|KE346360.1|	2987054	2987087	A	33	-	33	T
gi|514486632|gb|KE346360.1|	2988798	2988812	AGC	14	-	4	GCT
gi|514486632|gb|KE346360.1|	2989331	2989345	ACGCTG	14	+	2	TGACGC
gi|514486632|gb|KE346360.1|	2989622	2989641	AAAC	19	+	4	AACA
gi|514486632|gb|KE346360.1|	2989642	2989805	AAAC	163	+	40	AACA
gi|514486632|gb|KE346360.1|	2989806	2989820	A	14	+	14	A
gi|514486632|gb|KE346360.1|	2990622	2990639	ACC	17	+	5	ACC
gi|514486632|gb|KE346360.1|	2990644	2990658	AATGTC	14	-	2	GACATT
gi|514486632|gb|KE346360.1|	2991024	2991040	AATG	16	+	4	GAAT
gi|514486632|gb|KE346360.1|	2991369	2991387	AG	18	-	9	CT
gi|514486632|gb|KE346360.1|	2991487	2991502	AAACCTC	15	-	2	TGAGGTT
gi|514486632|gb|KE346360.1|	2991506	2991521	A	15	-	15	T
gi|514486632|gb|KE346360.1|	2991548	2991567	AAAAAAT	19	-	2	TTTTTAT
gi|514486632|gb|KE346360.1|	2992013	2992028	AAAC	15	+	3	AAAC
gi|514486632|gb|KE346360.1|	2993518	2993532	AAACAGG	14	-	2	TTCCTGT
gi|514486632|gb|KE346360.1|	2994710	2994724	ACGACT	14	-	2	AGTCGT
gi|514486632|gb|KE346360.1|	2994809	2994830	ACGATC	21	-	3	GATCGT
gi|514486632|gb|KE346360.1|	2994947	2994964	ACCGCG	17	+	2	GACCGC
gi|514486632|gb|KE346360.1|	2995032	2995046	AAACG	14	-	2	GTTTC
gi|514486632|gb|KE346360.1|	2995998	2996012	AAG	14	+	4	GAA
gi|514486632|gb|KE346360.1|	2996926	2996945	AGCC	19	+	4	CAGC
gi|514486632|gb|KE346360.1|	2997174	2997188	ACCGGCG	14	+	2	GCGACCG
gi|514486632|gb|KE346360.1|	2997930	2997945	ATCCCC	15	+	2	CCCATC
gi|514486632|gb|KE346360.1|	2998155	2998178	AATGC	23	-	4	GCATT
gi|514486632|gb|KE346360.1|	2998208	2998224	AATGCTG	16	+	2	TGAATGC
gi|514486632|gb|KE346360.1|	2998243	2998257	A	14	-	14	T
gi|514486632|gb|KE346360.1|	2998258	2998276	A	18	-	18	T
gi|514486632|gb|KE346360.1|	2998396	2998411	ACG	15	+	5	CGA
gi|514486632|gb|KE346360.1|	2998409	2998479	AG	70	+	35	GA
gi|514486632|gb|KE346360.1|	2998524	2998556	A	32	-	32	T
gi|514486632|gb|KE346360.1|	2998552	2998585	AAAACC	33	-	5	TTTTGG
gi|514486632|gb|KE346360.1|	2999345	2999359	AAGTGAT	14	-	2	ACTTATC
gi|514486632|gb|KE346360.1|	3000492	3000507	AC	15	+	7	AC
gi|514486632|gb|KE346360.1|	3000827	3000841	AG	14	+	7	AG
gi|514486632|gb|KE346360.1|	3001433	3001456	AGC	23	-	7	TGC
gi|514486632|gb|KE346360.1|	3001454	3001468	AAC	14	-	4	TGT
gi|514486632|gb|KE346360.1|	3001493	3001507	AACAGC	14	-	2	TGTTGC
gi|514486632|gb|KE346360.1|	3001502	3001531	AGC	29	-	9	TGC
gi|514486632|gb|KE346360.1|	3001598	3001613	AAGCTG	15	+	2	AGCTGA
gi|514486632|gb|KE346360.1|	3001713	3001733	AGC	20	-	6	GCT
gi|514486632|gb|KE346360.1|	3002360	3002374	AAAAAG	14	+	2	AAAAGA
gi|514486632|gb|KE346360.1|	3002382	3002399	A	17	+	17	A
gi|514486632|gb|KE346360.1|	3003321	3003338	AACACC	17	-	2	TGTTGG
gi|514486632|gb|KE346360.1|	3003333	3003350	AAC	17	-	5	TGT
gi|514486632|gb|KE346360.1|	3003366	3003380	AACAGC	14	-	2	TGCTGT
gi|514486632|gb|KE346360.1|	3003675	3003692	AAC	17	-	5	TGT
gi|514486632|gb|KE346360.1|	3003690	3003707	AGC	17	-	5	TGC
gi|514486632|gb|KE346360.1|	3003843	3003870	AGC	27	-	9	TGC
gi|514486632|gb|KE346360.1|	3003996	3004013	AACAGC	17	-	2	TGCTGT
gi|514486632|gb|KE346360.1|	3004041	3004061	AGC	20	-	6	TGC
gi|514486632|gb|KE346360.1|	3004071	3004085	AACAGC	14	-	2	TGTTGC
gi|514486632|gb|KE346360.1|	3004167	3004187	AGCTCC	20	+	3	CCAGCT
gi|514486632|gb|KE346360.1|	3004270	3004284	AAT	14	+	4	AAT
gi|514486632|gb|KE346360.1|	3004369	3004386	AGGC	17	-	4	CTGC
gi|514486632|gb|KE346360.1|	3004561	3004582	A	21	+	21	A
gi|514486632|gb|KE346360.1|	3004751	3004770	A	19	+	19	A
gi|514486632|gb|KE346360.1|	3004766	3004782	AAAAGG	16	+	2	AAAAGG
gi|514486632|gb|KE346360.1|	3004778	3004793	A	15	+	15	A
gi|514486632|gb|KE346360.1|	3004789	3004805	AAAAGG	16	+	2	AAAAGG
gi|514486632|gb|KE346360.1|	3004812	3004827	AAAATGG	15	+	2	AAAATGG
gi|514486632|gb|KE346360.1|	3004854	3004870	A	16	+	16	A
gi|514486632|gb|KE346360.1|	3006393	3006416	AC	23	-	11	GT
gi|514486632|gb|KE346360.1|	3008930	3008944	AGC	14	-	4	GCT
gi|514486632|gb|KE346360.1|	3009184	3009198	ACGAGG	14	-	2	TCGTCC
gi|514486632|gb|KE346360.1|	3010112	3010126	AACAGC	14	-	2	TGTTGC
gi|514486632|gb|KE346360.1|	3010605	3010619	ACG	14	-	4	GTC
gi|514486632|gb|KE346360.1|	3010716	3010744	AAC	28	-	9	GTT
gi|514486632|gb|KE346360.1|	3012522	3012536	AG	14	+	7	GA
gi|514486632|gb|KE346360.1|	3013273	3013287	A	14	+	14	A
gi|514486632|gb|KE346360.1|	3014079	3014109	AAAAC	30	+	6	AACAA
gi|514486632|gb|KE346360.1|	3015201	3015223	ATC	22	-	7	GAT
gi|514486632|gb|KE346360.1|	3015811	3015827	A	16	+	16	A
gi|514486632|gb|KE346360.1|	3015957	3015975	AAGACAC	18	+	2	CAAGACA
gi|514486632|gb|KE346360.1|	3017897	3017913	A	16	-	16	T
gi|514486632|gb|KE346360.1|	3017916	3017933	AAAAAG	17	-	2	TTTTTC
gi|514486632|gb|KE346360.1|	3018049	3018066	ACAGTGC	17	+	2	GCACAGT
gi|514486632|gb|KE346360.1|	3018102	3018118	A	16	-	16	T
gi|514486632|gb|KE346360.1|	3018378	3018392	AAACAC	14	-	2	GTGTTT
gi|514486632|gb|KE346360.1|	3018537	3018554	AAAAAAG	17	-	2	CTTTTTT
gi|514486632|gb|KE346360.1|	3018698	3018718	A	20	-	20	T
gi|514486632|gb|KE346360.1|	3019391	3019406	A	15	+	15	A
gi|514486632|gb|KE346360.1|	3019601	3019616	A	15	-	15	T
gi|514486632|gb|KE346360.1|	3020496	3020510	AC	14	+	7	AC
gi|514486632|gb|KE346360.1|	3022651	3022665	AACGCC	14	+	2	CAACGC
gi|514486632|gb|KE346360.1|	3023100	3023115	ACACGGG	15	-	2	GTGTCCC
gi|514486632|gb|KE346360.1|	3023688	3023702	AGC	14	+	4	AGC
gi|514486632|gb|KE346360.1|	3023703	3023719	AGC	16	+	5	AGC
gi|514486632|gb|KE346360.1|	3025156	3025170	AAGTCC	14	-	2	TGGACT
gi|514486632|gb|KE346360.1|	3025188	3025210	AC	22	-	11	TG
gi|514486632|gb|KE346360.1|	3026846	3026862	AAGAGC	16	+	2	AGCAAG
gi|514486632|gb|KE346360.1|	3030397	3030411	AGGCGGG	14	+	2	GCGGGAG
gi|514486632|gb|KE346360.1|	3030525	3030546	A	21	+	21	A
gi|514486632|gb|KE346360.1|	3030657	3030672	AAGCAGC	15	+	2	GCAGCAA
gi|514486632|gb|KE346360.1|	3030797	3030811	AACAGC	14	-	2	TGCTGT
gi|514486632|gb|KE346360.1|	3031043	3031063	AGC	20	+	6	GCA
gi|514486632|gb|KE346360.1|	3032915	3032932	AAAAAC	17	-	2	TTTTTG
gi|514486632|gb|KE346360.1|	3033582	3033603	AG	21	-	10	TC
gi|514486632|gb|KE346360.1|	3035687	3035701	AATGGC	14	+	2	TGGCAA
gi|514486632|gb|KE346360.1|	3037949	3037970	A	21	+	21	A
gi|514486632|gb|KE346360.1|	3039970	3039984	AGAGGC	14	+	2	GAGGCA
gi|514486632|gb|KE346360.1|	3040058	3040075	ACTCTG	17	-	2	GAGTCA
gi|514486632|gb|KE346360.1|	3040070	3040085	ACTCAG	15	-	2	GAGTCT
gi|514486632|gb|KE346360.1|	3040081	3040095	AGCATG	14	+	2	TGAGCA
gi|514486632|gb|KE346360.1|	3040918	3040932	AAC	14	-	4	TGT
gi|514486632|gb|KE346360.1|	3040930	3040948	AGC	18	-	6	TGC
gi|514486632|gb|KE346360.1|	3042525	3042541	AGC	16	-	5	GCT
gi|514486632|gb|KE346360.1|	3043208	3043229	ATCGGC	21	-	3	ATGCCG
gi|514486632|gb|KE346360.1|	3043276	3043290	ACG	14	+	4	GAC
gi|514486632|gb|KE346360.1|	3043323	3043337	ACGAGC	14	-	2	GCTCGT
gi|514486632|gb|KE346360.1|	3044181	3044199	AGC	18	-	6	TGC
gi|514486632|gb|KE346360.1|	3044229	3044243	ACTGATG	14	+	2	GATGACT
gi|514486632|gb|KE346360.1|	3045110	3045125	AATTCC	15	+	2	CCAATT
gi|514486632|gb|KE346360.1|	3047069	3047083	AGGGCGG	14	-	2	CCGCCCT
gi|514486632|gb|KE346360.1|	3048027	3048049	ATC	22	-	7	GAT
gi|514486632|gb|KE346360.1|	3048255	3048270	AGCGGC	15	-	2	GCTGCC
gi|514486632|gb|KE346360.1|	3049988	3050002	ATCCC	14	+	2	CCATC
gi|514486632|gb|KE346360.1|	3051176	3051191	AAAAAAC	15	+	2	AAAAAAC
gi|514486632|gb|KE346360.1|	3053323	3053337	AAAAGAC	14	+	2	CAAAAGA
gi|514486632|gb|KE346360.1|	3053388	3053402	A	14	+	14	A
gi|514486632|gb|KE346360.1|	3054467	3054486	AG	19	+	9	GA
gi|514486632|gb|KE346360.1|	3054489	3054506	AGAGGG	17	+	2	GAGAGG
gi|514486632|gb|KE346360.1|	3054586	3054603	AAC	17	-	5	TGT
gi|514486632|gb|KE346360.1|	3054637	3054651	AAAACC	14	-	2	TTTGGT
gi|514486632|gb|KE346360.1|	3055138	3055155	ACACTC	17	-	2	TGAGTG
gi|514486632|gb|KE346360.1|	3055234	3055248	ACC	14	+	4	ACC
gi|514486632|gb|KE346360.1|	3055261	3055284	ATC	23	+	7	TCA
gi|514486632|gb|KE346360.1|	3055294	3055312	ACCAGC	18	-	3	GCTGGT
gi|514486632|gb|KE346360.1|	3055519	3055533	AGC	14	+	4	CAG
gi|514486632|gb|KE346360.1|	3056034	3056055	AATCTAC	21	-	3	AGATTGT
gi|514486632|gb|KE346360.1|	3056504	3056519	AGAGGC	15	-	2	TGCCTC
gi|514486632|gb|KE346360.1|	3056900	3056917	AAAGCGG	17	-	2	TTCCGCT
gi|514486632|gb|KE346360.1|	3057254	3057273	AAAC	19	+	4	ACAA
gi|514486632|gb|KE346360.1|	3057563	3057579	AATGC	16	+	3	GCAAT
gi|514486632|gb|KE346360.1|	3057688	3057733	AGC	45	-	15	GCT
gi|514486632|gb|KE346360.1|	3057922	3057936	AACAAT	14	+	2	AACAAT
gi|514486632|gb|KE346360.1|	3059207	3059230	AG	23	+	11	GA
gi|514486632|gb|KE346360.1|	3064391	3064412	A	21	-	21	T
gi|514486632|gb|KE346360.1|	3064596	3064611	A	15	+	15	A
gi|514486632|gb|KE346360.1|	3064854	3064868	AAAGCCC	14	-	2	CTTTGGG
gi|514486632|gb|KE346360.1|	3065012	3065032	A	20	-	20	T
gi|514486632|gb|KE346360.1|	3065095	3065111	AC	16	+	8	AC
gi|514486632|gb|KE346360.1|	3065408	3065438	A	30	+	30	A
gi|514486632|gb|KE346360.1|	3067902	3067916	AAAAC	14	-	2	TTTTG
gi|514486632|gb|KE346360.1|	3069935	3069964	A	29	-	29	T
gi|514486632|gb|KE346360.1|	3070316	3070338	A	22	+	22	A
gi|514486632|gb|KE346360.1|	3070765	3070780	AAATAT	15	-	2	TTTATA
gi|514486632|gb|KE346360.1|	3070782	3070800	AAT	18	-	6	ATT
gi|514486632|gb|KE346360.1|	3072896	3072911	ACG	15	-	5	TCG
gi|514486632|gb|KE346360.1|	3073007	3073030	ATC	23	+	7	TCA
gi|514486632|gb|KE346360.1|	3073105	3073119	AGC	14	-	4	CTG
gi|514486632|gb|KE346360.1|	3073631	3073649	AGC	18	-	6	CTG
gi|514486632|gb|KE346360.1|	3074352	3074378	ATC	26	+	8	CAT
gi|514486632|gb|KE346360.1|	3076167	3076195	AC	28	+	14	CA
gi|514486632|gb|KE346360.1|	3076194	3076208	A	14	+	14	A
gi|514486632|gb|KE346360.1|	3077316	3077330	AC	14	+	7	CA
gi|514486632|gb|KE346360.1|	3078646	3078666	ACC	20	+	6	CAC
gi|514486632|gb|KE346360.1|	3078664	3078679	AAC	15	+	5	CAA
gi|514486632|gb|KE346360.1|	3078687	3078701	AATCAC	14	-	2	TTGTGA
gi|514486632|gb|KE346360.1|	3079700	3079715	ACAGCG	15	-	2	GTCGCT
gi|514486632|gb|KE346360.1|	3080770	3080784	ATGCCC	14	+	2	TGCCCA
gi|514486632|gb|KE346360.1|	3083919	3083934	A	15	-	15	T
gi|514486632|gb|KE346360.1|	3086155	3086184	A	29	-	29	T
gi|514486632|gb|KE346360.1|	3086303	3086317	AACCAC	14	-	2	GTTGTG
gi|514486632|gb|KE346360.1|	3086854	3086869	A	15	+	15	A
gi|514486632|gb|KE346360.1|	3089748	3089787	AGC	39	-	13	CTG
gi|514486632|gb|KE346360.1|	3090550	3090564	ACCATC	14	+	2	CACCAT
gi|514486632|gb|KE346360.1|	3092617	3092635	AATTCAG	18	+	2	CAGAATT
gi|514486632|gb|KE346360.1|	3092965	3092984	A	19	+	19	A
gi|514486632|gb|KE346360.1|	3093403	3093423	A	20	+	20	A
gi|514486632|gb|KE346360.1|	3093817	3093832	AAAG	15	+	3	AAAG
gi|514486632|gb|KE346360.1|	3093829	3093843	A	14	+	14	A
gi|514486632|gb|KE346360.1|	3094325	3094339	AAACAAC	14	+	2	AACAACA
gi|514486632|gb|KE346360.1|	3094541	3094563	CCG	22	+	7	CGC
gi|514486632|gb|KE346360.1|	3094572	3094587	AGC	15	-	5	CTG
gi|514486632|gb|KE346360.1|	3095303	3095322	ACG	19	+	6	GAC
gi|514486632|gb|KE346360.1|	3095989	3096007	AAAAATG	18	-	2	TTTTCAT
gi|514486632|gb|KE346360.1|	3096333	3096360	AATGAG	27	-	4	TCATTC
gi|514486632|gb|KE346360.1|	3096584	3096598	AAAAAAC	14	-	2	TTTTTTG
gi|514486632|gb|KE346360.1|	3098977	3098991	ACCTCC	14	+	2	CCACCT
gi|514486632|gb|KE346360.1|	3099013	3099027	ACCGCC	14	+	2	CCACCG
gi|514486632|gb|KE346360.1|	3099049	3099063	ACCGCC	14	+	2	CCGCCA
gi|514486632|gb|KE346360.1|	3101535	3101549	AAAAAAT	14	+	2	AAATAAA
gi|514486632|gb|KE346360.1|	3102706	3102727	AAC	21	+	7	CAA
gi|514486632|gb|KE346360.1|	3104526	3104540	AATGGC	14	+	2	AATGGC
gi|514486632|gb|KE346360.1|	3104789	3104807	AGC	18	+	6	CAG
gi|514486632|gb|KE346360.1|	3105498	3105515	ATC	17	-	5	GAT
gi|514486632|gb|KE346360.1|	3105652	3105667	AACAGC	15	+	2	CAGCAA
gi|514486632|gb|KE346360.1|	3105700	3105715	AAGCAGC	15	+	2	CAAGCAG
gi|514486632|gb|KE346360.1|	3107014	3107036	ACAGCG	22	-	3	CTGTCG
gi|514486632|gb|KE346360.1|	3107505	3107526	ACC	21	+	7	ACC
gi|514486632|gb|KE346360.1|	3107670	3107693	AATGAC	23	+	3	GACAAT
gi|514486632|gb|KE346360.1|	3107688	3107705	AACGAC	17	+	2	GACAAC
gi|514486632|gb|KE346360.1|	3108577	3108602	AGC	25	+	8	CAG
gi|514486632|gb|KE346360.1|	3111019	3111033	ACCACCC	14	-	2	GTGGTGG
gi|514486632|gb|KE346360.1|	3111169	3111183	AACAAGC	14	-	2	TGTTGCT
gi|514486632|gb|KE346360.1|	3111963	3111978	AACAACC	15	-	2	GTTGTTG
gi|514486632|gb|KE346360.1|	3112386	3112401	A	15	-	15	T
gi|514486632|gb|KE346360.1|	3112880	3112895	A	15	-	15	T
gi|514486632|gb|KE346360.1|	3113532	3113558	A	26	-	26	T
gi|514486632|gb|KE346360.1|	3118243	3118258	AACCCTC	15	+	2	CAACCCT
gi|514486632|gb|KE346360.1|	3118303	3118339	A	36	+	36	A
gi|514486632|gb|KE346360.1|	3118373	3118387	AAAAG	14	+	2	AAAGA
gi|514486632|gb|KE346360.1|	3118463	3118477	AGATGGG	14	+	2	TGGGAGA
gi|514486632|gb|KE346360.1|	3118485	3118499	AG	14	+	7	GA
gi|514486632|gb|KE346360.1|	3119136	3119150	ACACTC	14	+	2	CTCACA
gi|514486632|gb|KE346360.1|	3119786	3119801	AAAGTG	15	-	2	TTCACT
gi|514486632|gb|KE346360.1|	3120106	3120120	AAC	14	+	4	AAC
gi|514486632|gb|KE346360.1|	3120113	3120127	AAACAAC	14	+	2	ACAACAA
gi|514486632|gb|KE346360.1|	3122099	3122114	AGCATC	15	-	2	CTGATG
gi|514486632|gb|KE346360.1|	3123678	3123694	AAATAC	16	+	2	AAATAC
gi|514486632|gb|KE346360.1|	3128148	3128166	A	18	+	18	A
gi|514486632|gb|KE346360.1|	3130260	3130275	AGCATC	15	-	2	CTGATG
gi|514486632|gb|KE346360.1|	3131798	3131812	AAAAATC	14	-	2	ATTTTTG
gi|514486632|gb|KE346360.1|	3131999	3132014	AAAAAC	15	-	2	TTTGTT
gi|514486632|gb|KE346360.1|	3132416	3132430	AAC	14	+	4	ACA
gi|514486632|gb|KE346360.1|	3132535	3132550	A	15	+	15	A
gi|514486632|gb|KE346360.1|	3132551	3132567	AAAAAAC	16	+	2	AACAAAA
gi|514486632|gb|KE346360.1|	3134502	3134517	AGCATC	15	-	2	CTGATG
gi|514486632|gb|KE346360.1|	3136045	3136063	A	18	+	18	A
gi|514486632|gb|KE346360.1|	3136251	3136275	A	24	+	24	A
gi|514486632|gb|KE346360.1|	3138580	3138612	AGC	32	+	10	CAG
gi|514486632|gb|KE346360.1|	3139004	3139020	AGCCTC	16	-	2	TGAGGC
gi|514486632|gb|KE346360.1|	3139069	3139084	ACT	15	+	5	ACT
gi|514486632|gb|KE346360.1|	3139116	3139135	AGC	19	-	6	TGC
gi|514486632|gb|KE346360.1|	3140108	3140124	AGC	16	+	5	CAG
gi|514486632|gb|KE346360.1|	3140196	3140214	AGC	18	+	6	AGC
gi|514486632|gb|KE346360.1|	3141206	3141220	AGC	14	-	4	TGC
gi|514486632|gb|KE346360.1|	3141363	3141378	AAGGGGG	15	-	2	CCCTTCC
gi|514486632|gb|KE346360.1|	3141409	3141431	ACATCC	22	+	3	ACATCC
gi|514486632|gb|KE346360.1|	3142490	3142508	AAG	18	-	6	CTT
gi|514486632|gb|KE346360.1|	3143296	3143310	AGGGGG	14	+	2	GGAGGG
gi|514486632|gb|KE346360.1|	3143427	3143444	AGCCG	17	-	3	GCTCG
gi|514486632|gb|KE346360.1|	3152378	3152395	AGCCG	17	+	3	GCCGA
gi|514486632|gb|KE346360.1|	3152512	3152526	AGGGGG	14	-	2	CCCCCT
gi|514486632|gb|KE346360.1|	3152988	3153002	AAG	14	-	4	TTC
gi|514486632|gb|KE346360.1|	3153031	3153052	A	21	-	21	T
gi|514486632|gb|KE346360.1|	3153315	3153330	AGC	15	-	5	GCT
gi|514486632|gb|KE346360.1|	3154473	3154487	AGCCGC	14	-	2	GCGGCT
gi|514486632|gb|KE346360.1|	3156062	3156076	AAAGCAG	14	+	2	AAAGCAG
gi|514486632|gb|KE346360.1|	3156319	3156334	ACCGCC	15	-	2	GCGGTG
gi|514486632|gb|KE346360.1|	3156525	3156554	ACG	29	+	9	GAC
gi|514486632|gb|KE346360.1|	3160190	3160204	ATCCGCC	14	+	2	GCCATCC
gi|514486632|gb|KE346360.1|	3160875	3160899	AGC	24	+	8	CAG
gi|514486632|gb|KE346360.1|	3165404	3165424	AAACAAG	20	+	2	AAGAAAC
gi|514486632|gb|KE346360.1|	3166454	3166470	AGGGGC	16	+	2	GCAGGG
gi|514486632|gb|KE346360.1|	3166878	3166892	ACCACTC	14	-	2	TGGTGAG
gi|514486632|gb|KE346360.1|	3168160	3168195	ATC	35	-	11	ATG
gi|514486632|gb|KE346360.1|	3168197	3168265	ATC	68	-	22	TGA
gi|514486632|gb|KE346360.1|	3168471	3168493	AAAAAT	22	+	3	AAAAAT
gi|514486632|gb|KE346360.1|	3169038	3169055	AGAGCG	17	+	2	GAGAGC
gi|514486632|gb|KE346360.1|	3169139	3169159	AG	20	+	10	GA
gi|514486632|gb|KE346360.1|	3169209	3169224	AAAAAAG	15	+	2	AAGAAAA
gi|514486632|gb|KE346360.1|	3169508	3169526	AGGG	18	-	4	CTCC
gi|514486632|gb|KE346360.1|	3169708	3169727	A	19	+	19	A
gi|514486632|gb|KE346360.1|	3170200	3170214	AAATCAG	14	+	2	ATCAGAA
gi|514486632|gb|KE346360.1|	3171758	3171792	AAC	34	-	11	GTT
gi|514486632|gb|KE346360.1|	3172564	3172578	CCG	14	-	4	GCG
gi|514486632|gb|KE346360.1|	3173132	3173146	AGC	14	-	4	GCT
gi|514486632|gb|KE346360.1|	3173827	3173842	ACTC	15	-	3	GTGA
gi|514486632|gb|KE346360.1|	3173887	3173902	AAAGATC	15	+	2	CAAAGAT
gi|514486632|gb|KE346360.1|	3174112	3174128	AACCCC	16	+	2	CCCCAA
gi|514486632|gb|KE346360.1|	3174221	3174240	ACTCTC	19	-	3	GAGTGA
gi|514486632|gb|KE346360.1|	3174467	3174504	A	37	-	37	T
gi|514486632|gb|KE346360.1|	3174724	3174740	A	16	+	16	A
gi|514486632|gb|KE346360.1|	3174892	3174920	A	28	+	28	A
gi|514486632|gb|KE346360.1|	3175323	3175337	AAAAC	14	+	2	AAAAC
gi|514486632|gb|KE346360.1|	3177123	3177137	AGC	14	-	4	TGC
gi|514486632|gb|KE346360.1|	3177700	3177716	A	16	-	16	T
gi|514486632|gb|KE346360.1|	3177832	3177854	AAC	22	+	7	AAC
gi|514486632|gb|KE346360.1|	3178329	3178346	A	17	-	17	T
gi|514486632|gb|KE346360.1|	3181242	3181256	AAGAG	14	+	2	GAGAA
gi|514486632|gb|KE346360.1|	3182082	3182097	A	15	-	15	T
gi|514486632|gb|KE346360.1|	3184175	3184190	AAAACAC	15	-	2	GTTTTGT
gi|514486632|gb|KE346360.1|	3186554	3186570	A	16	+	16	A
gi|514486632|gb|KE346360.1|	3188049	3188073	AGC	24	+	8	CAG
gi|514486632|gb|KE346360.1|	3190359	3190378	AAAAACC	19	-	2	TTTTTGG
gi|514486632|gb|KE346360.1|	3191787	3191804	AATGCC	17	+	2	CAATGC
gi|514486632|gb|KE346360.1|	3193129	3193144	AAGGAC	15	+	2	GGACAA
gi|514486632|gb|KE346360.1|	3194130	3194145	AAC	15	-	5	TGT
gi|514486632|gb|KE346360.1|	3195457	3195472	A	15	+	15	A
gi|514486632|gb|KE346360.1|	3195809	3195834	ACC	25	+	8	CCA
gi|514486632|gb|KE346360.1|	3196140	3196155	AGC	15	+	5	CAG
gi|514486632|gb|KE346360.1|	3196260	3196276	AGC	16	+	5	CAG
gi|514486632|gb|KE346360.1|	3196432	3196447	A	15	+	15	A
gi|514486632|gb|KE346360.1|	3196482	3196507	AATCC	25	-	5	ATTGG
gi|514486632|gb|KE346360.1|	3197054	3197069	AAAGCC	15	+	2	GCCAAA
gi|514486632|gb|KE346360.1|	3198170	3198187	AAAAAAC	17	-	2	TTTTTGT
gi|514486632|gb|KE346360.1|	3200239	3200255	AAATGCG	16	+	2	AATGCGA
gi|514486632|gb|KE346360.1|	3200296	3200320	AAC	24	-	8	TTG
gi|514486632|gb|KE346360.1|	3201623	3201638	AAAAAGG	15	-	2	CTTTTTC
gi|514486632|gb|KE346360.1|	3201913	3201934	AC	21	-	10	GT
gi|514486632|gb|KE346360.1|	3203030	3203066	AC	36	+	18	CA
gi|514486632|gb|KE346360.1|	3203105	3203120	AAAAAC	15	+	2	AAAAAC
gi|514486632|gb|KE346360.1|	3203854	3203874	AG	20	+	10	GA
gi|514486632|gb|KE346360.1|	3204882	3204902	AAAAACC	20	+	2	CAAAAAC
gi|514486632|gb|KE346360.1|	3205324	3205339	AGCGCCC	15	+	2	GCCCAGC
gi|514486632|gb|KE346360.1|	3205919	3205934	AAC	15	-	5	TTG
gi|514486632|gb|KE346360.1|	3206273	3206287	AATAC	14	-	2	TGTAT
gi|514486632|gb|KE346360.1|	3206531	3206585	A	54	+	54	A
gi|514486632|gb|KE346360.1|	3206962	3206983	ACTCGAT	21	+	3	ACTCGAT
gi|514486632|gb|KE346360.1|	3209600	3209614	ACCAGCG	14	-	2	GTCGCTG
gi|514486632|gb|KE346360.1|	3209768	3209783	AAC	15	-	5	TGT
gi|514486632|gb|KE346360.1|	3209862	3209877	AAACTG	15	-	2	TCAGTT
gi|514486632|gb|KE346360.1|	3210056	3210073	ACGAGG	17	-	2	TCGTCC
gi|514486632|gb|KE346360.1|	3210511	3210528	ACGCCG	17	+	2	CGCCGA
gi|514486632|gb|KE346360.1|	3211327	3211342	AAAAAC	15	-	2	TTTGTT
gi|514486632|gb|KE346360.1|	3212506	3212526	AGC	20	-	6	CTG
gi|514486632|gb|KE346360.1|	3216210	3216224	AGGGGG	14	+	2	AGGGGG
gi|514486632|gb|KE346360.1|	3217406	3217420	AGC	14	-	4	TGC
gi|514486632|gb|KE346360.1|	3217758	3217784	AGC	26	-	8	TGC
gi|514486632|gb|KE346360.1|	3218486	3218504	AACAGC	18	+	3	CAGCAA
gi|514486632|gb|KE346360.1|	3218546	3218560	AGC	14	+	4	CAG
gi|514486632|gb|KE346360.1|	3219721	3219742	AG	21	+	10	AG
gi|514486632|gb|KE346360.1|	3219913	3219940	AAAGATG	27	+	3	AAAGATG
gi|514486632|gb|KE346360.1|	3220374	3220391	AAGAGG	17	+	2	GAAGAG
gi|514486632|gb|KE346360.1|	3220386	3220402	AAG	16	+	5	GAA
gi|514486632|gb|KE346360.1|	3221895	3221921	ACC	26	-	8	TGG
gi|514486632|gb|KE346360.1|	3222602	3222620	AGG	18	+	6	AGG
gi|514486632|gb|KE346360.1|	3222731	3222751	AGC	20	-	6	TGC
gi|514486632|gb|KE346360.1|	3222837	3222860	AAG	23	+	7	AGA
gi|514486632|gb|KE346360.1|	3222975	3222989	ACCCGC	14	-	2	GGGTGC
gi|514486632|gb|KE346360.1|	3223108	3223130	ACCAGG	22	-	3	TCCTGG
gi|514486632|gb|KE346360.1|	3223276	3223290	AGC	14	-	4	TGC
gi|514486632|gb|KE346360.1|	3223297	3223311	AGC	14	-	4	TGC
gi|514486632|gb|KE346360.1|	3223510	3223527	ATC	17	-	5	GAT
gi|514486632|gb|KE346360.1|	3224152	3224189	A	37	+	37	A
gi|514486632|gb|KE346360.1|	3225382	3225401	AATGGG	19	-	3	CCATTC
gi|514486632|gb|KE346360.1|	3225535	3225562	A	27	+	27	A
gi|514486632|gb|KE346360.1|	3225946	3225963	A	17	-	17	T
gi|514486632|gb|KE346360.1|	3226858	3226872	AGC	14	+	4	AGC
gi|514486632|gb|KE346360.1|	3228169	3228183	A	14	-	14	T
gi|514486632|gb|KE346360.1|	3228703	3228717	ATC	14	+	4	TCA
gi|514486632|gb|KE346360.1|	3228900	3228927	AGC	27	-	9	TGC
gi|514486632|gb|KE346360.1|	3229263	3229277	AACCAC	14	-	2	GTTGTG
gi|514486632|gb|KE346360.1|	3231467	3231489	AGC	22	-	7	GCT
gi|514486632|gb|KE346360.1|	3232024	3232051	ACGAGG	27	-	4	GTCCTC
gi|514486632|gb|KE346360.1|	3232073	3232087	ATC	14	-	4	GAT
gi|514486632|gb|KE346360.1|	3232217	3232232	ACG	15	-	5	TCG
gi|514486632|gb|KE346360.1|	3232818	3232841	ACCAGC	23	+	3	CAGCAC
gi|514486632|gb|KE346360.1|	3233024	3233042	AGC	18	+	6	GCA
gi|514486632|gb|KE346360.1|	3233083	3233108	AGCTCC	25	-	4	GGAGCT
gi|514486632|gb|KE346360.1|	3233108	3233124	AAGCAG	16	-	2	CTGCTT
gi|514486632|gb|KE346360.1|	3233190	3233204	ACCAGC	14	-	2	TGGTGC
gi|514486632|gb|KE346360.1|	3233205	3233237	ACCAGC	32	-	5	TGGTGC
gi|514486632|gb|KE346360.1|	3233452	3233466	AAAGG	14	+	2	GAAAG
gi|514486632|gb|KE346360.1|	3233473	3233510	A	37	+	37	A
gi|514486632|gb|KE346360.1|	3233609	3233635	AAAATC	26	-	4	TTGATT
gi|514486632|gb|KE346360.1|	3236386	3236403	AAAAAG	17	-	2	TTTTTC
gi|514486632|gb|KE346360.1|	3237342	3237356	ACCACG	14	-	2	GTGGTC
gi|514486632|gb|KE346360.1|	3239255	3239270	AACGC	15	+	3	CAACG
gi|514486632|gb|KE346360.1|	3239547	3239576	AAAAT	29	+	5	AAAAT
gi|514486632|gb|KE346360.1|	3239632	3239654	ATCC	22	+	5	CATC
gi|514486632|gb|KE346360.1|	3239788	3239812	AAC	24	+	8	ACA
gi|514486632|gb|KE346360.1|	3240205	3240233	ATC	28	-	9	TGA
gi|514486632|gb|KE346360.1|	3240635	3240692	AC	57	+	28	AC
gi|514486632|gb|KE346360.1|	3242550	3242572	AATG	22	+	5	AATG
gi|514486632|gb|KE346360.1|	3242790	3242813	CCG	23	-	7	GGC
gi|514486632|gb|KE346360.1|	3243470	3243484	CCG	14	-	4	GCG
gi|514486632|gb|KE346360.1|	3244403	3244419	AGC	16	+	5	AGC
gi|514486632|gb|KE346360.1|	3244431	3244509	AAC	78	+	26	ACA
gi|514486632|gb|KE346360.1|	3244983	3245002	AAC	19	-	6	TTG
gi|514486632|gb|KE346360.1|	3245210	3245225	A	15	-	15	T
gi|514486632|gb|KE346360.1|	3245265	3245282	AG	17	-	8	CT
gi|514486632|gb|KE346360.1|	3245484	3245502	ACTC	18	+	4	TCAC
gi|514486632|gb|KE346360.1|	3245495	3245510	ACTCTC	15	+	2	CTCACT
gi|514486632|gb|KE346360.1|	3245505	3245522	AG	17	-	8	CT
gi|514486632|gb|KE346360.1|	3245645	3245660	ACTCTC	15	+	2	CTCTCA
gi|514486632|gb|KE346360.1|	3245770	3245784	AAAAC	14	-	2	TTTTG
gi|514486632|gb|KE346360.1|	3245816	3245837	AAAAC	21	-	4	GTTTT
gi|514486632|gb|KE346360.1|	3247247	3247265	AAAAC	18	-	3	TTTTG
gi|514486632|gb|KE346360.1|	3247291	3247305	AAAAC	14	-	2	TTTGT
gi|514486632|gb|KE346360.1|	3249166	3249186	A	20	-	20	T
gi|514486632|gb|KE346360.1|	3250021	3250037	AG	16	-	8	TC
gi|514486632|gb|KE346360.1|	3252150	3252164	AAACAAC	14	-	2	GTTTGTT
gi|514486632|gb|KE346360.1|	3253912	3253935	AGC	23	-	7	GCT
gi|514486632|gb|KE346360.1|	3254326	3254343	AGCATC	17	+	2	CAGCAT
gi|514486632|gb|KE346360.1|	3254356	3254373	AGCATC	17	+	2	CAGCAT
gi|514486632|gb|KE346360.1|	3254394	3254409	ACG	15	+	5	GAC
gi|514486632|gb|KE346360.1|	3255435	3255454	AC	19	-	9	GT
gi|514486632|gb|KE346360.1|	3255697	3255711	AAAAG	14	-	2	TTTTC
gi|514486632|gb|KE346360.1|	3255896	3255917	A	21	-	21	T
gi|514486632|gb|KE346360.1|	3255953	3255970	A	17	-	17	T
gi|514486632|gb|KE346360.1|	3256131	3256151	A	20	-	20	T
gi|514486632|gb|KE346360.1|	3256204	3256218	A	14	-	14	T
gi|514486632|gb|KE346360.1|	3256256	3256271	A	15	-	15	T
gi|514486632|gb|KE346360.1|	3256294	3256308	ATC	14	+	4	CAT
gi|514486632|gb|KE346360.1|	3256306	3256320	AAC	14	+	4	CAA
gi|514486632|gb|KE346360.1|	3256978	3256992	AAAAAG	14	-	2	TTTTCT
gi|514486632|gb|KE346360.1|	3257676	3257690	ACGAGG	14	+	2	GACGAG
gi|514486632|gb|KE346360.1|	3257726	3257741	ACCGCC	15	+	2	CACCGC
gi|514486632|gb|KE346360.1|	3258288	3258317	AGC	29	+	9	AGC
gi|514486632|gb|KE346360.1|	3258439	3258458	AGG	19	-	6	CCT
gi|514486632|gb|KE346360.1|	3259068	3259083	AGC	15	-	5	TGC
gi|514486632|gb|KE346360.1|	3262162	3262176	AAAG	14	+	3	AAAG
gi|514486632|gb|KE346360.1|	3262379	3262393	ACCCGCT	14	-	2	AGCGGGT
gi|514486632|gb|KE346360.1|	3262401	3262416	ATGCCC	15	-	2	GCATGG
gi|514486632|gb|KE346360.1|	3265247	3265261	A	14	-	14	T
gi|514486632|gb|KE346360.1|	3265472	3265489	A	17	+	17	A
gi|514486632|gb|KE346360.1|	3265653	3265667	A	14	+	14	A
gi|514486632|gb|KE346360.1|	3265699	3265713	A	14	-	14	T
gi|514486632|gb|KE346360.1|	3266049	3266063	A	14	+	14	A
gi|514486632|gb|KE346360.1|	3266066	3266080	A	14	+	14	A
gi|514486632|gb|KE346360.1|	3266463	3266484	A	21	+	21	A
gi|514486632|gb|KE346360.1|	3266687	3266702	A	15	+	15	A
gi|514486632|gb|KE346360.1|	3266932	3266956	A	24	+	24	A
gi|514486632|gb|KE346360.1|	3267061	3267077	AC	16	+	8	CA
gi|514486632|gb|KE346360.1|	3267947	3267963	AG	16	+	8	GA
gi|514486632|gb|KE346360.1|	3268113	3268130	A	17	-	17	T
gi|514486632|gb|KE346360.1|	3268250	3268267	AAG	17	-	5	TCT
gi|514486632|gb|KE346360.1|	3270618	3270632	AGGCCG	14	-	2	CTCGGC
gi|514486632|gb|KE346360.1|	3272224	3272238	AACAGC	14	-	2	TGTTGC
gi|514486632|gb|KE346360.1|	3272247	3272265	AAC	18	-	6	TTG
gi|514486632|gb|KE346360.1|	3272263	3272282	AGC	19	-	6	TGC
gi|514486632|gb|KE346360.1|	3272771	3272785	ACTCGCC	14	+	2	CTCGCCA
gi|514486632|gb|KE346360.1|	3273216	3273230	AGGCGG	14	+	2	GGAGGC
gi|514486632|gb|KE346360.1|	3273766	3273810	AGC	44	-	14	TGC
gi|514486632|gb|KE346360.1|	3277371	3277386	ATCC	15	+	3	TCCA
gi|514486632|gb|KE346360.1|	3277639	3277653	AAAAG	14	+	2	AAAAG
gi|514486632|gb|KE346360.1|	3277914	3277948	AG	34	-	17	TC
gi|514486632|gb|KE346360.1|	3278142	3278168	ACG	26	+	8	GAC
gi|514486632|gb|KE346360.1|	3278163	3278179	ACGAGG	16	+	2	GACGAG
gi|514486632|gb|KE346360.1|	3278242	3278258	AGCGGC	16	-	2	CTGCCG
gi|514486632|gb|KE346360.1|	3278253	3278269	AGC	16	-	5	GCT
gi|514486632|gb|KE346360.1|	3278466	3278480	ACGATG	14	+	2	GATGAC
gi|514486632|gb|KE346360.1|	3278475	3278492	ACG	17	+	5	GAC
gi|514486632|gb|KE346360.1|	3278496	3278512	ACGATG	16	+	2	GATGAC
gi|514486632|gb|KE346360.1|	3278526	3278543	ACGAGG	17	+	2	GACGAG
gi|514486632|gb|KE346360.1|	3278538	3278552	ACG	14	+	4	GAC
gi|514486632|gb|KE346360.1|	3279881	3279898	AGC	17	+	5	CAG
gi|514486632|gb|KE346360.1|	3279896	3279922	AAC	26	+	8	CAA
gi|514486632|gb|KE346360.1|	3281673	3281689	ACC	16	-	5	GTG
gi|514486632|gb|KE346360.1|	3282510	3282529	CCG	19	-	6	GGC
gi|514486632|gb|KE346360.1|	3283768	3283782	AAAAAAC	14	-	2	TTTTTTG
gi|514486632|gb|KE346360.1|	3285513	3285527	AAAAAC	14	-	2	TTTTGT
gi|514486632|gb|KE346360.1|	3285529	3285545	A	16	-	16	T
gi|514486632|gb|KE346360.1|	3285547	3285561	A	14	-	14	T
gi|514486632|gb|KE346360.1|	3288227	3288249	AAC	22	-	7	TTG
gi|514486632|gb|KE346360.1|	3288306	3288330	A	24	+	24	A
gi|514486632|gb|KE346360.1|	3288353	3288372	AAAAT	19	+	3	AAAAT
gi|514486632|gb|KE346360.1|	3288370	3288384	AAAAATG	14	+	2	AAAAATG
gi|514486632|gb|KE346360.1|	3288560	3288582	AAAG	22	+	5	GAAA
gi|514486632|gb|KE346360.1|	3288915	3288932	AG	17	-	8	CT
gi|514486632|gb|KE346360.1|	3289309	3289328	AAAAAC	19	+	3	AAAAAC
gi|514486632|gb|KE346360.1|	3290244	3290258	ACG	14	-	4	TCG
gi|514486632|gb|KE346360.1|	3292671	3292685	ACG	14	-	4	TCG
gi|514486632|gb|KE346360.1|	3292989	3293004	AATCTGC	15	-	2	CAGATTG
gi|514486632|gb|KE346360.1|	3293090	3293106	ACCGCG	16	+	2	CCGCGA
gi|514486632|gb|KE346360.1|	3293337	3293351	AGCATC	14	+	2	CATCAG
gi|514486632|gb|KE346360.1|	3294171	3294187	AAAATT	16	-	2	TTTTAA
gi|514486632|gb|KE346360.1|	3294390	3294411	A	21	-	21	T
gi|514486632|gb|KE346360.1|	3294630	3294651	ACCAGT	21	+	3	CAGTAC
gi|514486632|gb|KE346360.1|	3294648	3294664	AACAGC	16	+	2	CAGCAA
gi|514486632|gb|KE346360.1|	3294954	3294968	AGCTCC	14	+	2	CAGCTC
gi|514486632|gb|KE346360.1|	3294996	3295019	AGC	23	+	7	CAG
gi|514486632|gb|KE346360.1|	3295280	3295316	A	36	-	36	T
gi|514486632|gb|KE346360.1|	3296405	3296419	AACAGC	14	+	2	CAGCAA
gi|514486632|gb|KE346360.1|	3296462	3296476	AACAGC	14	+	2	CAACAG
gi|514486632|gb|KE346360.1|	3296471	3296488	AGC	17	+	5	CAG
gi|514486632|gb|KE346360.1|	3296495	3296509	AACAGC	14	+	2	CAGCAA
gi|514486632|gb|KE346360.1|	3297207	3297221	AAG	14	-	4	CTT
gi|514486632|gb|KE346360.1|	3297859	3297882	AAAAAAC	23	-	3	TTTTGTT
gi|514486632|gb|KE346360.1|	3298187	3298202	A	15	-	15	T
gi|514486632|gb|KE346360.1|	3298976	3298992	A	16	-	16	T
gi|514486632|gb|KE346360.1|	3299092	3299106	ACG	14	-	4	TCG
gi|514486632|gb|KE346360.1|	3299105	3299122	AGC	17	+	5	CAG
gi|514486632|gb|KE346360.1|	3299314	3299329	AGC	15	+	5	GCA
gi|514486632|gb|KE346360.1|	3299617	3299634	ACCGCC	17	+	2	GCCACC
gi|514486632|gb|KE346360.1|	3299937	3299955	ACG	18	+	6	CGA
gi|514486632|gb|KE346360.1|	3299953	3299967	ATC	14	-	4	GAT
gi|514486632|gb|KE346360.1|	3302076	3302090	AAC	14	-	4	TGT
gi|514486632|gb|KE346360.1|	3302232	3302246	ACCGC	14	-	2	TGCGG
gi|514486632|gb|KE346360.1|	3302515	3302532	AGCAGG	17	+	2	GGAGCA
gi|514486632|gb|KE346360.1|	3303160	3303174	AGCGC	14	+	2	GCGCA
gi|514486632|gb|KE346360.1|	3303398	3303422	AACGGG	24	+	4	CGGGAA
gi|514486632|gb|KE346360.1|	3303613	3303639	AGC	26	-	8	TGC
gi|514486632|gb|KE346360.1|	3303643	3303658	ACC	15	-	5	TGG
gi|514486632|gb|KE346360.1|	3303664	3303678	ATGGCC	14	+	2	TGGCCA
gi|514486632|gb|KE346360.1|	3304036	3304050	A	14	+	14	A
gi|514486632|gb|KE346360.1|	3304390	3304407	CCG	17	-	5	GGC
gi|514486632|gb|KE346360.1|	3304577	3304593	AGGCCG	16	+	2	GAGGCC
gi|514486632|gb|KE346360.1|	3304588	3304611	ACCTCG	23	-	3	CGAGGT
gi|514486632|gb|KE346360.1|	3304885	3304903	AGC	18	-	6	CTG
gi|514486632|gb|KE346360.1|	3305308	3305323	AAGC	15	+	3	CAAG
gi|514486632|gb|KE346360.1|	3307730	3307745	ACGAGCC	15	-	2	GCTCGTG
gi|514486632|gb|KE346360.1|	3308674	3308691	ACGCTC	17	+	2	CTCACG
gi|514486632|gb|KE346360.1|	3309858	3309872	AAACGT	14	-	2	TTACGT
gi|514486632|gb|KE346360.1|	3312643	3312661	AAC	18	+	6	CAA
gi|514486632|gb|KE346360.1|	3313159	3313175	AGAGGG	16	+	2	GAGAGG
gi|514486632|gb|KE346360.1|	3313185	3313204	A	19	-	19	T
gi|514486632|gb|KE346360.1|	3314612	3314626	AAAAATC	14	-	2	TTTGATT
gi|514486632|gb|KE346360.1|	3315352	3315371	AAAG	19	+	4	AGAA
gi|514486632|gb|KE346360.1|	3315749	3315763	A	14	+	14	A
gi|514486632|gb|KE346360.1|	3316620	3316634	AAGTGC	14	+	2	AGTGCA
gi|514486632|gb|KE346360.1|	3316636	3316650	AAGAGC	14	+	2	GCAAGA
gi|514486632|gb|KE346360.1|	3316863	3316883	A	20	-	20	T
gi|514486632|gb|KE346360.1|	3317056	3317075	A	19	+	19	A
gi|514486632|gb|KE346360.1|	3317281	3317295	AAACTTC	14	-	2	AGTTTGA
gi|514486632|gb|KE346360.1|	3317315	3317336	A	21	-	21	T
gi|514486632|gb|KE346360.1|	3317897	3317914	A	17	+	17	A
gi|514486632|gb|KE346360.1|	3317932	3317951	A	19	+	19	A
gi|514486632|gb|KE346360.1|	3317981	3318005	A	24	+	24	A
gi|514486632|gb|KE346360.1|	3320331	3320348	AAAAACC	17	+	2	AAAAACC
gi|514486632|gb|KE346360.1|	3321252	3321266	AAAAG	14	+	2	AAAAG
gi|514486632|gb|KE346360.1|	3322369	3322384	AAAC	15	+	3	AAAC
gi|514486632|gb|KE346360.1|	3326264	3326292	AGGATG	28	-	4	CATCCT
gi|514486632|gb|KE346360.1|	3329132	3329150	A	18	-	18	T
gi|514486632|gb|KE346360.1|	3329846	3329868	A	22	-	22	T
gi|514486632|gb|KE346360.1|	3330137	3330152	AACCCCC	15	-	2	GGGGTTG
gi|514486632|gb|KE346360.1|	3331959	3331973	AAGCCC	14	-	2	GGCTTG
gi|514486632|gb|KE346360.1|	3333602	3333617	ACACGG	15	-	2	GTCCGT
gi|514486632|gb|KE346360.1|	3333808	3333825	ATC	17	+	5	CAT
gi|514486632|gb|KE346360.1|	3333954	3333979	A	25	+	25	A
gi|514486632|gb|KE346360.1|	3334052	3334067	AC	15	+	7	AC
gi|514486632|gb|KE346360.1|	3334363	3334378	CCG	15	+	5	GCC
gi|514486632|gb|KE346360.1|	3334463	3334477	CCG	14	-	4	GGC
gi|514486632|gb|KE346360.1|	3334772	3334786	AGCGGGC	14	+	2	GCAGCGG
gi|514486632|gb|KE346360.1|	3335080	3335094	AAAAC	14	+	2	CAAAA
gi|514486632|gb|KE346360.1|	3335102	3335118	A	16	+	16	A
gi|514486632|gb|KE346360.1|	3335631	3335650	AGG	19	+	6	AGG
gi|514486632|gb|KE346360.1|	3335665	3335682	AGGCGG	17	+	2	GGCGGA
gi|514486632|gb|KE346360.1|	3336995	3337009	AAACTG	14	+	2	AAACTG
gi|514486632|gb|KE346360.1|	3337021	3337048	A	27	-	27	T
gi|514486632|gb|KE346360.1|	3337226	3337244	A	18	+	18	A
gi|514486632|gb|KE346360.1|	3337273	3337289	A	16	+	16	A
gi|514486632|gb|KE346360.1|	3337500	3337523	ACCACCG	23	+	3	CACCGAC
gi|514486632|gb|KE346360.1|	3337635	3337652	AAC	17	+	5	ACA
gi|514486632|gb|KE346360.1|	3337817	3337845	A	28	+	28	A
gi|514486632|gb|KE346360.1|	3337846	3337861	AAAGG	15	+	3	AAAGG
gi|514486632|gb|KE346360.1|	3338032	3338048	AAAC	16	+	4	CAAA
gi|514486632|gb|KE346360.1|	3338057	3338077	AAAAAAG	20	+	2	AAAAAAG
gi|514486632|gb|KE346360.1|	3339050	3339067	AAGCAG	17	+	2	CAGAAG
gi|514486632|gb|KE346360.1|	3339379	3339393	AGC	14	+	4	GCA
gi|514486632|gb|KE346360.1|	3343550	3343564	AAAGGC	14	-	2	TGCCTT
gi|514486632|gb|KE346360.1|	3345520	3345551	A	31	+	31	A
gi|514486632|gb|KE346360.1|	3346346	3346361	AAGC	15	+	3	CAAG
gi|514486632|gb|KE346360.1|	3347047	3347062	AAAAC	15	+	3	CAAAA
gi|514486632|gb|KE346360.1|	3347058	3347072	AAAAG	14	+	2	AAAAG
gi|514486632|gb|KE346360.1|	3347379	3347595	AC	216	+	108	AC
gi|514486632|gb|KE346360.1|	3347621	3347649	AC	28	+	14	AC
gi|514486632|gb|KE346360.1|	3347652	3347684	AC	32	+	16	CA
gi|514486632|gb|KE346360.1|	3347693	3347710	AC	17	+	8	CA
gi|514486632|gb|KE346360.1|	3347728	3347742	AAAAAAG	14	+	2	AAAAAAG
gi|514486632|gb|KE346360.1|	3347893	3347969	AC	76	+	38	CA
gi|514486632|gb|KE346360.1|	3347968	3347991	A	23	+	23	A
gi|514486632|gb|KE346360.1|	3349291	3349342	A	51	+	51	A
gi|514486632|gb|KE346360.1|	3350271	3350293	AG	22	-	11	TC
gi|514486632|gb|KE346360.1|	3350429	3350443	A	14	-	14	T
gi|514486632|gb|KE346360.1|	3350600	3350615	A	15	-	15	T
gi|514486632|gb|KE346360.1|	3351397	3351449	AAC	52	-	17	TTG
gi|514486632|gb|KE346360.1|	3351921	3351936	AAAAGAG	15	-	2	TTTTCTC
gi|514486632|gb|KE346360.1|	3353775	3353789	AAAGAGC	14	+	2	AAAGAGC
gi|514486632|gb|KE346360.1|	3353908	3353955	AG	47	+	23	AG
gi|514486632|gb|KE346360.1|	3353992	3354007	AACGAAG	15	+	2	AGAACGA
gi|514486632|gb|KE346360.1|	3354058	3354073	A	15	+	15	A
gi|514486632|gb|KE346360.1|	3354163	3354177	AAG	14	+	4	GAA
gi|514486632|gb|KE346360.1|	3354516	3354536	A	20	+	20	A
gi|514486632|gb|KE346360.1|	3356113	3356127	AAAAAAC	14	-	2	TTTTTGT
gi|514486632|gb|KE346360.1|	3358183	3358201	ACG	18	+	6	CGA
gi|514486632|gb|KE346360.1|	3358458	3358483	AGC	25	-	8	CTG
gi|514486632|gb|KE346360.1|	3358503	3358524	AGAGCC	21	-	3	CTGGCT
gi|514486632|gb|KE346360.1|	3360137	3360152	AATCACC	15	+	2	TCACCAA
gi|514486632|gb|KE346360.1|	3362392	3362407	AC	15	+	7	AC
gi|514486632|gb|KE346360.1|	3363047	3363062	ACTC	15	-	3	GTGA
gi|514486632|gb|KE346360.1|	3364333	3364353	AAAAAAG	20	+	2	AAAAAAG
gi|514486632|gb|KE346360.1|	3364582	3364603	A	21	-	21	T
gi|514486632|gb|KE346360.1|	3365181	3365209	A	28	-	28	T
gi|514486632|gb|KE346360.1|	3367180	3367197	AGC	17	+	5	GCA
gi|514486632|gb|KE346360.1|	3367347	3367361	ACGCG	14	-	2	GCGTC
gi|514486632|gb|KE346360.1|	3369129	3369146	ACG	17	+	5	ACG
gi|514486632|gb|KE346360.1|	3369433	3369456	A	23	+	23	A
gi|514486632|gb|KE346360.1|	3369745	3369759	AAAGCC	14	-	2	CTTTGG
gi|514486632|gb|KE346360.1|	3369884	3369899	A	15	+	15	A
gi|514486632|gb|KE346360.1|	3369922	3369937	AAG	15	-	5	TTC
gi|514486632|gb|KE346360.1|	3370807	3370823	AGGGGG	16	-	2	CTCCCC
gi|514486632|gb|KE346360.1|	3371588	3371605	AAGACG	17	-	2	TCTTCG
gi|514486632|gb|KE346360.1|	3372301	3372316	AAAACAC	15	+	2	ACACAAA
gi|514486632|gb|KE346360.1|	3373182	3373196	AATCCTC	14	+	2	CTCAATC
gi|514486632|gb|KE346360.1|	3373672	3373687	AAGAAGG	15	+	2	GAAGGAA
gi|514486632|gb|KE346360.1|	3374236	3374251	CCCG	15	-	3	GGGC
gi|514486632|gb|KE346360.1|	3374271	3374289	A	18	+	18	A
gi|514486632|gb|KE346360.1|	3374296	3374313	AACAAG	17	+	2	AAGAAC
gi|514486632|gb|KE346360.1|	3374368	3374382	AGGGGC	14	+	2	GCAGGG
gi|514486632|gb|KE346360.1|	3375697	3375713	ACCTGC	16	-	2	GCAGGT
gi|514486632|gb|KE346360.1|	3376420	3376435	A	15	+	15	A
gi|514486632|gb|KE346360.1|	3376604	3376619	A	15	+	15	A
gi|514486632|gb|KE346360.1|	3379446	3379467	AAC	21	+	7	ACA
gi|514486632|gb|KE346360.1|	3379726	3379741	ACCTGC	15	-	2	CAGGTG
gi|514486632|gb|KE346360.1|	3381724	3381739	AGGG	15	+	3	GAGG
gi|514486632|gb|KE346360.1|	3381748	3381801	AG	53	+	26	GA
gi|514486632|gb|KE346360.1|	3381875	3381893	AAC	18	+	6	ACA
gi|514486632|gb|KE346360.1|	3383315	3383341	AGC	26	+	8	GCA
gi|514486632|gb|KE346360.1|	3383582	3383599	AGC	17	+	5	GCA
gi|514486632|gb|KE346360.1|	3383639	3383665	AGC	26	+	8	GCA
gi|514486632|gb|KE346360.1|	3384234	3384250	ACGAGG	16	-	2	CGTCCT
gi|514486632|gb|KE346360.1|	3385049	3385065	AGC	16	+	5	GCA
gi|514486632|gb|KE346360.1|	3385231	3385248	AGC	17	+	5	AGC
gi|514486632|gb|KE346360.1|	3385318	3385333	AGC	15	+	5	AGC
gi|514486632|gb|KE346360.1|	3385566	3385580	ACGAGG	14	-	2	CGTCCT
gi|514486632|gb|KE346360.1|	3386217	3386251	A	34	-	34	T
gi|514486632|gb|KE346360.1|	3388139	3388165	ACC	26	+	8	ACC
gi|514486632|gb|KE346360.1|	3388442	3388463	AACCAC	21	+	3	CAACCA
gi|514486632|gb|KE346360.1|	3390598	3390618	AAC	20	-	6	TTG
gi|514486632|gb|KE346360.1|	3390647	3390669	A	22	-	22	T
gi|514486632|gb|KE346360.1|	3391864	3391887	AACTCC	23	+	3	CTCCAA
gi|514486632|gb|KE346360.1|	3393059	3393081	AAC	22	-	7	TGT
gi|514486632|gb|KE346360.1|	3393222	3393236	AAAAATG	14	-	2	TTCATTT
gi|514486632|gb|KE346360.1|	3393243	3393257	AACAATT	14	-	2	TAATTGT
gi|514486632|gb|KE346360.1|	3394618	3394632	AAAAC	14	-	2	TTTTG
gi|514486632|gb|KE346360.1|	3394740	3394762	A	22	-	22	T
gi|514486632|gb|KE346360.1|	3395186	3395225	A	39	+	39	A
gi|514486632|gb|KE346360.1|	3395241	3395257	AAAC	16	-	4	TTTG
gi|514486632|gb|KE346360.1|	3395289	3395303	ACACTC	14	+	2	ACACTC
gi|514486632|gb|KE346360.1|	3399459	3399473	ACC	14	+	4	ACC
gi|514486632|gb|KE346360.1|	3400114	3400131	AAGCCG	17	+	2	AGCCGA
gi|514486632|gb|KE346360.1|	3400303	3400323	A	20	-	20	T
gi|514486632|gb|KE346360.1|	3400646	3400684	A	38	-	38	T
gi|514486632|gb|KE346360.1|	3401247	3401262	AGG	15	-	5	TCC
gi|514486632|gb|KE346360.1|	3401665	3401679	AGATGC	14	-	2	ATCTGC
gi|514486632|gb|KE346360.1|	3402505	3402522	ACTG	17	-	4	GTCA
gi|514486632|gb|KE346360.1|	3402588	3402610	A	22	-	22	T
gi|514486632|gb|KE346360.1|	3402614	3402629	A	15	-	15	T
gi|514486632|gb|KE346360.1|	3402633	3402649	A	16	-	16	T
gi|514486632|gb|KE346360.1|	3402653	3402677	A	24	-	24	T
gi|514486632|gb|KE346360.1|	3405277	3405293	A	16	-	16	T
gi|514486632|gb|KE346360.1|	3405288	3405311	AAAAAC	23	-	3	TTTTTG
gi|514486632|gb|KE346360.1|	3405306	3405324	A	18	-	18	T
gi|514486632|gb|KE346360.1|	3405430	3405444	AGC	14	+	4	GCA
gi|514486632|gb|KE346360.1|	3405473	3405490	AGCAGG	17	-	2	CTGCTC
gi|514486632|gb|KE346360.1|	3405732	3405753	AACAGC	21	+	3	GCAACA
gi|514486632|gb|KE346360.1|	3405748	3405762	AGC	14	+	4	CAG
gi|514486632|gb|KE346360.1|	3407205	3407219	ACACCC	14	+	2	ACACCC
gi|514486632|gb|KE346360.1|	3407716	3407730	AGCATCG	14	+	2	AGCATCG
gi|514486632|gb|KE346360.1|	3410476	3410491	ACC	15	+	5	ACC
gi|514486632|gb|KE346360.1|	3410702	3410721	AGG	19	-	6	CCT
gi|514486632|gb|KE346360.1|	3411539	3411553	AAACAC	14	-	2	GTGTTT
gi|514486632|gb|KE346360.1|	3411922	3411940	A	18	+	18	A
gi|514486632|gb|KE346360.1|	3415493	3415507	ACTCTC	14	+	2	CTCACT
gi|514486632|gb|KE346360.1|	3415519	3415533	AAACAC	14	+	2	CAAACA
gi|514486632|gb|KE346360.1|	3415620	3415637	AAAAT	17	+	3	AATAA
gi|514486632|gb|KE346360.1|	3415781	3415804	AACTCC	23	-	3	TGGAGT
gi|514486632|gb|KE346360.1|	3416124	3416138	AAGCC	14	+	2	AAGCC
gi|514486632|gb|KE346360.1|	3416188	3416204	AG	16	-	8	TC
gi|514486632|gb|KE346360.1|	3416794	3416809	AAAAC	15	+	3	CAAAA
gi|514486632|gb|KE346360.1|	3416805	3416822	A	17	+	17	A
gi|514486632|gb|KE346360.1|	3417355	3417373	ACG	18	-	6	TCG
gi|514486632|gb|KE346360.1|	3419289	3419305	AATGT	16	+	3	AATGT
gi|514486632|gb|KE346360.1|	3419959	3419973	AACTG	14	-	2	TTCAG
gi|514486632|gb|KE346360.1|	3419974	3419992	AACTG	18	-	3	TCAGT
gi|514486632|gb|KE346360.1|	3420587	3420601	AAAACCC	14	+	2	CAAAACC
gi|514486632|gb|KE346360.1|	3420594	3420622	AAAACC	28	+	4	CAAAAC
gi|514486632|gb|KE346360.1|	3420636	3420654	AGCG	18	-	4	CTCG
gi|514486632|gb|KE346360.1|	3420710	3420725	AATGC	15	-	3	CATTG
gi|514486632|gb|KE346360.1|	3420785	3420805	A	20	-	20	T
gi|514486632|gb|KE346360.1|	3420984	3421017	A	33	+	33	A
gi|514486632|gb|KE346360.1|	3421066	3421081	AAAGCG	15	-	2	CTTTCG
gi|514486632|gb|KE346360.1|	3421231	3421246	A	15	+	15	A
gi|514486632|gb|KE346360.1|	3421339	3421368	ACTC	29	-	7	GTGA
gi|514486632|gb|KE346360.1|	3421559	3421574	AAC	15	-	5	TTG
gi|514486632|gb|KE346360.1|	3422589	3422603	ACCCC	14	+	2	CCCCA
gi|514486632|gb|KE346360.1|	3423677	3423693	AAAAAG	16	-	2	CTTTTT
gi|514486632|gb|KE346360.1|	3423769	3423785	AG	16	-	8	CT
gi|514486632|gb|KE346360.1|	3424766	3424788	AAC	22	-	7	TGT
gi|514486632|gb|KE346360.1|	3425034	3425135	AG	101	-	50	TC
gi|514486632|gb|KE346360.1|	3425785	3425801	ACCAGC	16	+	2	CCAGCA
gi|514486632|gb|KE346360.1|	3425798	3425813	ACTGCT	15	-	2	CAGTAG
gi|514486632|gb|KE346360.1|	3426794	3426809	AGCCGC	15	-	2	TGCGGC
gi|514486632|gb|KE346360.1|	3428201	3428217	AGC	16	+	5	GCA
gi|514486632|gb|KE346360.1|	3428444	3428458	ACATGG	14	-	2	CATGTC
gi|514486632|gb|KE346360.1|	3429002	3429027	A	25	-	25	T
gi|514486632|gb|KE346360.1|	3430263	3430286	A	23	-	23	T
gi|514486632|gb|KE346360.1|	3430402	3430426	AGAGCC	24	-	4	CTCTGG
gi|514486632|gb|KE346360.1|	3433211	3433231	AACAGC	20	-	3	TGCTGT
gi|514486632|gb|KE346360.1|	3433336	3433350	AGATCG	14	-	2	TCTCGA
gi|514486632|gb|KE346360.1|	3435144	3435167	AAAGTGC	23	+	3	CAAAGTG
gi|514486632|gb|KE346360.1|	3435180	3435195	AAAAGTG	15	+	2	AGTGAAA
gi|514486632|gb|KE346360.1|	3435212	3435231	A	19	-	19	T
gi|514486632|gb|KE346360.1|	3435805	3435819	AAGTCG	14	-	2	TCGACT
gi|514486632|gb|KE346360.1|	3435931	3435945	AAAAG	14	-	2	TTTTC
gi|514486632|gb|KE346360.1|	3436048	3436102	AG	54	-	27	TC
gi|514486632|gb|KE346360.1|	3436410	3436425	ACTCCC	15	+	2	CTCCCA
gi|514486632|gb|KE346360.1|	3436528	3436542	AAC	14	-	4	GTT
gi|514486632|gb|KE346360.1|	3436779	3436795	ATC	16	+	5	ATC
gi|514486632|gb|KE346360.1|	3437462	3437477	ACAGCAG	15	-	2	GTCTGCT
gi|514486632|gb|KE346360.1|	3437494	3437508	ACGATG	14	+	2	GACGAT
gi|514486632|gb|KE346360.1|	3437550	3437565	AGG	15	-	5	CTC
gi|514486632|gb|KE346360.1|	3439081	3439095	AAAAG	14	-	2	TTTTC
gi|514486632|gb|KE346360.1|	3439250	3439274	A	24	+	24	A
gi|514486632|gb|KE346360.1|	3439468	3439498	A	30	-	30	T
gi|514486632|gb|KE346360.1|	3439556	3439571	AAATAAT	15	+	2	AAATAAT
gi|514486632|gb|KE346360.1|	3439743	3439757	A	14	-	14	T
gi|514486632|gb|KE346360.1|	3439929	3439954	A	25	-	25	T
gi|514486632|gb|KE346360.1|	3439984	3440000	A	16	-	16	T
gi|514486632|gb|KE346360.1|	3440034	3440048	AAG	14	-	4	TCT
gi|514486632|gb|KE346360.1|	3441393	3441407	AAAAG	14	-	2	TTTTC
gi|514486632|gb|KE346360.1|	3441679	3441693	AAAACAC	14	-	2	TGTGTTT
gi|514486632|gb|KE346360.1|	3442818	3442916	AG	98	-	49	CT
gi|514486632|gb|KE346360.1|	3447096	3447110	ATC	14	+	4	ATC
gi|514486632|gb|KE346360.1|	3448610	3448624	AACG	14	+	3	AACG
gi|514486632|gb|KE346360.1|	3448627	3448652	A	25	+	25	A
gi|514486632|gb|KE346360.1|	3448837	3448851	AAAAAC	14	-	2	TTTTTG
gi|514486632|gb|KE346360.1|	3448881	3448895	AAATG	14	-	2	TTTCA
gi|514486632|gb|KE346360.1|	3449154	3449168	AAAAAAG	14	+	2	GAAAAAA
gi|514486632|gb|KE346360.1|	3449959	3449973	AAT	14	-	4	TTA
gi|514486632|gb|KE346360.1|	3449971	3449989	A	18	-	18	T
gi|514486632|gb|KE346360.1|	3450256	3450280	A	24	+	24	A
gi|514486632|gb|KE346360.1|	3450455	3450469	AAAAAAT	14	-	2	TATTTTT
gi|514486632|gb|KE346360.1|	3450659	3450680	A	21	-	21	T
gi|514486632|gb|KE346360.1|	3451419	3451443	A	24	-	24	T
gi|514486632|gb|KE346360.1|	3452186	3452202	AGC	16	-	5	GCT
gi|514486632|gb|KE346360.1|	3455667	3455685	A	18	-	18	T
gi|514486632|gb|KE346360.1|	3456226	3456247	A	21	-	21	T
gi|514486632|gb|KE346360.1|	3460029	3460048	ATGCC	19	-	3	GGCAT
gi|514486632|gb|KE346360.1|	3460865	3460879	AAACC	14	+	2	CAAAC
gi|514486632|gb|KE346360.1|	3460893	3460909	AAAAAAC	16	-	2	TTGTTTT
gi|514486632|gb|KE346360.1|	3461330	3461346	ACCCC	16	-	3	GGGGT
gi|514486632|gb|KE346360.1|	3463467	3463481	AACATTC	14	-	2	TGTTGAA
gi|514486632|gb|KE346360.1|	3464307	3464325	A	18	-	18	T
gi|514486632|gb|KE346360.1|	3464936	3464951	AAAAT	15	+	3	AAAAT
gi|514486632|gb|KE346360.1|	3466028	3466045	AAC	17	-	5	TGT
gi|514486632|gb|KE346360.1|	3466700	3466724	AAC	24	-	8	GTT
gi|514486632|gb|KE346360.1|	3466787	3466806	ACCATG	19	+	3	TGACCA
gi|514486632|gb|KE346360.1|	3466875	3466889	AGC	14	-	4	GCT
gi|514486632|gb|KE346360.1|	3467128	3467142	AGC	14	+	4	GCA
gi|514486632|gb|KE346360.1|	3467189	3467205	A	16	+	16	A
gi|514486632|gb|KE346360.1|	3467199	3467226	AAAAAAT	27	+	3	AAAAAAT
gi|514486632|gb|KE346360.1|	3467552	3467568	AAAAAAC	16	+	2	AAAAAAC
gi|514486632|gb|KE346360.1|	3467907	3467922	AAAGAAC	15	-	2	TTGTTCT
gi|514486632|gb|KE346360.1|	3468225	3468246	AC	21	-	10	TG
gi|514486632|gb|KE346360.1|	3470014	3470094	AG	80	+	40	GA
gi|514486632|gb|KE346360.1|	3470095	3470217	AG	122	+	61	AG
gi|514486632|gb|KE346360.1|	3470457	3470471	AAGAG	14	-	2	CTCTT
gi|514486632|gb|KE346360.1|	3470757	3470802	A	45	-	45	T
gi|514486632|gb|KE346360.1|	3470967	3470991	A	24	-	24	T
gi|514486632|gb|KE346360.1|	3471193	3471216	A	23	-	23	T
gi|514486632|gb|KE346360.1|	3471441	3471458	AAAAAC	17	+	2	AAAAAC
gi|514486632|gb|KE346360.1|	3471888	3471910	A	22	-	22	T
gi|514486632|gb|KE346360.1|	3471906	3471924	AAAACC	18	-	3	TTTTGG
gi|514486632|gb|KE346360.1|	3473239	3473265	AGC	26	+	8	CAG
gi|514486632|gb|KE346360.1|	3474004	3474018	AGC	14	+	4	CAG
gi|514486632|gb|KE346360.1|	3474099	3474117	AACAGC	18	+	3	GCAACA
gi|514486632|gb|KE346360.1|	3474700	3474717	AACAGC	17	+	2	CAGCAA
gi|514486632|gb|KE346360.1|	3474793	3474810	AACAGC	17	+	2	CAGCAA
gi|514486632|gb|KE346360.1|	3475133	3475149	AAAAAG	16	-	2	TTTTTC
gi|514486632|gb|KE346360.1|	3475151	3475166	A	15	-	15	T
gi|514486632|gb|KE346360.1|	3475161	3475175	AAAAATG	14	-	2	TTTTTCA
gi|514486632|gb|KE346360.1|	3475180	3475196	AAAAAG	16	-	2	TTTTTC
gi|514486632|gb|KE346360.1|	3475204	3475218	AAAAATG	14	-	2	TTTTTCA
gi|514486632|gb|KE346360.1|	3475291	3475305	ACGC	14	-	3	GTGC
gi|514486632|gb|KE346360.1|	3477833	3477847	AACAGC	14	-	2	TTGCTG
gi|514486632|gb|KE346360.1|	3478806	3478829	A	23	-	23	T
gi|514486632|gb|KE346360.1|	3478977	3478992	AAAC	15	+	3	AAAC
gi|514486632|gb|KE346360.1|	3479376	3479397	AAAAAAC	21	-	3	TGTTTTT
gi|514486632|gb|KE346360.1|	3479799	3479818	AAAC	19	+	4	AAAC
gi|514486632|gb|KE346360.1|	3479815	3479832	A	17	+	17	A
gi|514486632|gb|KE346360.1|	3484021	3484035	AACAATC	14	-	2	TGATTGT
gi|514486632|gb|KE346360.1|	3484076	3484091	AAAATG	15	-	2	TTTTCA
gi|514486632|gb|KE346360.1|	3485767	3485781	ACCATG	14	+	2	CCATGA
gi|514486632|gb|KE346360.1|	3485811	3485825	ACGGCG	14	+	2	CGACGG
gi|514486632|gb|KE346360.1|	3486160	3486175	AACAGCG	15	-	2	TCGCTGT
gi|514486632|gb|KE346360.1|	3486169	3486185	AACAGC	16	-	2	GCTGTT
gi|514486632|gb|KE346360.1|	3486180	3486200	AGC	20	-	6	TGC
gi|514486632|gb|KE346360.1|	3486195	3486218	AACAGC	23	-	3	TGCTGT
gi|514486632|gb|KE346360.1|	3486723	3486739	AAAAGG	16	-	2	TTTTCC
gi|514486632|gb|KE346360.1|	3486735	3486751	A	16	-	16	T
gi|514486632|gb|KE346360.1|	3486850	3486865	ACACAT	15	+	2	ACATAC
gi|514486632|gb|KE346360.1|	3487189	3487203	AAACAGC	14	+	2	CAGCAAA
gi|514486632|gb|KE346360.1|	3489351	3489365	ACG	14	-	4	TCG
gi|514486632|gb|KE346360.1|	3490913	3490930	AAAAG	17	-	3	TTCTT
gi|514486632|gb|KE346360.1|	3492081	3492096	AAAAC	15	+	3	AAAAC
gi|514486632|gb|KE346360.1|	3494396	3494410	ACG	14	-	4	TCG
gi|514486632|gb|KE346360.1|	3495961	3495978	AAAAG	17	-	3	TTCTT
gi|514486632|gb|KE346360.1|	3496463	3496480	AC	17	-	8	GT
gi|514486632|gb|KE346360.1|	3497013	3497040	A	27	+	27	A
gi|514486632|gb|KE346360.1|	3497087	3497102	AAAAC	15	+	3	AAAAC
gi|514486632|gb|KE346360.1|	3499958	3499974	AAAAATG	16	-	2	TTCATTT
gi|514486632|gb|KE346360.1|	3500061	3500079	ACGAGCG	18	-	2	CGCTCGT
gi|514486632|gb|KE346360.1|	3500509	3500534	AG	25	-	12	TC
gi|514486632|gb|KE346360.1|	3500903	3500922	AAAAAAT	19	+	2	AAATAAA
gi|514486632|gb|KE346360.1|	3501022	3501036	A	14	+	14	A
gi|514486632|gb|KE346360.1|	3501534	3501548	AAGCATG	14	+	2	AAGCATG
gi|514486632|gb|KE346360.1|	3502121	3502135	AACAGC	14	+	2	AACAGC
gi|514486632|gb|KE346360.1|	3505438	3505453	A	15	-	15	T
gi|514486632|gb|KE346360.1|	3505621	3505635	AAAAACC	14	+	2	CCAAAAA
gi|514486632|gb|KE346360.1|	3505643	3505665	A	22	+	22	A
gi|514486632|gb|KE346360.1|	3506981	3506998	AAAAAAC	17	-	2	TTTTTTG
gi|514486632|gb|KE346360.1|	3508339	3508353	ACCAGC	14	-	2	GCTGGT
gi|514486632|gb|KE346360.1|	3509607	3509629	AAAAAT	22	-	3	TTTTAT
gi|514486632|gb|KE346360.1|	3510068	3510088	AAAAAAT	20	-	2	TTTTTTA
gi|514486632|gb|KE346360.1|	3510392	3510406	AAAGGC	14	-	2	TTGCCT
gi|514486632|gb|KE346360.1|	3515493	3515512	ACG	19	-	6	TCG
gi|514486632|gb|KE346360.1|	3515729	3515744	ACTCATC	15	-	2	GATGAGT
gi|514486632|gb|KE346360.1|	3515848	3515864	ACCACT	16	+	2	ACTACC
gi|514486632|gb|KE346360.1|	3515866	3515882	ACT	16	+	5	ACT
gi|514486632|gb|KE346360.1|	3516241	3516256	AATCCTC	15	-	2	ATTGAGG
gi|514486632|gb|KE346360.1|	3516927	3516948	A	21	+	21	A
gi|514486632|gb|KE346360.1|	3518303	3518322	AC	19	-	9	TG
gi|514486632|gb|KE346360.1|	3518776	3518803	ACG	27	-	9	CGT
gi|514486632|gb|KE346360.1|	3519169	3519185	AGCCAT	16	+	2	ATAGCC
gi|514486632|gb|KE346360.1|	3519382	3519416	AGC	34	-	11	CTG
gi|514486632|gb|KE346360.1|	3519753	3519767	AAC	14	-	4	TGT
gi|514486632|gb|KE346360.1|	3519831	3519845	AGC	14	-	4	TGC
gi|514486632|gb|KE346360.1|	3520080	3520094	AACAGC	14	-	2	TGCTGT
gi|514486632|gb|KE346360.1|	3520185	3520199	ACGAGG	14	-	2	TCCTCG
gi|514486632|gb|KE346360.1|	3520203	3520217	AAGAGG	14	-	2	TCTTCC
gi|514486632|gb|KE346360.1|	3520212	3520226	AGG	14	-	4	TCC
gi|514486632|gb|KE346360.1|	3523084	3523106	ACC	22	+	7	CCA
gi|514486632|gb|KE346360.1|	3523209	3523229	AAAAAG	20	+	3	AAAAGA
gi|514486632|gb|KE346360.1|	3523404	3523440	A	36	+	36	A
gi|514486632|gb|KE346360.1|	3523441	3523455	A	14	+	14	A
gi|514486632|gb|KE346360.1|	3523564	3523593	AG	29	+	14	GA
gi|514486632|gb|KE346360.1|	3523677	3523694	ACCATC	17	-	2	TGGTGA
gi|514486632|gb|KE346360.1|	3523785	3523802	A	17	+	17	A
gi|514486632|gb|KE346360.1|	3523804	3523826	AAAAT	22	-	4	TTTTA
gi|514486632|gb|KE346360.1|	3523821	3523838	AAT	17	-	5	TTA
gi|514486632|gb|KE346360.1|	3523836	3523852	A	16	-	16	T
gi|514486632|gb|KE346360.1|	3523858	3523872	AACAAGG	14	-	2	GTTCCTT
gi|514486632|gb|KE346360.1|	3524028	3524047	AAAG	19	+	4	AAAG
gi|514486632|gb|KE346360.1|	3524040	3524057	AAAAAAG	17	+	2	AAAGAAA
gi|514486632|gb|KE346360.1|	3525270	3525286	AAAATC	16	+	2	CAAAAT
gi|514486632|gb|KE346360.1|	3525556	3525573	ATC	17	-	5	GAT
gi|514486632|gb|KE346360.1|	3525818	3525835	ACG	17	+	5	ACG
gi|514486632|gb|KE346360.1|	3525833	3525849	AAC	16	+	5	ACA
gi|514486632|gb|KE346360.1|	3527555	3527572	AG	17	+	8	GA
gi|514486632|gb|KE346360.1|	3529247	3529264	AAAAAT	17	+	2	TAAAAA
gi|514486632|gb|KE346360.1|	3530002	3530017	AC	15	+	7	AC
gi|514486632|gb|KE346360.1|	3530612	3530626	AAGCGCC	14	-	2	GCTTGGC
gi|514486632|gb|KE346360.1|	3531759	3531773	AAACAAG	14	+	2	AACAAGA
gi|514486632|gb|KE346360.1|	3531986	3532001	AAAAC	15	+	3	CAAAA
gi|514486632|gb|KE346360.1|	3532617	3532632	ATCGCC	15	+	2	GCCATC
gi|514486632|gb|KE346360.1|	3532721	3532736	AAAACTC	15	-	2	TTGAGTT
gi|514486632|gb|KE346360.1|	3533199	3533214	AAAAATG	15	+	2	AATGAAA
gi|514486632|gb|KE346360.1|	3533261	3533276	AAATGGG	15	+	2	AAATGGG
gi|514486632|gb|KE346360.1|	3533468	3533485	AGC	17	+	5	AGC
gi|514486632|gb|KE346360.1|	3533534	3533563	AAGATC	29	+	4	CAAGAT
gi|514486632|gb|KE346360.1|	3533794	3533815	ACTGGC	21	-	3	TGCCAG
gi|514486632|gb|KE346360.1|	3534076	3534090	AAGCTC	14	-	2	GCTTGA
gi|514486632|gb|KE346360.1|	3535886	3535902	AGC	16	+	5	CAG
gi|514486632|gb|KE346360.1|	3535962	3535976	AGCGC	14	-	2	TGCGC
gi|514486632|gb|KE346360.1|	3536222	3536240	AC	18	-	9	GT
gi|514486632|gb|KE346360.1|	3537536	3537550	AAAC	14	-	3	TTTG
gi|514486632|gb|KE346360.1|	3539810	3539825	AAAAC	15	+	3	CAAAA
gi|514486632|gb|KE346360.1|	3541882	3541896	AACAGC	14	-	2	TGTTGC
gi|514486632|gb|KE346360.1|	3541933	3541958	AGC	25	-	8	TGC
gi|514486632|gb|KE346360.1|	3542046	3542060	ACACG	14	-	2	GTCGT
gi|514486632|gb|KE346360.1|	3542093	3542108	AGC	15	-	5	TGC
gi|514486632|gb|KE346360.1|	3542215	3542230	AGC	15	-	5	CTG
gi|514486632|gb|KE346360.1|	3542228	3542242	AAC	14	-	4	TGT
gi|514486632|gb|KE346360.1|	3545123	3545137	ACCCC	14	-	2	GGGGT
gi|514486632|gb|KE346360.1|	3545165	3545181	AAAAAAG	16	+	2	AAAAGAA
gi|514486632|gb|KE346360.1|	3546305	3546320	A	15	-	15	T
gi|514486632|gb|KE346360.1|	3546756	3546771	ACGAGG	15	-	2	CGTCCT
gi|514486632|gb|KE346360.1|	3550251	3550268	AGC	17	-	5	TGC
gi|514486632|gb|KE346360.1|	3551081	3551096	AAAAC	15	+	3	AAAAC
gi|514486632|gb|KE346360.1|	3552639	3552653	AGCAGCC	14	-	2	GCTGCTG
gi|514486632|gb|KE346360.1|	3553029	3553044	ACGCGAT	15	-	2	GTATCGC
gi|514486632|gb|KE346360.1|	3553818	3553841	A	23	-	23	T
gi|514486632|gb|KE346360.1|	3554003	3554026	A	23	+	23	A
gi|514486632|gb|KE346360.1|	3554576	3554597	A	21	+	21	A
gi|514486632|gb|KE346360.1|	3554620	3554640	A	20	-	20	T
gi|514486632|gb|KE346360.1|	3554642	3554660	A	18	-	18	T
gi|514486632|gb|KE346360.1|	3554792	3554810	ACC	18	-	6	GTG
gi|514486632|gb|KE346360.1|	3555228	3555243	AGATCC	15	-	2	ATCTGG
gi|514486632|gb|KE346360.1|	3555614	3555628	AACAAG	14	-	2	TTCTTG
gi|514486632|gb|KE346360.1|	3555623	3555642	AAACAAC	19	-	2	TTGTTTG
gi|514486632|gb|KE346360.1|	3555674	3555691	AAG	17	+	5	GAA
gi|514486632|gb|KE346360.1|	3556201	3556215	AAAAG	14	-	2	TTTTC
gi|514486632|gb|KE346360.1|	3557000	3557016	AAACAAC	16	-	2	TTGTTTG
gi|514486632|gb|KE346360.1|	3557009	3557035	AAAC	26	-	6	GTTT
gi|514486632|gb|KE346360.1|	3557934	3557958	AAC	24	-	8	TGT
gi|514486632|gb|KE346360.1|	3560064	3560082	A	18	+	18	A
gi|514486632|gb|KE346360.1|	3560098	3560112	AAAAAAG	14	-	2	TTTTTTC
gi|514486632|gb|KE346360.1|	3560114	3560130	A	16	-	16	T
gi|514486632|gb|KE346360.1|	3560638	3560659	A	21	-	21	T
gi|514486632|gb|KE346360.1|	3560813	3560836	A	23	+	23	A
gi|514486632|gb|KE346360.1|	3560869	3560888	A	19	+	19	A
gi|514486632|gb|KE346360.1|	3561193	3561211	AATGGG	18	+	3	ATGGGA
gi|514486632|gb|KE346360.1|	3561258	3561272	A	14	+	14	A
gi|514486632|gb|KE346360.1|	3561744	3561758	AGAGAGC	14	+	2	AGAGCAG
gi|514486632|gb|KE346360.1|	3563502	3563519	ACGAGG	17	+	2	ACGAGG
gi|514486632|gb|KE346360.1|	3565284	3565300	A	16	-	16	T
gi|514486632|gb|KE346360.1|	3565346	3565367	AAAAACG	21	-	3	TTTTTCG
gi|514486632|gb|KE346360.1|	3565499	3565526	A	27	-	27	T
gi|514486632|gb|KE346360.1|	3565917	3565931	AAAC	14	-	3	GTTT
gi|514486632|gb|KE346360.1|	3565954	3565968	AAAAT	14	-	2	TTTTA
gi|514486632|gb|KE346360.1|	3565972	3565988	AAAAAAT	16	-	2	TTATTTT
gi|514486632|gb|KE346360.1|	3566347	3566369	A	22	-	22	T
gi|514486632|gb|KE346360.1|	3566372	3566391	AAAAACC	19	-	2	TTTTTGG
gi|514486632|gb|KE346360.1|	3566603	3566619	AAG	16	-	5	CTT
gi|514486632|gb|KE346360.1|	3566620	3566637	AAG	17	-	5	TCT
gi|514486632|gb|KE346360.1|	3567680	3567700	AAAAAAG	20	+	2	AAAAAAG
gi|514486632|gb|KE346360.1|	3567850	3567872	AAAAT	22	-	4	ATTTT
gi|514486632|gb|KE346360.1|	3568099	3568121	A	22	+	22	A
gi|514486632|gb|KE346360.1|	3568178	3568192	AAAAAC	14	-	2	TTGTTT
gi|514486632|gb|KE346360.1|	3568350	3568365	AAAACG	15	-	2	TTTTCG
gi|514486632|gb|KE346360.1|	3568580	3568594	A	14	+	14	A
gi|514486632|gb|KE346360.1|	3568835	3568854	A	19	-	19	T
gi|514486632|gb|KE346360.1|	3569045	3569060	AAAAAAT	15	-	2	TATTTTT
gi|514486632|gb|KE346360.1|	3569087	3569103	A	16	+	16	A
gi|514486632|gb|KE346360.1|	3569142	3569158	A	16	-	16	T
gi|514486632|gb|KE346360.1|	3569225	3569240	A	15	-	15	T
gi|514486632|gb|KE346360.1|	3569248	3569263	AC	15	+	7	CA
gi|514486632|gb|KE346360.1|	3569264	3569295	AG	31	-	15	CT
gi|514486632|gb|KE346360.1|	3570588	3570603	AAG	15	+	5	GAA
gi|514486632|gb|KE346360.1|	3575174	3575188	AACGCGC	14	-	2	TGCGCGT
gi|514486632|gb|KE346360.1|	3576457	3576471	AGCGGC	14	-	2	GCTGCC
gi|514486632|gb|KE346360.1|	3576799	3576814	ACGAG	15	-	3	CGTCT
gi|514486632|gb|KE346360.1|	3577197	3577218	ACAGAG	21	-	3	TCTGTC
gi|514486632|gb|KE346360.1|	3577373	3577390	AAAAAAG	17	-	2	TTTTTTC
gi|514486632|gb|KE346360.1|	3578606	3578621	AGCCCG	15	-	2	CTCGGG
gi|514486632|gb|KE346360.1|	3578839	3578853	AATGCC	14	-	2	CATTGG
gi|514486632|gb|KE346360.1|	3578854	3578869	AGC	15	+	5	GCA
gi|514486632|gb|KE346360.1|	3578990	3579007	AAC	17	-	5	GTT
gi|514486632|gb|KE346360.1|	3579183	3579202	ACTCTC	19	-	3	GAGTGA
gi|514486632|gb|KE346360.1|	3579479	3579495	ACTC	16	-	4	GTGA
gi|514486632|gb|KE346360.1|	3579590	3579620	ACC	30	+	10	CAC
gi|514486632|gb|KE346360.1|	3579635	3579657	AAC	22	+	7	AAC
gi|514486632|gb|KE346360.1|	3579720	3579741	AGC	21	-	7	GCT
gi|514486632|gb|KE346360.1|	3582061	3582075	AAAGATT	14	-	2	AATCTTT
gi|514486632|gb|KE346360.1|	3582191	3582212	AAC	21	+	7	AAC
gi|514486632|gb|KE346360.1|	3582209	3582223	AACG	14	+	3	AACG
gi|514486632|gb|KE346360.1|	3582379	3582394	ACTCTC	15	-	2	TGAGAG
gi|514486632|gb|KE346360.1|	3582403	3582419	ACTC	16	-	4	TGAG
gi|514486632|gb|KE346360.1|	3582473	3582496	A	23	+	23	A
gi|514486632|gb|KE346360.1|	3582508	3582525	AAAAAAG	17	-	2	TTTCTTT
gi|514486632|gb|KE346360.1|	3582519	3582536	A	17	-	17	T
gi|514486632|gb|KE346360.1|	3582542	3582556	AAAGC	14	-	2	TTGCT
gi|514486632|gb|KE346360.1|	3582706	3582723	A	17	-	17	T
gi|514486632|gb|KE346360.1|	3582724	3582742	A	18	-	18	T
gi|514486632|gb|KE346360.1|	3582900	3582920	A	20	+	20	A
gi|514486632|gb|KE346360.1|	3582952	3582975	A	23	-	23	T
gi|514486632|gb|KE346360.1|	3583003	3583023	A	20	-	20	T
gi|514486632|gb|KE346360.1|	3583182	3583199	AACTGTG	17	+	2	GAACTGT
gi|514486632|gb|KE346360.1|	3583216	3583232	ATC	16	+	5	CAT
gi|514486632|gb|KE346360.1|	3585839	3585855	ACCCCTC	16	-	2	GTGAGGG
gi|514486632|gb|KE346360.1|	3586498	3586512	AAGCAC	14	-	2	TGTGCT
gi|514486632|gb|KE346360.1|	3586823	3586845	A	22	-	22	T
gi|514486632|gb|KE346360.1|	3587309	3587329	A	20	-	20	T
gi|514486632|gb|KE346360.1|	3587364	3587379	A	15	-	15	T
gi|514486632|gb|KE346360.1|	3590280	3590294	AAAGATC	14	-	2	TTTGATC
gi|514486632|gb|KE346360.1|	3590980	3590998	AAAAG	18	+	3	AAAAG
gi|514486632|gb|KE346360.1|	3591413	3591427	AAAAC	14	+	2	AAAAC
gi|514486632|gb|KE346360.1|	3591673	3591692	A	19	+	19	A
gi|514486632|gb|KE346360.1|	3591707	3591722	A	15	+	15	A
gi|514486632|gb|KE346360.1|	3591926	3591951	A	25	+	25	A
gi|514486632|gb|KE346360.1|	3592136	3592165	A	29	-	29	T
gi|514486632|gb|KE346360.1|	3592341	3592355	A	14	+	14	A
gi|514486632|gb|KE346360.1|	3592361	3592376	AAG	15	+	5	AAG
gi|514486632|gb|KE346360.1|	3592419	3592434	ACAGGC	15	-	2	TGCCTG
gi|514486632|gb|KE346360.1|	3592714	3592731	ACC	17	+	5	ACC
gi|514486632|gb|KE346360.1|	3592961	3592979	A	18	+	18	A
gi|514486632|gb|KE346360.1|	3594064	3594078	AAGTGG	14	+	2	AGTGGA
gi|514486632|gb|KE346360.1|	3594338	3594362	AAGTG	24	+	4	GTGAA
gi|514486632|gb|KE346360.1|	3594412	3594431	A	19	+	19	A
gi|514486632|gb|KE346360.1|	3595487	3595501	AAACC	14	+	2	CAAAC
gi|514486632|gb|KE346360.1|	3596675	3596692	ACACAT	17	+	2	ACACAT
gi|514486632|gb|KE346360.1|	3596687	3596710	AC	23	+	11	AC
gi|514486632|gb|KE346360.1|	3599450	3599464	AAGGTCC	14	+	2	CAAGGTC
gi|514486632|gb|KE346360.1|	3599682	3599702	AAAAC	20	+	4	ACAAA
gi|514486632|gb|KE346360.1|	3600224	3600245	AGC	21	-	7	CTG
gi|514486632|gb|KE346360.1|	3600248	3600263	AGC	15	-	5	TGC
gi|514486632|gb|KE346360.1|	3600484	3600507	ACTGAG	23	-	3	GTCTCA
gi|514486632|gb|KE346360.1|	3600532	3600551	AAAAAAC	19	-	2	TTTTTTG
gi|514486632|gb|KE346360.1|	3600704	3600723	AGC	19	-	6	CTG
gi|514486632|gb|KE346360.1|	3602088	3602108	AAC	20	-	6	GTT
gi|514486632|gb|KE346360.1|	3602106	3602120	ACG	14	-	4	GTC
gi|514486632|gb|KE346360.1|	3603390	3603404	ACGAGG	14	+	2	GACGAG
gi|514486632|gb|KE346360.1|	3603844	3603858	AAAGAAT	14	+	2	GAATAAA
gi|514486632|gb|KE346360.1|	3603869	3603892	AAT	23	+	7	AAT
gi|514486632|gb|KE346360.1|	3604095	3604109	AAAAAAC	14	+	2	AAAAAAC
gi|514486632|gb|KE346360.1|	3605100	3605118	AGC	18	+	6	CAG
gi|514486632|gb|KE346360.1|	3605443	3605457	AGGCG	14	-	2	CGCCT
gi|514486632|gb|KE346360.1|	3606003	3606017	ACTGCG	14	+	2	GCGACT
gi|514486632|gb|KE346360.1|	3606484	3606506	ACGATG	22	+	3	GATGAC
gi|514486632|gb|KE346360.1|	3607185	3607210	ACTCTC	25	-	4	GAGAGT
gi|514486632|gb|KE346360.1|	3609218	3609233	ACCACG	15	-	2	GTGGTC
gi|514486632|gb|KE346360.1|	3609745	3609759	AGC	14	+	4	CAG
gi|514486632|gb|KE346360.1|	3609905	3609922	AAAGG	17	+	3	AAAGG
gi|514486632|gb|KE346360.1|	3609920	3609934	AAAGGG	14	+	2	AAGGGA
gi|514486632|gb|KE346360.1|	3609966	3609986	A	20	+	20	A
gi|514486632|gb|KE346360.1|	3610015	3610029	AAAAAAG	14	+	2	GAAAAAA
gi|514486632|gb|KE346360.1|	3610056	3610070	AATCAC	14	+	2	AATCAC
gi|514486632|gb|KE346360.1|	3610667	3610686	AAAAAG	19	+	3	AAAAAG
gi|514486632|gb|KE346360.1|	3610852	3610874	AAATCC	22	-	3	TGGATT
gi|514486632|gb|KE346360.1|	3610877	3610891	ACTG	14	-	3	CAGT
gi|514486632|gb|KE346360.1|	3611017	3611032	AGC	15	-	5	TGC
gi|514486632|gb|KE346360.1|	3611099	3611115	AAGCAC	16	+	2	CAAGCA
gi|514486632|gb|KE346360.1|	3611323	3611350	ACCAGC	27	-	4	TGGTGC
gi|514486632|gb|KE346360.1|	3614728	3614748	AGC	20	-	6	CTG
gi|514486632|gb|KE346360.1|	3615491	3615507	AAGCC	16	+	3	AGCCA
gi|514486632|gb|KE346360.1|	3615668	3615682	CCG	14	-	4	GCG
gi|514486632|gb|KE346360.1|	3615837	3615851	AATGCC	14	+	2	TGCCAA
gi|514486632|gb|KE346360.1|	3615997	3616018	AGC	21	+	7	CAG
gi|514486632|gb|KE346360.1|	3617179	3617193	AAGGGG	14	-	2	CCTTCC
gi|514486632|gb|KE346360.1|	3618006	3618020	AAAGCT	14	+	2	AAAGCT
gi|514486632|gb|KE346360.1|	3620811	3620825	ACGCCC	14	+	2	GCCCAC
gi|514486632|gb|KE346360.1|	3622641	3622658	AGC	17	-	5	GCT
gi|514486632|gb|KE346360.1|	3622827	3622841	AAC	14	+	4	AAC
gi|514486632|gb|KE346360.1|	3622866	3622883	AAAC	17	+	4	AAAC
gi|514486632|gb|KE346360.1|	3623187	3623202	A	15	+	15	A
gi|514486632|gb|KE346360.1|	3623735	3623751	A	16	+	16	A
gi|514486632|gb|KE346360.1|	3623855	3623879	AG	24	+	12	GA
gi|514486632|gb|KE346360.1|	3624708	3624723	AGAGCTG	15	-	2	AGCTCTC
gi|514486632|gb|KE346360.1|	3627211	3627232	ACG	21	-	7	TCG
gi|514486632|gb|KE346360.1|	3628670	3628684	ACT	14	+	4	CTA
gi|514486632|gb|KE346360.1|	3628761	3628776	ACGAGC	15	-	2	GCTCGT
gi|514486632|gb|KE346360.1|	3629091	3629106	AAC	15	+	5	CAA
gi|514486632|gb|KE346360.1|	3629292	3629315	AGC	23	+	7	CAG
gi|514486632|gb|KE346360.1|	3629627	3629686	AGGATC	59	+	9	ATCAGG
gi|514486632|gb|KE346360.1|	3629697	3629712	ACG	15	-	5	TCG
gi|514486632|gb|KE346360.1|	3630066	3630114	AACCAG	48	-	8	TCTGGT
gi|514486632|gb|KE346360.1|	3630597	3630611	AGGATG	14	-	2	TCATCC
gi|514486632|gb|KE346360.1|	3631804	3631818	AGATGG	14	+	2	TGGAGA
gi|514486632|gb|KE346360.1|	3636231	3636259	AGC	28	-	9	GCT
gi|514486632|gb|KE346360.1|	3636488	3636506	AAG	18	+	6	AAG
gi|514486632|gb|KE346360.1|	3637503	3637546	AAC	43	+	14	ACA
gi|514486632|gb|KE346360.1|	3637545	3637573	AAAC	28	+	7	AAAC
gi|514486632|gb|KE346360.1|	3639395	3639409	ACTCAG	14	-	2	AGTCTG
gi|514486632|gb|KE346360.1|	3639667	3639696	ACT	29	-	9	GTA
gi|514486632|gb|KE346360.1|	3639946	3639961	AGAGGG	15	+	2	AGAGGG
gi|514486632|gb|KE346360.1|	3642133	3642156	A	23	-	23	T
gi|514486632|gb|KE346360.1|	3642396	3642422	A	26	+	26	A
gi|514486632|gb|KE346360.1|	3642866	3642890	AAG	24	+	8	GAA
gi|514486632|gb|KE346360.1|	3642942	3642975	A	33	+	33	A
gi|514486632|gb|KE346360.1|	3643155	3643170	AAACAAG	15	+	2	AACAAGA
gi|514486632|gb|KE346360.1|	3643275	3643303	ATC	28	-	9	ATG
gi|514486632|gb|KE346360.1|	3643929	3643946	AAC	17	+	5	AAC
gi|514486632|gb|KE346360.1|	3643939	3643953	AAACAAC	14	+	2	ACAACAA
gi|514486632|gb|KE346360.1|	3644663	3644688	A	25	+	25	A
gi|514486632|gb|KE346360.1|	3644820	3644838	A	18	+	18	A
gi|514486632|gb|KE346360.1|	3647304	3647319	ACTGGC	15	-	2	GCCAGT
gi|514486632|gb|KE346360.1|	3651101	3651126	A	25	+	25	A
gi|514486632|gb|KE346360.1|	3651156	3651174	A	18	-	18	T
gi|514486632|gb|KE346360.1|	3651365	3651385	A	20	+	20	A
gi|514486632|gb|KE346360.1|	3651392	3651409	A	17	+	17	A
gi|514486632|gb|KE346360.1|	3651601	3651618	A	17	-	17	T
gi|514486632|gb|KE346360.1|	3651826	3651843	A	17	-	17	T
gi|514486632|gb|KE346360.1|	3651881	3651910	A	29	+	29	A
gi|514486632|gb|KE346360.1|	3651929	3651956	A	27	-	27	T
gi|514486632|gb|KE346360.1|	3651969	3651983	AATGCTG	14	-	2	CAGCATT
gi|514486632|gb|KE346360.1|	3652214	3652237	A	23	-	23	T
gi|514486632|gb|KE346360.1|	3652258	3652272	AAAAGCG	14	+	2	GCGAAAA
gi|514486632|gb|KE346360.1|	3652585	3652605	AAAAC	20	-	4	TTTTG
gi|514486632|gb|KE346360.1|	3653687	3653701	AAAAAC	14	-	2	TTTTTG
gi|514486632|gb|KE346360.1|	3654409	3654426	AACAAG	17	-	2	TTGTTC
gi|514486632|gb|KE346360.1|	3656692	3656706	ACT	14	-	4	AGT
gi|514486632|gb|KE346360.1|	3656731	3656745	ACCAGCC	14	-	2	GGTGGCT
gi|514486632|gb|KE346360.1|	3657107	3657122	AACAACC	15	-	2	TTGGTTG
gi|514486632|gb|KE346360.1|	3657159	3657173	AGATC	14	-	2	CTGAT
gi|514486632|gb|KE346360.1|	3657169	3657188	AGCTC	19	-	3	CTGAG
gi|514486632|gb|KE346360.1|	3659638	3659670	ATC	32	-	10	GAT
gi|514486632|gb|KE346360.1|	3659981	3659995	AAAGCC	14	-	2	CTTTGG
gi|514486632|gb|KE346360.1|	3660037	3660057	ACG	20	-	6	GTC
gi|514486632|gb|KE346360.1|	3660384	3660402	AGC	18	-	6	GCT
gi|514486632|gb|KE346360.1|	3660600	3660615	AAGAAGC	15	+	2	AAGAAGC
gi|514486632|gb|KE346360.1|	3660683	3660730	A	47	-	47	T
gi|514486632|gb|KE346360.1|	3660751	3660766	A	15	-	15	T
gi|514486632|gb|KE346360.1|	3660973	3660987	AC	14	+	7	CA
gi|514486632|gb|KE346360.1|	3661589	3661612	ACT	23	+	7	CTA
gi|514486632|gb|KE346360.1|	3662301	3662318	AGC	17	+	5	GCA
gi|514486632|gb|KE346360.1|	3662928	3662942	AACC	14	-	3	GGTT
gi|514486632|gb|KE346360.1|	3664400	3664426	ACG	26	+	8	GAC
gi|514486632|gb|KE346360.1|	3665741	3665755	AG	14	+	7	GA
gi|514486632|gb|KE346360.1|	3665794	3665808	AG	14	+	7	GA
gi|514486632|gb|KE346360.1|	3665827	3665842	AC	15	+	7	AC
gi|514486632|gb|KE346360.1|	3667478	3667492	AAGGTGG	14	-	2	CTTCCAC
gi|514486632|gb|KE346360.1|	3667874	3667888	ACCAGC	14	+	2	CACCAG
gi|514486632|gb|KE346360.1|	3667883	3667909	AGC	26	+	8	CAG
gi|514486632|gb|KE346360.1|	3668350	3668367	CCG	17	+	5	GCC
gi|514486632|gb|KE346360.1|	3669456	3669471	A	15	-	15	T
gi|514486632|gb|KE346360.1|	3672910	3672924	AACAGC	14	+	2	CAGCAA
gi|514486632|gb|KE346360.1|	3674232	3674259	A	27	+	27	A
gi|514486632|gb|KE346360.1|	3674291	3674309	A	18	+	18	A
gi|514486632|gb|KE346360.1|	3675020	3675039	ACGAG	19	-	3	TCTCG
gi|514486632|gb|KE346360.1|	3675303	3675320	AG	17	+	8	AG
gi|514486632|gb|KE346360.1|	3675502	3675524	A	22	-	22	T
gi|514486632|gb|KE346360.1|	3675937	3675966	AGC	29	-	9	TGC
gi|514486632|gb|KE346360.1|	3678699	3678729	ATC	30	+	10	ATC
gi|514486632|gb|KE346360.1|	3678735	3678750	ACAGCG	15	-	2	GTCGCT
gi|514486632|gb|KE346360.1|	3679171	3679196	A	25	-	25	T
gi|514486632|gb|KE346360.1|	3679239	3679254	AG	15	-	7	CT
gi|514486632|gb|KE346360.1|	3679255	3679329	AG	74	-	37	CT
gi|514486632|gb|KE346360.1|	3679529	3679550	AGC	21	+	7	CAG
gi|514486632|gb|KE346360.1|	3680000	3680018	ACT	18	+	6	ACT
gi|514486632|gb|KE346360.1|	3680537	3680554	AAAACC	17	-	2	TTTTGG
gi|514486632|gb|KE346360.1|	3682714	3682735	AACCACC	21	+	3	ACCACCA
gi|514486632|gb|KE346360.1|	3682796	3682816	AACCCTC	20	-	2	GGGTTGA
gi|514486632|gb|KE346360.1|	3682810	3682825	AACCCC	15	-	2	GGGTTG
gi|514486632|gb|KE346360.1|	3684070	3684087	AACTCC	17	+	2	TCCAAC
gi|514486632|gb|KE346360.1|	3684288	3684307	AGC	19	-	6	GCT
gi|514486632|gb|KE346360.1|	3684536	3684551	AGG	15	-	5	CTC
gi|514486632|gb|KE346360.1|	3684567	3684585	ACTGGC	18	+	3	ACTGGC
gi|514486632|gb|KE346360.1|	3684586	3684601	ACTGGC	15	+	2	CTGGCA
gi|514486632|gb|KE346360.1|	3685017	3685033	AAAAAC	16	-	2	GTTTTT
gi|514486632|gb|KE346360.1|	3686598	3686612	A	14	-	14	T
gi|514486632|gb|KE346360.1|	3687557	3687573	AAC	16	-	5	GTT
gi|514486632|gb|KE346360.1|	3689019	3689033	ACGGGG	14	-	2	CGTCCC
gi|514486632|gb|KE346360.1|	3690012	3690026	AGC	14	+	4	GCA
gi|514486632|gb|KE346360.1|	3690407	3690431	AGC	24	-	8	CTG
gi|514486632|gb|KE346360.1|	3690812	3690828	AGC	16	-	5	GCT
gi|514486632|gb|KE346360.1|	3690829	3690843	AGCCAT	14	+	2	CCATAG
gi|514486632|gb|KE346360.1|	3690909	3690932	A	23	+	23	A
gi|514486632|gb|KE346360.1|	3691160	3691175	AAAC	15	+	3	ACAA
gi|514486632|gb|KE346360.1|	3691184	3691200	AG	16	-	8	CT
gi|514486632|gb|KE346360.1|	3691450	3691465	ACTCC	15	-	3	GGAGT
gi|514486632|gb|KE346360.1|	3691482	3691496	AATACTC	14	-	2	TGAGTAT
gi|514486632|gb|KE346360.1|	3693858	3693872	AAAAC	14	-	2	GTTTT
gi|514486632|gb|KE346360.1|	3693911	3693925	AAATTAG	14	-	2	AATTTCT
gi|514486632|gb|KE346360.1|	3698347	3698387	A	40	+	40	A
gi|514486632|gb|KE346360.1|	3698403	3698419	AAAG	16	-	4	CTTT
gi|514486632|gb|KE346360.1|	3698471	3698487	AATGC	16	+	3	CAATG
gi|514486632|gb|KE346360.1|	3698489	3698506	AAC	17	-	5	TGT
gi|514486632|gb|KE346360.1|	3701586	3701602	AAACC	16	-	3	GGTTT
gi|514486632|gb|KE346360.1|	3702018	3702033	AGC	15	+	5	AGC
gi|514486632|gb|KE346360.1|	3702849	3702863	AG	14	+	7	GA
gi|514486632|gb|KE346360.1|	3703396	3703413	A	17	-	17	T
gi|514486632|gb|KE346360.1|	3704886	3704901	ACG	15	+	5	CGA
gi|514486632|gb|KE346360.1|	3705120	3705137	AAGCGC	17	-	2	GCTTGC
gi|514486632|gb|KE346360.1|	3705449	3705463	AAAAGGG	14	+	2	AAGGGAA
gi|514486632|gb|KE346360.1|	3705464	3705481	A	17	+	17	A
gi|514486632|gb|KE346360.1|	3705705	3705724	A	19	+	19	A
gi|514486632|gb|KE346360.1|	3705930	3705949	ATC	19	+	6	CAT
gi|514486632|gb|KE346360.1|	3706007	3706021	ACGAGG	14	-	2	TCCTCG
gi|514486632|gb|KE346360.1|	3706208	3706225	ATC	17	+	5	TCA
gi|514486632|gb|KE346360.1|	3706246	3706270	ACGATG	24	-	4	ATCGTC
gi|514486632|gb|KE346360.1|	3706387	3706415	AAGGGC	28	-	4	CTTGCC
gi|514486632|gb|KE346360.1|	3706523	3706540	ACG	17	-	5	TCG
gi|514486632|gb|KE346360.1|	3707529	3707543	AATCAC	14	-	2	ATTGTG
gi|514486632|gb|KE346360.1|	3708041	3708056	ACC	15	-	5	GGT
gi|514486632|gb|KE346360.1|	3708134	3708162	AG	28	+	14	AG
gi|514486632|gb|KE346360.1|	3708329	3708343	AAAAT	14	+	2	AAAAT
gi|514486632|gb|KE346360.1|	3711064	3711079	AATGAG	15	-	2	ATTCTC
gi|514486632|gb|KE346360.1|	3711081	3711110	ATC	29	-	9	GAT
gi|514486632|gb|KE346360.1|	3711904	3711919	AAAAC	15	-	3	TTTGT
gi|514486632|gb|KE346360.1|	3711912	3711926	AAAACAC	14	-	2	GTTTTGT
gi|514486632|gb|KE346360.1|	3711919	3711939	AAAAC	20	-	4	GTTTT
gi|514486632|gb|KE346360.1|	3712089	3712109	AC	20	+	10	AC
gi|514486632|gb|KE346360.1|	3713487	3713501	ACCGGC	14	+	2	CCGGCA
gi|514486632|gb|KE346360.1|	3714907	3714921	AATGGC	14	-	2	CATTGC
gi|514486632|gb|KE346360.1|	3717027	3717042	AAGATG	15	-	2	TCATCT
gi|514486632|gb|KE346360.1|	3718636	3718651	AACAATC	15	-	2	TTGTTGA
gi|514486632|gb|KE346360.1|	3718735	3718757	ACGATG	22	-	3	CATCGT
gi|514486632|gb|KE346360.1|	3718752	3718767	ATC	15	+	5	TCA
gi|514486632|gb|KE346360.1|	3719275	3719289	CCG	14	-	4	GCG
gi|514486632|gb|KE346360.1|	3719921	3719935	A	14	-	14	T
gi|514486632|gb|KE346360.1|	3722587	3722604	ACGATG	17	-	2	TCATCG
gi|514486632|gb|KE346360.1|	3723066	3723081	ACG	15	+	5	CGA
gi|514486632|gb|KE346360.1|	3723079	3723102	ATC	23	-	7	GAT
gi|514486632|gb|KE346360.1|	3726584	3726603	CCG	19	+	6	GCC
gi|514486632|gb|KE346360.1|	3727226	3727245	AACAGC	19	-	3	GCTGTT
gi|514486632|gb|KE346360.1|	3728114	3728129	AAG	15	+	5	GAA
gi|514486632|gb|KE346360.1|	3728165	3728192	A	27	+	27	A
gi|514486632|gb|KE346360.1|	3728395	3728415	A	20	-	20	T
gi|514486632|gb|KE346360.1|	3728745	3728763	A	18	+	18	A
gi|514486632|gb|KE346360.1|	3728951	3728966	A	15	+	15	A
gi|514486632|gb|KE346360.1|	3728968	3728991	A	23	+	23	A
gi|514486632|gb|KE346360.1|	3731472	3731487	AGC	15	-	5	CTG
gi|514486632|gb|KE346360.1|	3731482	3731498	AACAGC	16	-	2	TGCTGT
gi|514486632|gb|KE346360.1|	3732016	3732031	ACCACCC	15	-	2	GGTGGTG
gi|514486632|gb|KE346360.1|	3734106	3734129	AAAAC	23	+	4	AAACA
gi|514486632|gb|KE346360.1|	3734290	3734305	AC	15	-	7	TG
gi|514486632|gb|KE346360.1|	3734686	3734700	AGGGG	14	+	2	GGGGA
gi|514486632|gb|KE346360.1|	3735124	3735143	ACAG	19	+	4	CAGA
gi|514486632|gb|KE346360.1|	3735346	3735419	AG	73	+	36	AG
gi|514486632|gb|KE346360.1|	3735438	3735477	AG	39	+	19	AG
gi|514486632|gb|KE346360.1|	3735706	3735720	AATGAG	14	+	2	AATGAG
gi|514486632|gb|KE346360.1|	3736363	3736384	AGC	21	+	7	CAG
gi|514486632|gb|KE346360.1|	3736903	3736919	CCG	16	+	5	CCG
gi|514486632|gb|KE346360.1|	3736917	3736932	AGC	15	-	5	GCT
gi|514486632|gb|KE346360.1|	3738165	3738180	AAAAAC	15	+	2	AACAAA
gi|514486632|gb|KE346360.1|	3740610	3740624	AACACG	14	+	2	CACGAA
gi|514486632|gb|KE346360.1|	3740966	3740992	ACTC	26	-	6	AGTG
gi|514486632|gb|KE346360.1|	3741253	3741267	A	14	+	14	A
gi|514486632|gb|KE346360.1|	3741612	3741628	AAC	16	-	5	TGT
gi|514486632|gb|KE346360.1|	3741743	3741838	AC	95	+	47	CA
gi|514486632|gb|KE346360.1|	3741839	3741874	AC	35	+	17	CA
gi|514486632|gb|KE346360.1|	3743259	3743277	AAC	18	-	6	TTG
gi|514486632|gb|KE346360.1|	3743611	3743628	ACGACT	17	-	2	GTCGTA
gi|514486632|gb|KE346360.1|	3744241	3744259	AGG	18	-	6	CTC
gi|514486632|gb|KE346360.1|	3744505	3744523	ACTC	18	-	4	GAGT
gi|514486632|gb|KE346360.1|	3744590	3744607	AACAAT	17	-	2	TTGTTA
gi|514486632|gb|KE346360.1|	3749163	3749178	AC	15	+	7	CA
gi|514486632|gb|KE346360.1|	3750484	3750498	AAAAAG	14	+	2	AAAGAA
gi|514486632|gb|KE346360.1|	3750552	3750569	A	17	+	17	A
gi|514486632|gb|KE346360.1|	3750607	3750621	A	14	-	14	T
gi|514486632|gb|KE346360.1|	3751007	3751022	A	15	+	15	A
gi|514486632|gb|KE346360.1|	3751055	3751077	AC	22	+	11	CA
gi|514486632|gb|KE346360.1|	3751247	3751264	AAT	17	+	5	AAT
gi|514486632|gb|KE346360.1|	3751398	3751413	ACGATG	15	+	2	CGATGA
gi|514486632|gb|KE346360.1|	3752092	3752115	AGCATC	23	-	3	TGCTGA
gi|514486632|gb|KE346360.1|	3753023	3753038	ACG	15	-	5	TCG
gi|514486632|gb|KE346360.1|	3753602	3753617	CCCCCCG	15	-	2	GCGGGGG
gi|514486632|gb|KE346360.1|	3753759	3753774	A	15	+	15	A
gi|514486632|gb|KE346360.1|	3754001	3754022	AAT	21	+	7	ATA
gi|514486632|gb|KE346360.1|	3754821	3754835	A	14	-	14	T
gi|514486632|gb|KE346360.1|	3754848	3754863	AAAGAAC	15	-	2	TGTTCTT
gi|514486632|gb|KE346360.1|	3755077	3755100	AAAAT	23	+	4	AAAAT
gi|514486632|gb|KE346360.1|	3755097	3755112	AAAAAT	15	+	2	AAATAA
gi|514486632|gb|KE346360.1|	3755105	3755134	AAAAAAT	29	+	4	ATAAAAA
gi|514486632|gb|KE346360.1|	3755150	3755168	AAAAAAG	18	-	2	TTTTTTC
gi|514486632|gb|KE346360.1|	3755205	3755223	A	18	+	18	A
gi|514486632|gb|KE346360.1|	3760448	3760464	ACTC	16	+	4	CTCA
gi|514486632|gb|KE346360.1|	3760817	3760831	AAAACAC	14	+	2	CAAAACA
gi|514486632|gb|KE346360.1|	3762256	3762273	CCG	17	-	5	CGG
gi|514486632|gb|KE346360.1|	3763216	3763230	AATATCC	14	+	2	CAATATC
gi|514486632|gb|KE346360.1|	3763418	3763432	AAGCAC	14	-	2	GTGCTT
gi|514486632|gb|KE346360.1|	3763909	3763923	AATGAC	14	+	2	TGACAA
gi|514486632|gb|KE346360.1|	3765744	3765758	AGCTGC	14	+	2	CTGCAG
gi|514486632|gb|KE346360.1|	3769731	3769768	AC	37	+	18	CA
gi|514486632|gb|KE346360.1|	3769775	3769792	AAACAAC	17	+	2	AAACAAC
gi|514486632|gb|KE346360.1|	3771186	3771209	AAAC	23	+	5	AAAC
gi|514486632|gb|KE346360.1|	3771982	3771997	AATCC	15	+	3	ATCCA
gi|514486632|gb|KE346360.1|	3772082	3772101	AG	19	-	9	TC
gi|514486632|gb|KE346360.1|	3772180	3772232	A	52	-	52	T
gi|514486632|gb|KE346360.1|	3772448	3772462	AAGAGTG	14	+	2	AGAGTGA
gi|514486632|gb|KE346360.1|	3772467	3772481	AAGAGTG	14	+	2	AGAGTGA
gi|514486632|gb|KE346360.1|	3772548	3772573	AGC	25	+	8	CAG
gi|514486632|gb|KE346360.1|	3772856	3772878	AG	22	-	11	CT
gi|514486632|gb|KE346360.1|	3772879	3772895	AG	16	-	8	TC
gi|514486632|gb|KE346360.1|	3773179	3773194	AATGGC	15	+	2	TGGCAA
gi|514486632|gb|KE346360.1|	3773204	3773218	AGC	14	+	4	AGC
gi|514486632|gb|KE346360.1|	3773366	3773381	AACTC	15	+	3	ACTCA
gi|514486632|gb|KE346360.1|	3774433	3774449	ACGACT	16	-	2	GTAGTC
gi|514486632|gb|KE346360.1|	3774600	3774614	ACAGT	14	+	2	TACAG
gi|514486632|gb|KE346360.1|	3774710	3774725	AATAGG	15	-	2	TTCCTA
gi|514486632|gb|KE346360.1|	3774765	3774783	AATG	18	-	4	TTCA
gi|514486632|gb|KE346360.1|	3774856	3774879	ACTGGC	23	-	3	TGCCAG
gi|514486632|gb|KE346360.1|	3775056	3775072	ATCCGC	16	+	2	CATCCG
gi|514486632|gb|KE346360.1|	3775081	3775097	AGATGC	16	-	2	ATCTGC
gi|514486632|gb|KE346360.1|	3775512	3775531	AGC	19	-	6	CTG
gi|514486632|gb|KE346360.1|	3775934	3775970	AGC	36	+	12	GCA
gi|514486632|gb|KE346360.1|	3777440	3777511	AC	71	-	35	GT
gi|514486632|gb|KE346360.1|	3778125	3778139	AAC	14	-	4	TGT
gi|514486632|gb|KE346360.1|	3778148	3778177	AAC	29	-	9	GTT
gi|514486632|gb|KE346360.1|	3778434	3778448	AAAAAAC	14	-	2	TTTGTTT
gi|514486632|gb|KE346360.1|	3778572	3778586	AAGAGG	14	-	2	TCCTCT
gi|514486632|gb|KE346360.1|	3778596	3778613	ACG	17	-	5	TCG
gi|514486632|gb|KE346360.1|	3780089	3780103	AAAAAC	14	-	2	TTGTTT
gi|514486632|gb|KE346360.1|	3780863	3780882	AGCCTG	19	-	3	CAGGCT
gi|514486632|gb|KE346360.1|	3780877	3780898	AGCCCG	21	-	3	GGCTCG
gi|514486632|gb|KE346360.1|	3781540	3781554	AGG	14	+	4	GGA
gi|514486632|gb|KE346360.1|	3782006	3782023	ACCAGC	17	+	2	GCACCA
gi|514486632|gb|KE346360.1|	3782243	3782257	ACTCTG	14	+	2	ACTCTG
gi|514486632|gb|KE346360.1|	3782271	3782287	AAC	16	-	5	TTG
gi|514486632|gb|KE346360.1|	3782789	3782805	AACC	16	-	4	TTGG
gi|514486632|gb|KE346360.1|	3783473	3783493	AG	20	+	10	AG
gi|514486632|gb|KE346360.1|	3783742	3783769	AACTCG	27	-	4	TCGAGT
gi|514486632|gb|KE346360.1|	3784145	3784160	ACG	15	+	5	CGA
gi|514486632|gb|KE346360.1|	3785540	3785562	AC	22	-	11	TG
gi|514486632|gb|KE346360.1|	3786997	3787027	AAGG	30	+	7	GAAG
gi|514486632|gb|KE346360.1|	3787360	3787374	A	14	+	14	A
gi|514486632|gb|KE346360.1|	3787391	3787405	AAGATTG	14	-	2	AATCTTC
gi|514486632|gb|KE346360.1|	3787488	3787503	A	15	+	15	A
gi|514486632|gb|KE346360.1|	3788012	3788145	AG	133	-	66	CT
gi|514486632|gb|KE346360.1|	3791397	3791453	AAAAAC	56	+	9	AACAAA
gi|514486632|gb|KE346360.1|	3791452	3791468	AAAC	16	+	4	AAAC
gi|514486632|gb|KE346360.1|	3792909	3792923	AACGCC	14	+	2	CCAACG
gi|514486632|gb|KE346360.1|	3793152	3793166	AAAAC	14	-	2	GTTTT
gi|514486632|gb|KE346360.1|	3794185	3794200	AGC	15	+	5	AGC
gi|514486632|gb|KE346360.1|	3794260	3794274	A	14	+	14	A
gi|514486632|gb|KE346360.1|	3794270	3794284	AAAAC	14	+	2	AAAAC
gi|514486271|gb|KE346361.1|	3217	3231	ACG	14	+	4	CGA
gi|514486271|gb|KE346361.1|	4968	5306	AAC	338	+	112	AAC
gi|514486271|gb|KE346361.1|	7745	7828	AC	83	+	41	AC
gi|514486271|gb|KE346361.1|	9212	9226	AAAAAAG	14	-	2	TTTTTTC
gi|514486271|gb|KE346361.1|	9989	10008	AAAAG	19	-	3	TTTTC
gi|514486271|gb|KE346361.1|	10073	10090	AATGCTC	17	-	2	TTGAGCA
gi|514486271|gb|KE346361.1|	10134	10160	AGG	26	-	8	CTC
gi|514486271|gb|KE346361.1|	10280	10321	AG	41	-	20	CT
gi|514486271|gb|KE346361.1|	10408	10423	AGCCTG	15	+	2	CCTGAG
gi|514486271|gb|KE346361.1|	11501	11518	AAAGAAC	17	-	2	GTTCTTT
gi|514486271|gb|KE346361.1|	13545	13592	AC	47	+	23	AC
gi|514486271|gb|KE346361.1|	13593	13662	AC	69	+	34	AC
gi|514486271|gb|KE346361.1|	16004	16030	A	26	-	26	T
gi|514486271|gb|KE346361.1|	16072	16087	AACGC	15	+	3	CAACG
gi|514486271|gb|KE346361.1|	16300	16314	ACCAGC	14	+	2	CACCAG
gi|514486271|gb|KE346361.1|	16456	16472	ACGAGG	16	-	2	CCTCGT
gi|514486271|gb|KE346361.1|	17781	17795	ATCGCC	14	+	2	CGCCAT
gi|514486271|gb|KE346361.1|	17801	17856	AGG	55	-	18	CCT
gi|514486271|gb|KE346361.1|	19939	19954	AAAC	15	-	3	TTTG
gi|514486271|gb|KE346361.1|	19951	19970	A	19	-	19	T
gi|514486271|gb|KE346361.1|	20024	20040	AAAAC	16	-	3	TTGTT
gi|514486271|gb|KE346361.1|	21083	21233	AAAC	150	-	37	TTTG
gi|514486271|gb|KE346361.1|	21248	21319	AAAC	71	-	17	TTGT
gi|514486271|gb|KE346361.1|	21703	21725	AAAC	22	-	5	GTTT
gi|514486271|gb|KE346361.1|	21774	21790	ACAG	16	-	4	CTGT
gi|514486271|gb|KE346361.1|	22101	22128	AAGTC	27	-	5	CTTGA
gi|514486271|gb|KE346361.1|	22878	22983	AAC	105	-	35	GTT
gi|514486271|gb|KE346361.1|	24625	24646	A	21	+	21	A
gi|514486271|gb|KE346361.1|	24762	24782	A	20	+	20	A
gi|514486271|gb|KE346361.1|	25071	25085	AAACGTC	14	-	2	TTTGACG
gi|514486271|gb|KE346361.1|	26238	26257	AG	19	-	9	TC
gi|514486271|gb|KE346361.1|	26267	26286	AG	19	-	9	TC
gi|514486271|gb|KE346361.1|	26508	26601	AG	93	-	46	TC
gi|514486271|gb|KE346361.1|	26728	26745	AACTCC	17	+	2	ACTCCA
gi|514486271|gb|KE346361.1|	26885	26899	AACACAC	14	+	2	ACACACA
gi|514486271|gb|KE346361.1|	28584	28604	AAAC	20	+	5	AAAC
gi|514486271|gb|KE346361.1|	29006	29027	ATC	21	-	7	TGA
gi|514486271|gb|KE346361.1|	29186	29206	AGCCAT	20	-	3	CTATGG
gi|514486271|gb|KE346361.1|	29201	29218	ACAGCC	17	-	2	TGGCTG
gi|514486271|gb|KE346361.1|	29422	29442	AAC	20	+	6	AAC
gi|514486271|gb|KE346361.1|	29560	29574	ACTC	14	-	3	AGTG
gi|514486271|gb|KE346361.1|	29650	29668	AAGTAG	18	+	3	AGAAGT
gi|514486271|gb|KE346361.1|	29729	29754	AG	25	+	12	GA
gi|514486271|gb|KE346361.1|	29900	29919	AAG	19	-	6	CTT
gi|514486271|gb|KE346361.1|	29920	29936	AAG	16	-	5	TCT
gi|514486271|gb|KE346361.1|	30600	30623	ACAGAG	23	+	3	AGAGAC
gi|514486271|gb|KE346361.1|	33570	33627	AC	57	-	28	TG
gi|514486271|gb|KE346361.1|	34326	34341	ATC	15	-	5	TGA
gi|514486271|gb|KE346361.1|	35004	35036	AAAC	32	-	8	TGTT
gi|514486271|gb|KE346361.1|	38079	38097	AGGATC	18	-	3	GATCCT
gi|514486271|gb|KE346361.1|	38099	38115	AGGATC	16	-	2	TCCTGA
gi|514486271|gb|KE346361.1|	38117	38133	AGGATC	16	-	2	TCCTGA
gi|514486271|gb|KE346361.1|	38141	38158	ACCAGG	17	-	2	TCCTGG
gi|514486271|gb|KE346361.1|	38581	38598	AAAAAAT	17	+	2	AAATAAA
gi|514486271|gb|KE346361.1|	38622	38638	A	16	+	16	A
gi|514486271|gb|KE346361.1|	38656	38674	AG	18	-	9	TC
gi|514486271|gb|KE346361.1|	38987	39002	AATAG	15	+	3	GAATA
gi|514486271|gb|KE346361.1|	39587	39608	ATC	21	-	7	ATG
gi|514486271|gb|KE346361.1|	39624	39640	ATC	16	+	5	ATC
gi|514486271|gb|KE346361.1|	39973	39987	AACATTG	14	-	2	CAATGTT
gi|514486271|gb|KE346361.1|	41111	41127	AC	16	-	8	TG
gi|514486271|gb|KE346361.1|	41148	41162	AACTCTC	14	+	2	CAACTCT
gi|514486271|gb|KE346361.1|	42132	42148	AAAAAG	16	-	2	TTTTCT
gi|514486271|gb|KE346361.1|	42182	42196	AAAAAAG	14	-	2	TTTTCTT
gi|514486271|gb|KE346361.1|	42384	42405	AG	21	+	10	GA
gi|514486271|gb|KE346361.1|	42485	42503	AAGAGTG	18	+	2	GTGAAGA
gi|514486271|gb|KE346361.1|	42497	42513	ACTC	16	-	4	GAGT
gi|514486271|gb|KE346361.1|	42591	42614	AG	23	-	11	CT
gi|514486271|gb|KE346361.1|	42619	42637	AG	18	-	9	CT
gi|514486271|gb|KE346361.1|	42634	42649	AAGCAG	15	-	2	TCTGCT
gi|514486271|gb|KE346361.1|	43963	43978	AAAAC	15	-	3	TTTTG
gi|514486271|gb|KE346361.1|	44021	44037	A	16	-	16	T
gi|514486271|gb|KE346361.1|	44618	44639	AAG	21	-	7	TCT
gi|514486271|gb|KE346361.1|	44778	44800	AGCCTC	22	+	3	CAGCCT
gi|514486271|gb|KE346361.1|	48333	48348	AGC	15	-	5	GCT
gi|514486271|gb|KE346361.1|	48479	48495	AGC	16	+	5	GCA
gi|514486271|gb|KE346361.1|	48874	48889	AGGG	15	+	3	GAGG
gi|514486271|gb|KE346361.1|	48898	48921	A	23	+	23	A
gi|514486271|gb|KE346361.1|	49475	49491	A	16	-	16	T
gi|514486271|gb|KE346361.1|	49859	49873	A	14	-	14	T
gi|514486271|gb|KE346361.1|	50213	50229	A	16	+	16	A
gi|514486271|gb|KE346361.1|	50404	50419	A	15	+	15	A
gi|514486271|gb|KE346361.1|	50626	50641	A	15	+	15	A
gi|514486271|gb|KE346361.1|	51041	51060	AG	19	+	9	GA
gi|514486271|gb|KE346361.1|	51445	51467	A	22	+	22	A
gi|514486271|gb|KE346361.1|	51928	51944	AAAAAT	16	+	2	AATAAA
gi|514486271|gb|KE346361.1|	52603	52621	A	18	-	18	T
gi|514486271|gb|KE346361.1|	52815	52836	A	21	+	21	A
gi|514486271|gb|KE346361.1|	53950	53965	AAC	15	-	5	TGT
gi|514486271|gb|KE346361.1|	53986	54000	AGC	14	-	4	TGC
gi|514486271|gb|KE346361.1|	58423	58437	AAACAAC	14	+	2	ACAACAA
gi|514486271|gb|KE346361.1|	58448	58472	AAC	24	+	8	CAA
gi|514486271|gb|KE346361.1|	59006	59020	AAGGCAC	14	-	2	GTGCCTT
gi|514486271|gb|KE346361.1|	59282	59305	A	23	-	23	T
gi|514486271|gb|KE346361.1|	59510	59538	AGC	28	-	9	GCT
gi|514486271|gb|KE346361.1|	60413	60428	ACGGAG	15	+	2	GACGGA
gi|514486271|gb|KE346361.1|	65159	65175	AGATCGC	16	-	2	ATCTGCG
gi|514486271|gb|KE346361.1|	67193	67207	AAC	14	+	4	ACA
gi|514486271|gb|KE346361.1|	67391	67411	A	20	+	20	A
gi|514486271|gb|KE346361.1|	69561	69577	AAGAGG	16	+	2	GAGGAA
gi|514486271|gb|KE346361.1|	70129	70144	A	15	+	15	A
gi|514486271|gb|KE346361.1|	70208	70234	ACG	26	+	8	GAC
gi|514486271|gb|KE346361.1|	70336	70353	ACGCTG	17	+	2	TGACGC
gi|514486271|gb|KE346361.1|	70668	70692	A	24	-	24	T
gi|514486271|gb|KE346361.1|	71077	71092	A	15	+	15	A
gi|514486271|gb|KE346361.1|	71088	71102	AAAAG	14	+	2	AAAAG
gi|514486271|gb|KE346361.1|	71377	71401	AAGGG	24	+	4	AGGGA
gi|514486271|gb|KE346361.1|	71609	71626	A	17	+	17	A
gi|514486271|gb|KE346361.1|	71695	71728	AAACG	33	+	6	GAAAC
gi|514486271|gb|KE346361.1|	72197	72213	AGC	16	+	5	CAG
gi|514486271|gb|KE346361.1|	72436	72450	AGCGGC	14	-	2	CCGCTG
gi|514486271|gb|KE346361.1|	72660	72686	AGC	26	+	8	AGC
gi|514486271|gb|KE346361.1|	72774	72791	ATC	17	-	5	GAT
gi|514486271|gb|KE346361.1|	73304	73322	ACAGGC	18	+	3	GCACAG
gi|514486271|gb|KE346361.1|	73993	74011	AAAC	18	-	4	TTTG
gi|514486271|gb|KE346361.1|	75223	75237	AAAAAC	14	-	2	TTTTGT
gi|514486271|gb|KE346361.1|	75251	75278	AC	27	-	13	TG
gi|514486271|gb|KE346361.1|	75277	75292	A	15	-	15	T
gi|514486271|gb|KE346361.1|	75672	75687	AGGGCG	15	+	2	GGCGAG
gi|514486271|gb|KE346361.1|	76071	76092	AAACAAC	21	+	3	AAACAAC
gi|514486271|gb|KE346361.1|	77579	77596	AAAC	17	+	4	AACA
gi|514486271|gb|KE346361.1|	77591	77611	AAC	20	+	6	AAC
gi|514486271|gb|KE346361.1|	78318	78335	AAAAAT	17	+	2	AAAAAT
gi|514486271|gb|KE346361.1|	78328	78374	AAAAAAT	46	+	6	ATAAAAA
gi|514486271|gb|KE346361.1|	78537	78559	A	22	+	22	A
gi|514486271|gb|KE346361.1|	79162	79185	A	23	+	23	A
gi|514486271|gb|KE346361.1|	79342	79361	ACTC	19	+	4	CTCA
gi|514486271|gb|KE346361.1|	79564	79580	ACTGCAG	16	-	2	TGCAGTC
gi|514486271|gb|KE346361.1|	80758	80781	AGC	23	+	7	CAG
gi|514486271|gb|KE346361.1|	81478	81499	AGAGGC	21	-	3	GCCTCT
gi|514486271|gb|KE346361.1|	81500	81529	AGAGGC	29	-	4	CTGCCT
gi|514486271|gb|KE346361.1|	83812	83826	ATC	14	-	4	TGA
gi|514486271|gb|KE346361.1|	83824	83839	AAC	15	-	5	TGT
gi|514486271|gb|KE346361.1|	85796	85810	AGGCGC	14	-	2	GCGCCT
gi|514486271|gb|KE346361.1|	89943	89957	AGC	14	+	4	GCA
gi|514486271|gb|KE346361.1|	90120	90136	AGGCCG	16	-	2	GCCTCG
gi|514486271|gb|KE346361.1|	91385	91425	ATC	40	+	13	CAT
gi|514486271|gb|KE346361.1|	91608	91626	AAC	18	+	6	CAA
gi|514486271|gb|KE346361.1|	91683	91698	AAAAC	15	+	3	AAAAC
gi|514486271|gb|KE346361.1|	91888	91907	AAAC	19	-	4	GTTT
gi|514486271|gb|KE346361.1|	92195	92211	AC	16	+	8	CA
gi|514486271|gb|KE346361.1|	92360	92379	ACCCT	19	+	3	CCCTA
gi|514486271|gb|KE346361.1|	92440	92457	AAAAAAT	17	-	2	TTTTTTA
gi|514486271|gb|KE346361.1|	92454	92471	AAAAAAT	17	-	2	TTTATTT
gi|514486271|gb|KE346361.1|	92687	92704	A	17	+	17	A
gi|514486271|gb|KE346361.1|	92854	92879	A	25	+	25	A
gi|514486271|gb|KE346361.1|	93083	93107	A	24	+	24	A
gi|514486271|gb|KE346361.1|	94474	94488	ATC	14	+	4	TCA
gi|514486271|gb|KE346361.1|	94486	94503	ACG	17	-	5	TCG
gi|514486271|gb|KE346361.1|	95896	95921	ACGGCG	25	-	4	CGTCGC
gi|514486271|gb|KE346361.1|	96022	96037	ACAGATC	15	-	2	GATCTGT
gi|514486271|gb|KE346361.1|	96033	96047	AC	14	-	7	TG
gi|514486271|gb|KE346361.1|	96089	96103	AAGCTC	14	-	2	GCTTGA
gi|514486271|gb|KE346361.1|	96137	96152	AGC	15	-	5	GCT
gi|514486271|gb|KE346361.1|	97179	97210	A	31	-	31	T
gi|514486271|gb|KE346361.1|	97517	97536	AGC	19	+	6	AGC
gi|514486271|gb|KE346361.1|	98260	98274	AAAAAG	14	-	2	TTTCTT
gi|514486271|gb|KE346361.1|	98664	98680	A	16	-	16	T
gi|514486271|gb|KE346361.1|	98681	98695	A	14	-	14	T
gi|514486271|gb|KE346361.1|	98692	98707	AAAC	15	-	3	TTTG
gi|514486271|gb|KE346361.1|	101770	101798	AGC	28	-	9	CTG
gi|514486271|gb|KE346361.1|	101805	101820	ACTGCT	15	+	2	GCTACT
gi|514486271|gb|KE346361.1|	102771	102785	AGAGGC	14	-	2	CTCTGC
gi|514486271|gb|KE346361.1|	103202	103216	AAGGC	14	+	2	AAGGC
gi|514486271|gb|KE346361.1|	103338	103352	AACTG	14	-	2	TCAGT
gi|514486271|gb|KE346361.1|	103376	103390	AAAACG	14	-	2	TTTTCG
gi|514486271|gb|KE346361.1|	103406	103429	A	23	-	23	T
gi|514486271|gb|KE346361.1|	103465	103485	A	20	-	20	T
gi|514486271|gb|KE346361.1|	103509	103526	AAG	17	-	5	TTC
gi|514486271|gb|KE346361.1|	104244	104258	AGCCTC	14	-	2	GAGGCT
gi|514486271|gb|KE346361.1|	104353	104367	AAAAGC	14	+	2	AAGCAA
gi|514486271|gb|KE346361.1|	104443	104460	ATCC	17	-	4	TGGA
gi|514486271|gb|KE346361.1|	104660	104677	AG	17	-	8	CT
gi|514486271|gb|KE346361.1|	105095	105145	AG	50	-	25	CT
gi|514486271|gb|KE346361.1|	105334	105349	AAGGG	15	-	3	CCCTT
gi|514486271|gb|KE346361.1|	105411	105437	AAC	26	-	8	TTG
gi|514486271|gb|KE346361.1|	105438	105456	AAAC	18	-	4	GTTT
gi|514486271|gb|KE346361.1|	105536	105553	ACAGC	17	+	3	AGCAC
gi|514486271|gb|KE346361.1|	105590	105605	AACACAC	15	+	2	ACACAAC
gi|514486271|gb|KE346361.1|	105829	105843	ACCAGC	14	-	2	GGTGCT
gi|514486271|gb|KE346361.1|	106047	106065	AGCGGC	18	+	3	GGCAGC
gi|514486271|gb|KE346361.1|	106171	106194	AGC	23	+	7	CAG
gi|514486271|gb|KE346361.1|	106189	106206	AACAGC	17	+	2	CAGCAA
gi|514486271|gb|KE346361.1|	106217	106242	AGC	25	+	8	CAG
gi|514486271|gb|KE346361.1|	106471	106485	AGC	14	+	4	GCA
gi|514486271|gb|KE346361.1|	106524	106548	AGCATC	24	+	4	GCATCA
gi|514486271|gb|KE346361.1|	106721	106735	CCG	14	-	4	CGG
gi|514486271|gb|KE346361.1|	107011	107034	ACC	23	-	7	GGT
gi|514486271|gb|KE346361.1|	108546	108562	AAAAAAC	16	-	2	TTTGTTT
gi|514486271|gb|KE346361.1|	108961	108996	AAAC	35	-	8	TGTT
gi|514486271|gb|KE346361.1|	109743	109758	AAAC	15	+	3	ACAA
gi|514486271|gb|KE346361.1|	110497	110535	AAC	38	+	12	ACA
gi|514486271|gb|KE346361.1|	110757	110771	AATGCC	14	+	2	GCCAAT
gi|514486271|gb|KE346361.1|	111985	112001	AAAAAC	16	+	2	AAAAAC
gi|514486271|gb|KE346361.1|	113121	113148	A	27	+	27	A
gi|514486271|gb|KE346361.1|	113186	113202	A	16	-	16	T
gi|514486271|gb|KE346361.1|	115195	115210	AAAC	15	-	3	TTTG
gi|514486271|gb|KE346361.1|	115704	115718	AAAC	14	-	3	TTTG
gi|514486271|gb|KE346361.1|	116277	116307	AG	30	+	15	GA
gi|514486271|gb|KE346361.1|	121656	121671	A	15	-	15	T
gi|514486271|gb|KE346361.1|	122039	122053	AAACGC	14	-	2	GCGTTT
gi|514486271|gb|KE346361.1|	124558	124578	AAGAGTG	20	-	2	TCTTCAC
gi|514486271|gb|KE346361.1|	124891	124910	A	19	-	19	T
gi|514486271|gb|KE346361.1|	125547	125561	A	14	-	14	T
gi|514486271|gb|KE346361.1|	126101	126115	ACAGCGT	14	+	2	CAGCGTA
gi|514486271|gb|KE346361.1|	126268	126282	AACACTC	14	-	2	TGTTGAG
gi|514486271|gb|KE346361.1|	126904	126918	AATATCC	14	-	2	GATATTG
gi|514486271|gb|KE346361.1|	127308	127323	A	15	+	15	A
gi|514486271|gb|KE346361.1|	128741	128755	ACGAGCG	14	-	2	TCGTCGC
gi|514486271|gb|KE346361.1|	130064	130080	ACCTGC	16	-	2	GCAGGT
gi|514486271|gb|KE346361.1|	130117	130131	AGCCGC	14	+	2	CGCAGC
gi|514486271|gb|KE346361.1|	130485	130502	AGC	17	-	5	TGC
gi|514486271|gb|KE346361.1|	130533	130559	AGC	26	-	8	TGC
gi|514486271|gb|KE346361.1|	130554	130571	AACAGC	17	-	2	TGCTGT
gi|514486271|gb|KE346361.1|	130569	130585	AACAGC	16	-	2	TGCTGT
gi|514486271|gb|KE346361.1|	131051	131065	AGCAGG	14	+	2	AGCAGG
gi|514486271|gb|KE346361.1|	131563	131578	AGGCGC	15	+	2	CAGGCG
gi|514486271|gb|KE346361.1|	131618	131645	AGC	27	-	9	CTG
gi|514486271|gb|KE346361.1|	131805	131819	AACAGC	14	-	2	TGTTGC
gi|514486271|gb|KE346361.1|	131829	131844	AACAGC	15	-	2	TGCTGT
gi|514486271|gb|KE346361.1|	132086	132100	AAT	14	-	4	TTA
gi|514486271|gb|KE346361.1|	132095	132118	AAAAAAT	23	-	3	TTATTTT
gi|514486271|gb|KE346361.1|	134812	134827	AAT	15	-	5	ATT
gi|514486271|gb|KE346361.1|	134872	134897	A	25	-	25	T
gi|514486271|gb|KE346361.1|	134971	134991	AG	20	-	10	TC
gi|514486271|gb|KE346361.1|	135239	135255	ATCATCC	16	+	2	ATCATCC
gi|514486271|gb|KE346361.1|	135255	135276	ATC	21	+	7	TCA
gi|514486271|gb|KE346361.1|	135722	135746	A	24	+	24	A
gi|514486271|gb|KE346361.1|	135878	135892	ACCAGCC	14	-	2	GTGGCTG
gi|514486271|gb|KE346361.1|	135962	135977	ACC	15	+	5	CAC
gi|514486271|gb|KE346361.1|	136650	136700	AG	50	-	25	CT
gi|514486271|gb|KE346361.1|	137291	137305	AATGTGG	14	-	2	TTCCACA
gi|514486271|gb|KE346361.1|	139430	139447	AAAAC	17	-	3	TTTTG
gi|514486271|gb|KE346361.1|	139532	139546	AGCGCG	14	-	2	TCGCGC
gi|514486271|gb|KE346361.1|	140591	140616	AGC	25	-	8	TGC
gi|514486271|gb|KE346361.1|	142225	142246	A	21	-	21	T
gi|514486271|gb|KE346361.1|	142477	142491	AAAC	14	-	3	TTTG
gi|514486271|gb|KE346361.1|	142623	142648	A	25	+	25	A
gi|514486271|gb|KE346361.1|	143025	143062	A	37	-	37	T
gi|514486271|gb|KE346361.1|	143307	143322	AAATAAT	15	-	2	TTATTAT
gi|514486271|gb|KE346361.1|	143326	143343	AAATAAT	17	-	2	ATTATTT
gi|514486271|gb|KE346361.1|	143360	143378	ACTGATG	18	-	2	ATCAGTC
gi|514486271|gb|KE346361.1|	143406	143421	AATG	15	+	3	TGAA
gi|514486271|gb|KE346361.1|	143427	143450	AG	23	+	11	GA
gi|514486271|gb|KE346361.1|	143853	143867	AAGGGG	14	-	2	CCCTTC
gi|514486271|gb|KE346361.1|	143969	143989	A	20	-	20	T
gi|514486271|gb|KE346361.1|	143992	144006	AAAAAC	14	-	2	TTTTTG
gi|514486271|gb|KE346361.1|	144111	144126	AC	15	-	7	GT
gi|514486271|gb|KE346361.1|	144270	144286	AG	16	-	8	CT
gi|514486271|gb|KE346361.1|	144594	144610	AAC	16	+	5	CAA
gi|514486271|gb|KE346361.1|	144605	144622	AACGAC	17	+	2	ACAACG
gi|514486271|gb|KE346361.1|	144686	144703	AGCGGC	17	-	2	GCTGCC
gi|514486271|gb|KE346361.1|	144698	144715	AGC	17	-	5	GCT
gi|514486271|gb|KE346361.1|	146551	146565	AGC	14	+	4	CAG
gi|514486271|gb|KE346361.1|	146958	146978	AC	20	-	10	GT
gi|514486271|gb|KE346361.1|	147195	147214	AAAAAC	19	+	3	ACAAAA
gi|514486271|gb|KE346361.1|	148875	148889	CCG	14	-	4	GCG
gi|514486271|gb|KE346361.1|	149731	149748	ACCCCT	17	-	2	GGGGTA
gi|514486271|gb|KE346361.1|	149774	149795	ATCATCC	21	-	3	TGGATGA
gi|514486271|gb|KE346361.1|	150069	150088	ACC	19	+	6	CAC
gi|514486271|gb|KE346361.1|	150086	150106	CCG	20	+	6	CCG
gi|514486271|gb|KE346361.1|	150163	150187	A	24	-	24	T
gi|514486271|gb|KE346361.1|	150321	150372	AAAAT	51	+	10	AATAA
gi|514486271|gb|KE346361.1|	150461	150478	ACC	17	+	5	ACC
gi|514486271|gb|KE346361.1|	150609	150623	AAAAATG	14	+	2	TGAAAAA
gi|514486271|gb|KE346361.1|	150628	150642	AAAAATG	14	+	2	TGAAAAA
gi|514486271|gb|KE346361.1|	151082	151096	CCG	14	-	4	CGG
gi|514486271|gb|KE346361.1|	151669	151688	ACG	19	+	6	GAC
gi|514486271|gb|KE346361.1|	152413	152436	ACGCCG	23	-	3	GCGTCG
gi|514486271|gb|KE346361.1|	153064	153092	ACG	28	-	9	GTC
gi|514486271|gb|KE346361.1|	153545	153573	AGC	28	+	9	GCA
gi|514486271|gb|KE346361.1|	154849	154867	ACC	18	-	6	GGT
gi|514486271|gb|KE346361.1|	156514	156529	A	15	-	15	T
gi|514486271|gb|KE346361.1|	156789	156803	ACTGCG	14	-	2	GTCGCA
gi|514486271|gb|KE346361.1|	156875	156896	A	21	-	21	T
gi|514486271|gb|KE346361.1|	158453	158467	AAAAAAC	14	-	2	TTTGTTT
gi|514486271|gb|KE346361.1|	160444	160460	AAC	16	-	5	TGT
gi|514486271|gb|KE346361.1|	160678	160693	AAC	15	-	5	TTG
gi|514486271|gb|KE346361.1|	160948	160971	A	23	+	23	A
gi|514486271|gb|KE346361.1|	161179	161193	A	14	+	14	A
gi|514486271|gb|KE346361.1|	161234	161268	AAAAT	34	+	6	AAAAT
gi|514486271|gb|KE346361.1|	161348	161364	AC	16	+	8	CA
gi|514486271|gb|KE346361.1|	161421	161436	A	15	+	15	A
gi|514486271|gb|KE346361.1|	161431	161447	AAAAAGG	16	+	2	AAAAAGG
gi|514486271|gb|KE346361.1|	162308	162323	ATC	15	-	5	ATG
gi|514486271|gb|KE346361.1|	164535	164555	ACG	20	-	6	TCG
gi|514486271|gb|KE346361.1|	166424	166438	AGCAGG	14	+	2	AGCAGG
gi|514486271|gb|KE346361.1|	166453	166470	ACAGAG	17	+	2	CAGAGA
gi|514486271|gb|KE346361.1|	166665	166693	AAG	28	+	9	AAG
gi|514486271|gb|KE346361.1|	166688	166707	AAGACG	19	+	3	GAAGAC
gi|514486271|gb|KE346361.1|	166713	166734	AAGAAGG	21	+	3	GAAGGAA
gi|514486271|gb|KE346361.1|	167349	167364	AACAGCG	15	+	2	CAGCGAA
gi|514486271|gb|KE346361.1|	169016	169034	ACCCCC	18	+	3	ACCCCC
gi|514486271|gb|KE346361.1|	169091	169136	A	45	+	45	A
gi|514486271|gb|KE346361.1|	169373	169397	A	24	+	24	A
gi|514486271|gb|KE346361.1|	169552	169573	A	21	+	21	A
gi|514486271|gb|KE346361.1|	169753	169770	A	17	+	17	A
gi|514486271|gb|KE346361.1|	169818	169891	A	73	+	73	A
gi|514486271|gb|KE346361.1|	169896	169910	AAG	14	-	4	TTC
gi|514486271|gb|KE346361.1|	170463	170489	AC	26	+	13	AC
gi|514486271|gb|KE346361.1|	170771	170791	ACACGC	20	-	3	GTGTGC
gi|514486271|gb|KE346361.1|	170911	170926	AATCAGC	15	-	2	ATTGCTG
gi|514486271|gb|KE346361.1|	171932	171946	AACACAG	14	+	2	AACACAG
gi|514486271|gb|KE346361.1|	172526	172544	A	18	-	18	T
gi|514486271|gb|KE346361.1|	172560	172591	A	31	-	31	T
gi|514486271|gb|KE346361.1|	173177	173191	AAG	14	+	4	GAA
gi|514486271|gb|KE346361.1|	173192	173207	AAG	15	+	5	GAA
gi|514486271|gb|KE346361.1|	173282	173296	AACTCAC	14	+	2	TCACAAC
gi|514486271|gb|KE346361.1|	176430	176444	AAAAAAC	14	+	2	CAAAAAA
gi|514486271|gb|KE346361.1|	176988	177013	AAC	25	+	8	ACA
gi|514486271|gb|KE346361.1|	177277	177293	AAAC	16	+	4	AAAC
gi|514486271|gb|KE346361.1|	177564	177581	AAC	17	+	5	AAC
gi|514486271|gb|KE346361.1|	177582	177781	AC	199	+	99	AC
gi|514486271|gb|KE346361.1|	177778	177794	AAAAC	16	+	3	ACAAA
gi|514486271|gb|KE346361.1|	177800	177814	AACCCAC	14	+	2	ACAACCC
gi|514486271|gb|KE346361.1|	178058	178072	AAAAAAC	14	+	2	ACAAAAA
gi|514486271|gb|KE346361.1|	178079	178096	AAAC	17	+	4	ACAA
gi|514486271|gb|KE346361.1|	178943	178966	A	23	+	23	A
gi|514486271|gb|KE346361.1|	180119	180139	AAAAC	20	+	4	CAAAA
gi|514486271|gb|KE346361.1|	181459	181499	A	40	-	40	T
gi|514486271|gb|KE346361.1|	181665	181679	AGG	14	+	4	GAG
gi|514486271|gb|KE346361.1|	183612	183627	ACCCTC	15	+	2	CACCCT
gi|514486271|gb|KE346361.1|	185099	185113	AAGGAC	14	-	2	TCCTTG
gi|514486271|gb|KE346361.1|	185240	185254	ACATGG	14	-	2	TCCATG
gi|514486271|gb|KE346361.1|	185567	185590	AGC	23	-	7	TGC
gi|514486271|gb|KE346361.1|	186541	186567	AGC	26	-	8	GCT
gi|514486271|gb|KE346361.1|	186665	186682	AGC	17	+	5	GCA
gi|514486271|gb|KE346361.1|	189864	189891	A	27	+	27	A
gi|514486271|gb|KE346361.1|	190027	190041	AGG	14	+	4	GAG
gi|514486271|gb|KE346361.1|	190293	190323	A	30	-	30	T
gi|514486271|gb|KE346361.1|	190500	190526	A	26	-	26	T
gi|514486271|gb|KE346361.1|	191888	191903	AAGGGG	15	+	2	GGGGAA
gi|514486271|gb|KE346361.1|	192874	192888	ACGAGTC	14	+	2	CACGAGT
gi|514486271|gb|KE346361.1|	193465	193479	AAC	14	+	4	AAC
gi|514486271|gb|KE346361.1|	194919	194935	ATC	16	-	5	GAT
gi|514486271|gb|KE346361.1|	195100	195114	ATC	14	+	4	ATC
gi|514486271|gb|KE346361.1|	195473	195487	ACGCCGC	14	-	2	GCGTGCG
gi|514486271|gb|KE346361.1|	195586	195608	A	22	-	22	T
gi|514486271|gb|KE346361.1|	196225	196256	A	31	-	31	T
gi|514486271|gb|KE346361.1|	196815	196830	A	15	-	15	T
gi|514486271|gb|KE346361.1|	197061	197075	AAAC	14	+	3	AACA
gi|514486271|gb|KE346361.1|	197209	197223	AACC	14	-	3	TGGT
gi|514486271|gb|KE346361.1|	200908	200924	AAATCAC	16	-	2	TGATTTG
gi|514486271|gb|KE346361.1|	200983	201001	AAAAAAC	18	-	2	TTTTGTT
gi|514486271|gb|KE346361.1|	201395	201409	AAAAGC	14	-	2	TTGCTT
gi|514486271|gb|KE346361.1|	201405	201431	A	26	-	26	T
gi|514486271|gb|KE346361.1|	201426	201440	AAAAAGC	14	-	2	TTTTTGC
gi|514486271|gb|KE346361.1|	201483	201505	ACCG	22	-	5	GTCG
gi|514486271|gb|KE346361.1|	201593	201616	A	23	-	23	T
gi|514486271|gb|KE346361.1|	201737	201752	AAAAC	15	+	3	ACAAA
gi|514486271|gb|KE346361.1|	201790	201804	AAAAT	14	+	2	AAAAT
gi|514486271|gb|KE346361.1|	202605	202628	A	23	+	23	A
gi|514486271|gb|KE346361.1|	203001	203015	AAAGAG	14	-	2	TTTCTC
gi|514486271|gb|KE346361.1|	203023	203038	AG	15	-	7	CT
gi|514486271|gb|KE346361.1|	203902	203916	AAGGCTG	14	-	2	CAGCCTT
gi|514486271|gb|KE346361.1|	204314	204328	ACGACGG	14	-	2	GTCGTCC
gi|514486271|gb|KE346361.1|	204414	204430	AAACAAC	16	-	2	TGTTGTT
gi|514486271|gb|KE346361.1|	204450	204477	A	27	-	27	T
gi|514486271|gb|KE346361.1|	204766	204783	A	17	-	17	T
gi|514486271|gb|KE346361.1|	204835	204849	AAAAG	14	-	2	TTTTC
gi|514486271|gb|KE346361.1|	205456	205480	A	24	-	24	T
gi|514486271|gb|KE346361.1|	205781	205798	AAAAAAC	17	-	2	TTTGTTT
gi|514486271|gb|KE346361.1|	205920	205934	AAAAATG	14	-	2	CATTTTT
gi|514486271|gb|KE346361.1|	206261	206280	A	19	+	19	A
gi|514486271|gb|KE346361.1|	207255	207276	A	21	-	21	T
gi|514486271|gb|KE346361.1|	207279	207293	AAAAC	14	-	2	TTGTT
gi|514486271|gb|KE346361.1|	207325	207340	AAGC	15	-	3	TTGC
gi|514486271|gb|KE346361.1|	207483	207507	A	24	-	24	T
gi|514486271|gb|KE346361.1|	207647	207664	CCG	17	+	5	CCG
gi|514486271|gb|KE346361.1|	207736	207757	AGC	21	-	7	GCT
gi|514486271|gb|KE346361.1|	207901	207929	ACTGGC	28	-	4	GCCAGT
gi|514486271|gb|KE346361.1|	208751	208772	AGC	21	-	7	CTG
gi|514486271|gb|KE346361.1|	208773	208789	AGC	16	-	5	TGC
gi|514486271|gb|KE346361.1|	208787	208801	ACT	14	+	4	CTA
gi|514486271|gb|KE346361.1|	209427	209441	AGC	14	+	4	CAG
gi|514486271|gb|KE346361.1|	210062	210076	ACGCGG	14	-	2	TCCGCG
gi|514486271|gb|KE346361.1|	210097	210111	AAAGCGT	14	+	2	AGCGTAA
gi|514486271|gb|KE346361.1|	213592	213677	AC	85	+	42	AC
gi|514486271|gb|KE346361.1|	213973	213987	ACACGC	14	-	2	GCGTGT
gi|514486271|gb|KE346361.1|	214200	214218	AGC	18	+	6	GCA
gi|514486271|gb|KE346361.1|	214723	214739	AAACAAC	16	-	2	TTTGTTG
gi|514486271|gb|KE346361.1|	214858	214872	A	14	-	14	T
gi|514486271|gb|KE346361.1|	217306	217320	AAAC	14	+	3	AACA
gi|514486271|gb|KE346361.1|	217468	217488	A	20	+	20	A
gi|514486271|gb|KE346361.1|	218978	218997	AGC	19	+	6	GCA
gi|514486271|gb|KE346361.1|	219194	219208	AAG	14	+	4	AAG
gi|514486271|gb|KE346361.1|	219203	219220	AACAAG	17	+	2	AAGAAC
gi|514486271|gb|KE346361.1|	219215	219235	AAG	20	+	6	AAG
gi|514486271|gb|KE346361.1|	219248	219292	A	44	-	44	T
gi|514486271|gb|KE346361.1|	219330	219359	A	29	-	29	T
gi|514486271|gb|KE346361.1|	219500	219520	A	20	+	20	A
gi|514486271|gb|KE346361.1|	221762	221776	AG	14	-	7	TC
gi|514486271|gb|KE346361.1|	223184	223200	AAG	16	-	5	TTC
gi|514486271|gb|KE346361.1|	224121	224135	ACG	14	+	4	GAC
gi|514486271|gb|KE346361.1|	225779	225794	AAAAAG	15	-	2	TTTCTT
gi|514486271|gb|KE346361.1|	226402	226416	AAAAC	14	-	2	TTTTG
gi|514486271|gb|KE346361.1|	227928	227943	AAAAAAG	15	-	2	TTTCTTT
gi|514486271|gb|KE346361.1|	228337	228353	AAATGGC	16	-	2	TTTGCCA
gi|514486271|gb|KE346361.1|	233921	233936	ACTC	15	-	3	GTGA
gi|514486271|gb|KE346361.1|	233949	233974	ACTC	25	-	6	GTGA
gi|514486271|gb|KE346361.1|	234451	234482	CCG	31	-	10	GCG
gi|514486271|gb|KE346361.1|	234679	234698	AGC	19	-	6	CTG
gi|514486271|gb|KE346361.1|	235122	235151	ATC	29	+	9	CAT
gi|514486271|gb|KE346361.1|	235152	235180	ATC	28	+	9	CAT
gi|514486271|gb|KE346361.1|	236852	236952	AC	100	+	50	AC
gi|514486271|gb|KE346361.1|	237373	237387	ACG	14	-	4	GTC
gi|514486271|gb|KE346361.1|	237828	237843	AACAGC	15	-	2	GCTGTT
gi|514486271|gb|KE346361.1|	238280	238298	A	18	+	18	A
gi|514486271|gb|KE346361.1|	238644	238668	AAGCC	24	+	4	AAGCC
gi|514486271|gb|KE346361.1|	239049	239066	ATC	17	-	5	ATG
gi|514486271|gb|KE346361.1|	240237	240252	AAAAGTG	15	-	2	TCACTTT
gi|514486271|gb|KE346361.1|	241827	241850	ACACTC	23	-	3	GTGTGA
gi|514486271|gb|KE346361.1|	242717	242731	AAAC	14	-	3	GTTT
gi|514486271|gb|KE346361.1|	243046	243061	AAAC	15	-	3	TTTG
gi|514486271|gb|KE346361.1|	243313	243331	A	18	-	18	T
gi|514486271|gb|KE346361.1|	243332	243346	AAG	14	-	4	CTT
gi|514486271|gb|KE346361.1|	243516	243533	AAGTCG	17	-	2	TCGACT
gi|514486271|gb|KE346361.1|	244687	244712	AAGCAG	25	-	4	CTGCTT
gi|514486271|gb|KE346361.1|	246027	246041	AGC	14	-	4	GCT
gi|514486271|gb|KE346361.1|	246587	246605	AAAAAT	18	-	3	ATTTTT
gi|514486271|gb|KE346361.1|	248015	248031	AGC	16	+	5	AGC
gi|514486271|gb|KE346361.1|	249215	249229	AGGCGG	14	+	2	CGGAGG
gi|514486271|gb|KE346361.1|	249386	249404	ACG	18	+	6	CGA
gi|514486271|gb|KE346361.1|	250437	250451	ACC	14	-	4	TGG
gi|514486271|gb|KE346361.1|	251375	251389	AGCAGCG	14	+	2	GCAGCGA
gi|514486271|gb|KE346361.1|	253647	253663	AAAAC	16	-	3	GTTTT
gi|514486271|gb|KE346361.1|	256168	256184	AAAAAGG	16	+	2	AAAAAGG
gi|514486271|gb|KE346361.1|	260609	260627	AAAACAC	18	-	2	GTTTTGT
gi|514486271|gb|KE346361.1|	260627	260642	AAAACC	15	-	2	GTTTTG
gi|514486271|gb|KE346361.1|	262220	262242	AAC	22	+	7	CAA
gi|514486271|gb|KE346361.1|	262480	262504	AAG	24	-	8	TTC
gi|514486271|gb|KE346361.1|	262686	262700	AAAAT	14	+	2	AAAAT
gi|514486271|gb|KE346361.1|	262736	262756	AAAAAAT	20	+	2	AAAAAAT
gi|514486271|gb|KE346361.1|	264472	264489	A	17	-	17	T
gi|514486271|gb|KE346361.1|	265918	265932	AAGAGAG	14	-	2	TCTCTCT
gi|514486271|gb|KE346361.1|	265929	265943	AAGAGAG	14	-	2	TCTCTCT
gi|514486271|gb|KE346361.1|	265940	265954	AAGAGAG	14	-	2	TCTCTCT
gi|514486271|gb|KE346361.1|	265951	265966	AAGAGAG	15	-	2	TCTCTCT
gi|514486271|gb|KE346361.1|	266290	266306	AACGACC	16	-	2	CGTTGGT
gi|514486271|gb|KE346361.1|	266608	266627	AAG	19	-	6	CTT
gi|514486271|gb|KE346361.1|	267759	267774	A	15	-	15	T
gi|514486271|gb|KE346361.1|	267798	267813	AAAAT	15	-	3	ATTTT
gi|514486271|gb|KE346361.1|	267806	267820	AAAAAT	14	-	2	TTATTT
gi|514486271|gb|KE346361.1|	267828	267853	A	25	-	25	T
gi|514486271|gb|KE346361.1|	268415	268431	AGC	16	+	5	CAG
gi|514486271|gb|KE346361.1|	268682	268697	AAGAGAG	15	-	2	TCTCTCT
gi|514486271|gb|KE346361.1|	268757	268792	A	35	+	35	A
gi|514486271|gb|KE346361.1|	269019	269038	A	19	+	19	A
gi|514486271|gb|KE346361.1|	269061	269079	AGCG	18	-	4	CTCG
gi|514486271|gb|KE346361.1|	269211	269228	A	17	-	17	T
gi|514486271|gb|KE346361.1|	269297	269313	AAAAAG	16	-	2	TTTTCT
gi|514486271|gb|KE346361.1|	270147	270167	A	20	+	20	A
gi|514486271|gb|KE346361.1|	271101	271128	A	27	-	27	T
gi|514486271|gb|KE346361.1|	271146	271173	A	27	-	27	T
gi|514486271|gb|KE346361.1|	271948	271966	A	18	-	18	T
gi|514486271|gb|KE346361.1|	271967	271981	AAAAAAG	14	-	2	CTTTTTT
gi|514486271|gb|KE346361.1|	272896	272940	AGC	44	-	14	TGC
gi|514486271|gb|KE346361.1|	272938	272952	AAC	14	-	4	TGT
gi|514486271|gb|KE346361.1|	272950	272982	AGC	32	-	10	TGC
gi|514486271|gb|KE346361.1|	273584	273599	AAAC	15	-	3	TTTG
gi|514486271|gb|KE346361.1|	274164	274178	A	14	+	14	A
gi|514486271|gb|KE346361.1|	274209	274238	A	29	+	29	A
gi|514486271|gb|KE346361.1|	274423	274437	AG	14	-	7	CT
gi|514486271|gb|KE346361.1|	274454	274475	ACC	21	+	7	CCA
gi|514486271|gb|KE346361.1|	275834	275852	AGCAGG	18	-	3	CCTGCT
gi|514486271|gb|KE346361.1|	276182	276201	AAG	19	-	6	TCT
gi|514486271|gb|KE346361.1|	278211	278225	AACGAC	14	+	2	ACGACA
gi|514486271|gb|KE346361.1|	278226	278241	ACG	15	+	5	ACG
gi|514486271|gb|KE346361.1|	278715	278740	AAAAAC	25	+	4	AAACAA
gi|514486271|gb|KE346361.1|	280567	280582	ACG	15	-	5	TCG
gi|514486271|gb|KE346361.1|	281049	281063	AGCCCC	14	+	2	GCCCCA
gi|514486271|gb|KE346361.1|	281316	281334	ACG	18	-	6	CGT
gi|514486271|gb|KE346361.1|	282063	282079	A	16	-	16	T
gi|514486271|gb|KE346361.1|	282096	282127	ACTGC	31	-	6	TGCAG
gi|514486271|gb|KE346361.1|	282413	282443	A	30	+	30	A
gi|514486271|gb|KE346361.1|	282533	282549	AC	16	-	8	GT
gi|514486271|gb|KE346361.1|	283173	283193	AAAAAAT	20	+	2	TAAAAAA
gi|514486271|gb|KE346361.1|	283262	283289	AAC	27	+	9	CAA
gi|514486271|gb|KE346361.1|	284409	284435	ACC	26	+	8	CCA
gi|514486271|gb|KE346361.1|	284732	284747	ACTGCC	15	-	2	GGCAGT
gi|514486271|gb|KE346361.1|	285025	285039	ACCACG	14	+	2	CACGAC
gi|514486271|gb|KE346361.1|	285034	285054	ACCATG	20	+	3	GACCAT
gi|514486271|gb|KE346361.1|	285058	285072	AGG	14	+	4	GAG
gi|514486271|gb|KE346361.1|	285966	285983	ACCACG	17	+	2	CACGAC
gi|514486271|gb|KE346361.1|	288572	288586	AAAGCAC	14	-	2	TGTGCTT
gi|514486271|gb|KE346361.1|	289096	289112	AACCCCC	16	+	2	CCCAACC
gi|514486271|gb|KE346361.1|	289252	289271	AG	19	-	9	TC
gi|514486271|gb|KE346361.1|	289624	289648	A	24	+	24	A
gi|514486271|gb|KE346361.1|	289659	289677	A	18	+	18	A
gi|514486271|gb|KE346361.1|	290582	290596	AAACAC	14	-	2	TGTTTG
gi|514486271|gb|KE346361.1|	292609	292626	AGCTGC	17	+	2	GCTGCA
gi|514486271|gb|KE346361.1|	293143	293158	AC	15	-	7	TG
gi|514486271|gb|KE346361.1|	293554	293573	AGC	19	+	6	GCA
gi|514486271|gb|KE346361.1|	293664	293691	AGC	27	+	9	CAG
gi|514486271|gb|KE346361.1|	293722	293736	AGCATC	14	+	2	TCAGCA
gi|514486271|gb|KE346361.1|	294034	294049	AATCTCC	15	+	2	CCAATCT
gi|514486271|gb|KE346361.1|	294087	294105	A	18	-	18	T
gi|514486271|gb|KE346361.1|	296505	296531	AGC	26	+	8	GCA
gi|514486271|gb|KE346361.1|	297535	297549	ACG	14	-	4	CGT
gi|514486271|gb|KE346361.1|	297700	297722	AGC	22	-	7	CTG
gi|514486271|gb|KE346361.1|	297909	297932	A	23	+	23	A
gi|514486271|gb|KE346361.1|	300371	300388	ACC	17	-	5	GTG
gi|514486271|gb|KE346361.1|	301319	301344	AAAC	25	-	6	TGTT
gi|514486271|gb|KE346361.1|	303882	303896	AAC	14	-	4	TGT
gi|514486271|gb|KE346361.1|	303903	303917	AAAAAAC	14	-	2	TTTTTTG
gi|514486271|gb|KE346361.1|	304737	304754	AGGC	17	+	4	CAGG
gi|514486271|gb|KE346361.1|	307455	307506	A	51	+	51	A
gi|514486271|gb|KE346361.1|	307507	307522	AAG	15	+	5	GAA
gi|514486271|gb|KE346361.1|	307837	307852	A	15	+	15	A
gi|514486271|gb|KE346361.1|	308073	308090	A	17	+	17	A
gi|514486271|gb|KE346361.1|	308184	308201	AAAGAG	17	+	2	AGAGAA
gi|514486271|gb|KE346361.1|	308204	308220	AG	16	+	8	AG
gi|514486271|gb|KE346361.1|	308816	308833	AAC	17	-	5	TTG
gi|514486271|gb|KE346361.1|	308832	308849	AAACAAC	17	-	2	TTGTTTG
gi|514486271|gb|KE346361.1|	309425	309446	AAGGGAG	21	+	3	GGAGAAG
gi|514486271|gb|KE346361.1|	309500	309523	A	23	+	23	A
gi|514486271|gb|KE346361.1|	309875	309889	AAAC	14	-	3	TTTG
gi|514486271|gb|KE346361.1|	309974	309990	AG	16	-	8	TC
gi|514486271|gb|KE346361.1|	310131	310145	A	14	+	14	A
gi|514486271|gb|KE346361.1|	310391	310412	A	21	+	21	A
gi|514486271|gb|KE346361.1|	310666	310682	AAAAAAC	16	+	2	AAACAAA
gi|514486271|gb|KE346361.1|	311769	311785	AAAAAC	16	-	2	TTTTTG
gi|514486271|gb|KE346361.1|	311830	311844	AACCGC	14	-	2	TTGCGG
gi|514486271|gb|KE346361.1|	312006	312024	A	18	+	18	A
gi|514486271|gb|KE346361.1|	312068	312088	AAAAAC	20	-	3	TTGTTT
gi|514486271|gb|KE346361.1|	312130	312147	AAGACAG	17	-	2	CTTCTGT
gi|514486271|gb|KE346361.1|	316467	316481	AAAAAAC	14	+	2	AAACAAA
gi|514486271|gb|KE346361.1|	317528	317545	AGGG	17	-	4	CCTC
gi|514486271|gb|KE346361.1|	317737	317799	AC	62	-	31	TG
gi|514486271|gb|KE346361.1|	317976	317990	AAAAACC	14	+	2	ACCAAAA
gi|514486271|gb|KE346361.1|	318456	318481	A	25	+	25	A
gi|514486271|gb|KE346361.1|	318700	318728	AC	28	-	14	TG
gi|514486271|gb|KE346361.1|	318802	318820	CCG	18	-	6	GCG
gi|514486271|gb|KE346361.1|	318837	318853	AG	16	+	8	AG
gi|514486271|gb|KE346361.1|	319690	319707	AAC	17	-	5	TGT
gi|514486271|gb|KE346361.1|	319708	319722	AAC	14	-	4	TGT
gi|514486271|gb|KE346361.1|	319717	319734	AACAGC	17	-	2	TGTTGC
gi|514486271|gb|KE346361.1|	321417	321431	AAAGTC	14	+	2	AGTCAA
gi|514486271|gb|KE346361.1|	322560	322580	A	20	+	20	A
gi|514486271|gb|KE346361.1|	322579	322600	AG	21	+	10	AG
gi|514486271|gb|KE346361.1|	322687	322701	AGG	14	+	4	GGA
gi|514486271|gb|KE346361.1|	322738	322771	A	33	+	33	A
gi|514486271|gb|KE346361.1|	323314	323331	AAC	17	+	5	AAC
gi|514486271|gb|KE346361.1|	323498	323512	AAAAC	14	-	2	TTTTG
gi|514486271|gb|KE346361.1|	323691	323706	AAAATT	15	+	2	AATTAA
gi|514486271|gb|KE346361.1|	324104	324120	A	16	+	16	A
gi|514486271|gb|KE346361.1|	324304	324319	A	15	+	15	A
gi|514486271|gb|KE346361.1|	324504	324520	AAAAAAC	16	+	2	AAAACAA
gi|514486271|gb|KE346361.1|	324516	324536	AAAAAC	20	+	3	AAAACA
gi|514486271|gb|KE346361.1|	324777	324793	AGCTCG	16	+	2	CGAGCT
gi|514486271|gb|KE346361.1|	325049	325065	AC	16	+	8	CA
gi|514486271|gb|KE346361.1|	325060	325077	ACACAT	17	+	2	ACACAT
gi|514486271|gb|KE346361.1|	325116	325130	A	14	+	14	A
gi|514486271|gb|KE346361.1|	325132	325146	AAAAAAC	14	+	2	AAAACAA
gi|514486271|gb|KE346361.1|	326054	326074	AAGAGGG	20	+	2	AGGGAAG
gi|514486271|gb|KE346361.1|	326078	326092	AACG	14	+	3	AACG
gi|514486271|gb|KE346361.1|	326090	326114	A	24	+	24	A
gi|514486271|gb|KE346361.1|	326132	326197	A	65	+	65	A
gi|514486271|gb|KE346361.1|	327451	327465	AGGGG	14	+	2	GGGGA
gi|514486271|gb|KE346361.1|	327564	327578	AAAACAC	14	-	2	TTTTGTG
gi|514486271|gb|KE346361.1|	327881	327897	A	16	+	16	A
gi|514486271|gb|KE346361.1|	331609	331623	ACCTGC	14	-	2	GCAGGT
gi|514486271|gb|KE346361.1|	331784	331798	AGCAGG	14	+	2	GAGCAG
gi|514486271|gb|KE346361.1|	332942	332957	AGCATG	15	+	2	AGCATG
gi|514486271|gb|KE346361.1|	333739	333784	A	45	-	45	T
gi|514486271|gb|KE346361.1|	333973	333989	A	16	+	16	A
gi|514486271|gb|KE346361.1|	334468	334495	A	27	+	27	A
gi|514486271|gb|KE346361.1|	334511	334529	AAAAAG	18	+	3	GAAAAA
gi|514486271|gb|KE346361.1|	334724	334738	AAAAT	14	+	2	AAAAT
gi|514486271|gb|KE346361.1|	334731	334745	AAAAAT	14	+	2	AATAAA
gi|514486271|gb|KE346361.1|	335167	335181	A	14	-	14	T
gi|514486271|gb|KE346361.1|	335750	335764	A	14	-	14	T
gi|514486271|gb|KE346361.1|	335798	335813	A	15	-	15	T
gi|514486271|gb|KE346361.1|	336003	336030	A	27	-	27	T
gi|514486271|gb|KE346361.1|	336062	336076	A	14	-	14	T
gi|514486271|gb|KE346361.1|	336273	336287	AAAAT	14	-	2	TTTTA
gi|514486271|gb|KE346361.1|	336348	336368	AAG	20	+	6	AAG
gi|514486271|gb|KE346361.1|	336404	336418	AAAAC	14	-	2	TTTTG
gi|514486271|gb|KE346361.1|	341547	341561	AACAACC	14	-	2	GTTGTTG
gi|514486271|gb|KE346361.1|	341751	341778	A	27	-	27	T
gi|514486271|gb|KE346361.1|	342081	342103	ATC	22	+	7	ATC
gi|514486271|gb|KE346361.1|	342098	342112	AGCATC	14	+	2	CATCAG
gi|514486271|gb|KE346361.1|	342119	342133	AGCATC	14	+	2	CATCAG
gi|514486271|gb|KE346361.1|	342166	342183	AATCCC	17	+	2	CAATCC
gi|514486271|gb|KE346361.1|	342205	342237	AGC	32	+	10	AGC
gi|514486271|gb|KE346361.1|	342271	342285	ATC	14	+	4	TCA
gi|514486271|gb|KE346361.1|	342280	342294	ACGATG	14	-	2	TCATCG
gi|514486271|gb|KE346361.1|	342560	342576	ACG	16	+	5	CGA
gi|514486271|gb|KE346361.1|	342614	342631	ACCACT	17	-	2	GTAGTG
gi|514486271|gb|KE346361.1|	342754	342768	AGGATG	14	-	2	TCCTCA
gi|514486271|gb|KE346361.1|	342764	342780	AGCATC	16	+	2	CATCAG
gi|514486271|gb|KE346361.1|	342902	342927	AGC	25	-	8	CTG
gi|514486271|gb|KE346361.1|	343504	343518	AGCATC	14	+	2	CATCAG
gi|514486271|gb|KE346361.1|	344029	344043	AGC	14	+	4	CAG
gi|514486271|gb|KE346361.1|	344052	344085	AGC	33	+	11	GCA
gi|514486271|gb|KE346361.1|	344083	344127	AAC	44	+	14	CAA
gi|514486271|gb|KE346361.1|	345083	345113	AGG	30	-	10	CTC
gi|514486271|gb|KE346361.1|	346628	346642	A	14	-	14	T
gi|514486271|gb|KE346361.1|	348690	348705	AATCC	15	+	3	CAATC
gi|514486271|gb|KE346361.1|	349334	349348	AAAAAGC	14	+	2	GCAAAAA
gi|514486271|gb|KE346361.1|	350530	350546	AAAACAC	16	+	2	ACACAAA
gi|514486271|gb|KE346361.1|	350621	350636	AAC	15	-	5	TTG
gi|514486271|gb|KE346361.1|	350902	350920	AGG	18	-	6	CTC
gi|514486271|gb|KE346361.1|	350919	350934	AGGG	15	-	3	CTCC
gi|514486271|gb|KE346361.1|	351266	351280	AGC	14	-	4	GCT
gi|514486271|gb|KE346361.1|	351339	351357	AAAGGC	18	-	3	CCTTTG
gi|514486271|gb|KE346361.1|	351352	351369	AAAGAC	17	-	2	CTTTGT
gi|514486271|gb|KE346361.1|	351740	351754	ACAGCG	14	-	2	CGCTGT
gi|514486271|gb|KE346361.1|	352074	352088	ACGAGG	14	+	2	GAGGAC
gi|514486271|gb|KE346361.1|	352628	352645	ACG	17	+	5	GAC
gi|514486271|gb|KE346361.1|	353232	353249	AGC	17	-	5	CTG
gi|514486271|gb|KE346361.1|	353266	353281	AGC	15	-	5	TGC
gi|514486271|gb|KE346361.1|	353360	353377	ACGAGG	17	+	2	GACGAG
gi|514486271|gb|KE346361.1|	353759	353782	ATC	23	-	7	GAT
gi|514486271|gb|KE346361.1|	353860	353880	AACTCC	20	+	3	CAACTC
gi|514486271|gb|KE346361.1|	354327	354345	A	18	-	18	T
gi|514486271|gb|KE346361.1|	356407	356426	ACACGC	19	+	3	CGCACA
gi|514486271|gb|KE346361.1|	360272	360288	AGCGGC	16	+	2	CGGCAG
gi|514486271|gb|KE346361.1|	360868	360882	A	14	-	14	T
gi|514486271|gb|KE346361.1|	360883	360919	AAG	36	-	12	CTT
gi|514486271|gb|KE346361.1|	360941	360955	ACTGCGG	14	+	2	GACTGCG
gi|514486271|gb|KE346361.1|	361550	361567	A	17	+	17	A
gi|514486271|gb|KE346361.1|	361819	361850	AG	31	-	15	TC
gi|514486271|gb|KE346361.1|	362039	362055	AAGAGT	16	-	2	TACTCT
gi|514486271|gb|KE346361.1|	362732	362748	AAGAGT	16	-	2	TACTCT
gi|514486271|gb|KE346361.1|	363236	363250	ATC	14	-	4	ATG
gi|514486271|gb|KE346361.1|	364144	364160	AACG	16	-	4	CGTT
gi|514486271|gb|KE346361.1|	365412	365429	ACC	17	+	5	CCA
gi|514486271|gb|KE346361.1|	366686	366703	ATC	17	-	5	GAT
gi|514486271|gb|KE346361.1|	366701	366730	ACG	29	+	9	GAC
gi|514486271|gb|KE346361.1|	368404	368422	A	18	-	18	T
gi|514486271|gb|KE346361.1|	368938	368969	A	31	-	31	T
gi|514486271|gb|KE346361.1|	369949	369965	AC	16	+	8	CA
gi|514486271|gb|KE346361.1|	370503	370523	ATCC	20	-	5	GATG
gi|514486271|gb|KE346361.1|	371652	371669	AAGGGC	17	-	2	CTTGCC
gi|514486271|gb|KE346361.1|	372957	372981	AAACAC	24	-	4	TTTGTG
gi|514486271|gb|KE346361.1|	373246	373269	A	23	-	23	T
gi|514486271|gb|KE346361.1|	373551	373570	ACGGGGG	19	+	2	GGGGACG
gi|514486271|gb|KE346361.1|	373768	373793	A	25	+	25	A
gi|514486271|gb|KE346361.1|	374945	374960	AGC	15	-	5	GCT
gi|514486271|gb|KE346361.1|	375638	375742	AAC	104	-	34	TTG
gi|514486271|gb|KE346361.1|	376159	376177	AAAAAAC	18	-	2	TTTTTTG
gi|514486271|gb|KE346361.1|	376567	376585	ATC	18	-	6	TGA
gi|514486271|gb|KE346361.1|	376969	376994	A	25	+	25	A
gi|514486271|gb|KE346361.1|	378242	378258	AAAGAC	16	-	2	TGTCTT
gi|514486271|gb|KE346361.1|	378409	378432	AAAC	23	-	5	TTTG
gi|514486271|gb|KE346361.1|	379903	379918	ACTGGC	15	-	2	TGCCAG
gi|514486271|gb|KE346361.1|	380795	380811	AGCC	16	+	4	AGCC
gi|514486271|gb|KE346361.1|	383388	383403	AAAGCGG	15	-	2	CCGCTTT
gi|514486271|gb|KE346361.1|	384263	384280	AAATCAG	17	+	2	GAAATCA
gi|514486271|gb|KE346361.1|	385508	385523	A	15	+	15	A
gi|514486271|gb|KE346361.1|	386290	386365	AGC	75	-	25	CTG
gi|514486271|gb|KE346361.1|	388767	388782	AAGCGG	15	-	2	GCTTCC
gi|514486271|gb|KE346361.1|	389442	389456	A	14	-	14	T
gi|514486271|gb|KE346361.1|	389745	389762	AAAAC	17	-	3	TTTTG
gi|514486271|gb|KE346361.1|	396105	396119	ACATGC	14	+	2	CATGCA
gi|514486271|gb|KE346361.1|	398464	398490	ACCAG	26	+	5	GACCA
gi|514486271|gb|KE346361.1|	399809	399823	A	14	-	14	T
gi|514486271|gb|KE346361.1|	399849	399863	AAAAAT	14	-	2	TTTATT
gi|514486271|gb|KE346361.1|	399859	399874	AAAAAT	15	-	2	TTTTAT
gi|514486271|gb|KE346361.1|	400012	400027	AAGACAG	15	+	2	ACAGAAG
gi|514486271|gb|KE346361.1|	400021	400037	AAG	16	+	5	AGA
gi|514486271|gb|KE346361.1|	400385	400406	AAGGGTC	21	-	3	TTGACCC
gi|514486271|gb|KE346361.1|	400551	400565	A	14	+	14	A
gi|514486271|gb|KE346361.1|	400566	400580	A	14	+	14	A
gi|514486271|gb|KE346361.1|	402228	402244	AACTTG	16	-	2	GTTCAA
gi|514486271|gb|KE346361.1|	404376	404395	AGAGC	19	+	3	CAGAG
gi|514486271|gb|KE346361.1|	404536	404564	A	28	-	28	T
gi|514486271|gb|KE346361.1|	404715	404732	AAAAAC	17	+	2	AAAAAC
gi|514486271|gb|KE346361.1|	404761	404802	A	41	+	41	A
gi|514486271|gb|KE346361.1|	405392	405408	AAC	16	-	5	TTG
gi|514486271|gb|KE346361.1|	405651	405667	AGG	16	-	5	CCT
gi|514486271|gb|KE346361.1|	407455	407470	AAAAAG	15	-	2	TTTCTT
gi|514486271|gb|KE346361.1|	407823	407837	AAAAC	14	+	2	AAAAC
gi|514486271|gb|KE346361.1|	408120	408135	ATCC	15	-	3	ATGG
gi|514486271|gb|KE346361.1|	409375	409401	ACGCCG	26	+	4	ACGCCG
gi|514486271|gb|KE346361.1|	409450	409467	AAAGGG	17	+	2	GGGAAA
gi|514486271|gb|KE346361.1|	409768	409793	A	25	+	25	A
gi|514486271|gb|KE346361.1|	410004	410019	AC	15	+	7	CA
gi|514486271|gb|KE346361.1|	410081	410095	AGGGGGG	14	-	2	CCCTCCC
gi|514486271|gb|KE346361.1|	410102	410117	ACACGC	15	+	2	CACGCA
gi|514486271|gb|KE346361.1|	410692	410711	AAAAG	19	+	3	AAAAG
gi|514486271|gb|KE346361.1|	410977	410991	ATCATGC	14	-	2	CATGATG
gi|514486271|gb|KE346361.1|	411258	411272	A	14	+	14	A
gi|514486271|gb|KE346361.1|	412038	412052	A	14	-	14	T
gi|514486271|gb|KE346361.1|	413500	413515	A	15	+	15	A
gi|514486271|gb|KE346361.1|	414838	414864	AAAC	26	+	6	AAAC
gi|514486271|gb|KE346361.1|	415631	415655	A	24	+	24	A
gi|514486271|gb|KE346361.1|	415701	415717	A	16	+	16	A
gi|514486271|gb|KE346361.1|	416164	416178	AAGCC	14	-	2	GGCTT
gi|514486271|gb|KE346361.1|	416191	416211	AGC	20	+	6	GCA
gi|514486271|gb|KE346361.1|	416756	416781	AAC	25	+	8	AAC
gi|514486271|gb|KE346361.1|	419064	419084	AC	20	+	10	AC
gi|514486271|gb|KE346361.1|	419139	419163	AG	24	+	12	GA
gi|514486271|gb|KE346361.1|	419393	419413	AAAAAAG	20	+	2	AAAAAAG
gi|514486271|gb|KE346361.1|	419544	419568	AG	24	+	12	AG
gi|514486271|gb|KE346361.1|	419586	419673	AG	87	+	43	AG
gi|514486271|gb|KE346361.1|	419908	419922	AAAAACC	14	+	2	AAACCAA
gi|514486271|gb|KE346361.1|	420796	420812	AAAAC	16	-	3	GTTTT
gi|514486271|gb|KE346361.1|	421209	421224	A	15	+	15	A
gi|514486271|gb|KE346361.1|	421712	421726	AAAAACC	14	-	2	TTGGTTT
gi|514486271|gb|KE346361.1|	421963	421985	A	22	+	22	A
gi|514486271|gb|KE346361.1|	422167	422186	AAAAGC	19	-	3	TTTTGC
gi|514486271|gb|KE346361.1|	422341	422374	A	33	+	33	A
gi|514486271|gb|KE346361.1|	424846	424860	AAGCGG	14	-	2	GCTTCC
gi|514486271|gb|KE346361.1|	428661	428678	A	17	-	17	T
gi|514486271|gb|KE346361.1|	428845	428861	A	16	+	16	A
gi|514486271|gb|KE346361.1|	428956	428970	AACCAC	14	-	2	GTGGTT
gi|514486271|gb|KE346361.1|	430137	430151	AGCCTC	14	-	2	GCTGAG
gi|514486271|gb|KE346361.1|	430209	430232	AGG	23	+	7	GAG
gi|514486271|gb|KE346361.1|	430629	430650	AGGCGC	21	+	3	CAGGCG
gi|514486271|gb|KE346361.1|	430755	430777	AGC	22	-	7	GCT
gi|514486271|gb|KE346361.1|	430898	430921	AGC	23	-	7	TGC
gi|514486271|gb|KE346361.1|	430931	430961	ACTGCC	30	+	5	CCACTG
gi|514486271|gb|KE346361.1|	431080	431095	ACG	15	+	5	CGA
gi|514486271|gb|KE346361.1|	431227	431245	A	18	-	18	T
gi|514486271|gb|KE346361.1|	431374	431388	AGAGGCG	14	+	2	AGGCGAG
gi|514486271|gb|KE346361.1|	431647	431662	AAC	15	+	5	AAC
gi|514486271|gb|KE346361.1|	432233	432247	AAAAACC	14	-	2	TTTTTGG
gi|514486271|gb|KE346361.1|	433376	433399	A	23	+	23	A
gi|514486271|gb|KE346361.1|	434035	434049	AAAAAG	14	+	2	AAAGAA
gi|514486271|gb|KE346361.1|	435834	435851	AG	17	+	8	AG
gi|514486271|gb|KE346361.1|	435931	435947	AGGGATG	16	+	2	GAGGGAT
gi|514486271|gb|KE346361.1|	438490	438504	AAAAC	14	+	2	ACAAA
gi|514486271|gb|KE346361.1|	438797	438814	ACCCCC	17	-	2	GGGGGT
gi|514486271|gb|KE346361.1|	439675	439696	ACCGCC	21	-	3	GGCGGT
gi|514486271|gb|KE346361.1|	439896	439912	A	16	-	16	T
gi|514486271|gb|KE346361.1|	441852	441868	AAC	16	+	5	ACA
gi|514486271|gb|KE346361.1|	441966	441981	AAAGAG	15	+	2	AAGAGA
gi|514486271|gb|KE346361.1|	443508	443532	ACG	24	+	8	ACG
gi|514486271|gb|KE346361.1|	443757	443771	AACTTG	14	-	2	TCAAGT
gi|514486271|gb|KE346361.1|	443820	443834	AAAAC	14	+	2	AACAA
gi|514486271|gb|KE346361.1|	444220	444236	AGCTC	16	-	3	CTGAG
gi|514486271|gb|KE346361.1|	445399	445415	A	16	-	16	T
gi|514486271|gb|KE346361.1|	445410	445424	AAAAAC	14	-	2	TTTTTG
gi|514486271|gb|KE346361.1|	446326	446346	AGAGCG	20	+	3	AGAGCG
gi|514486271|gb|KE346361.1|	446411	446429	AGAGG	18	-	3	CTCTC
gi|514486271|gb|KE346361.1|	447546	447560	AAAAAC	14	+	2	AAAAAC
gi|514486271|gb|KE346361.1|	447625	447640	AC	15	+	7	CA
gi|514486271|gb|KE346361.1|	448117	448134	AAAAAT	17	-	2	TTTTTA
gi|514486271|gb|KE346361.1|	448173	448191	A	18	-	18	T
gi|514486271|gb|KE346361.1|	448362	448382	A	20	-	20	T
gi|514486271|gb|KE346361.1|	448583	448608	A	25	+	25	A
gi|514486271|gb|KE346361.1|	448622	448652	A	30	-	30	T
gi|514486271|gb|KE346361.1|	448852	448866	AAAAAAC	14	-	2	TTTTTTG
gi|514486271|gb|KE346361.1|	449245	449261	AAAAAC	16	+	2	AAAAAC
gi|514486271|gb|KE346361.1|	449942	449960	ACC	18	+	6	ACC
gi|514486271|gb|KE346361.1|	450419	450433	ACCCGTC	14	+	2	TCACCCG
gi|514486271|gb|KE346361.1|	450732	450765	AGC	33	+	11	CAG
gi|514486271|gb|KE346361.1|	450800	450819	AGC	19	+	6	GCA
gi|514486271|gb|KE346361.1|	453380	453417	AC	37	-	18	TG
gi|514486271|gb|KE346361.1|	454269	454283	AAG	14	-	4	CTT
gi|514486271|gb|KE346361.1|	454481	454501	AAC	20	-	6	TGT
gi|514486271|gb|KE346361.1|	454826	454849	AAC	23	-	7	TGT
gi|514486271|gb|KE346361.1|	454847	454865	ACC	18	-	6	TGG
gi|514486271|gb|KE346361.1|	455036	455052	ACCAGC	16	-	2	TGGTGC
gi|514486271|gb|KE346361.1|	456094	456109	ACGATG	15	-	2	GTCATC
gi|514486271|gb|KE346361.1|	456943	456957	AAGCCAG	14	+	2	AAGCCAG
gi|514486271|gb|KE346361.1|	456964	456981	AAAAAC	17	+	2	AAAAAC
gi|514486271|gb|KE346361.1|	456986	457008	A	22	+	22	A
gi|514486271|gb|KE346361.1|	457005	457024	AAAC	19	+	4	AAAC
gi|514486271|gb|KE346361.1|	457021	457037	A	16	+	16	A
gi|514486271|gb|KE346361.1|	458236	458251	AAGGGAC	15	+	2	GACAAGG
gi|514486271|gb|KE346361.1|	458677	458691	CCCCG	14	-	2	GGGGC
gi|514486271|gb|KE346361.1|	458804	458818	AC	14	+	7	CA
gi|514486271|gb|KE346361.1|	460149	460164	A	15	+	15	A
gi|514486271|gb|KE346361.1|	460360	460375	AAGAAGG	15	-	2	TCCTTCT
gi|514486271|gb|KE346361.1|	460861	460880	AGCGGC	19	+	3	CAGCGG
gi|514486271|gb|KE346361.1|	461674	461688	AACAAGC	14	-	2	GCTTGTT
gi|514486271|gb|KE346361.1|	462454	462475	A	21	+	21	A
gi|514486271|gb|KE346361.1|	462671	462697	A	26	+	26	A
gi|514486271|gb|KE346361.1|	462901	462915	A	14	+	14	A
gi|514486271|gb|KE346361.1|	464099	464121	AAGG	22	+	5	AGGA
gi|514486271|gb|KE346361.1|	464232	464256	AG	24	+	12	AG
gi|514486271|gb|KE346361.1|	465483	465510	A	27	+	27	A
gi|514486271|gb|KE346361.1|	465670	465697	A	27	+	27	A
gi|514486271|gb|KE346361.1|	465888	465904	AAAAAT	16	-	2	TTTTTA
gi|514486271|gb|KE346361.1|	465915	465930	A	15	-	15	T
gi|514486271|gb|KE346361.1|	465932	465947	A	15	-	15	T
gi|514486271|gb|KE346361.1|	466151	466166	A	15	+	15	A
gi|514486271|gb|KE346361.1|	466167	466182	A	15	+	15	A
gi|514486271|gb|KE346361.1|	466341	466355	AAAAAAC	14	-	2	TTTTTTG
gi|514486271|gb|KE346361.1|	466374	466388	AAAAT	14	-	2	TTTTA
gi|514486271|gb|KE346361.1|	468710	468727	A	17	-	17	T
gi|514486271|gb|KE346361.1|	469284	469298	AACTGCC	14	+	2	TGCCAAC
gi|514486271|gb|KE346361.1|	470047	470063	AAAAAT	16	+	2	AAAATA
gi|514486271|gb|KE346361.1|	471398	471413	AAAC	15	+	3	AAAC
gi|514486271|gb|KE346361.1|	471672	471693	A	21	-	21	T
gi|514486271|gb|KE346361.1|	471875	471939	AGC	64	-	21	GCT
gi|514486271|gb|KE346361.1|	472689	472705	AACAGC	16	-	2	GCTGTT
gi|514486271|gb|KE346361.1|	472700	472715	AGC	15	-	5	TGC
gi|514486271|gb|KE346361.1|	473123	473141	AC	18	-	9	TG
gi|514486271|gb|KE346361.1|	473215	473243	AAG	28	+	9	GAA
gi|514486271|gb|KE346361.1|	473268	473293	A	25	+	25	A
gi|514486271|gb|KE346361.1|	473328	473342	AATCCTC	14	-	2	TTGAGGA
gi|514486271|gb|KE346361.1|	473431	473450	AACC	19	+	4	CCAA
gi|514486271|gb|KE346361.1|	473452	473492	A	40	+	40	A
gi|514486271|gb|KE346361.1|	473631	473668	AG	37	+	18	AG
gi|514486271|gb|KE346361.1|	475163	475188	A	25	+	25	A
gi|514486271|gb|KE346361.1|	475516	475531	A	15	+	15	A
gi|514486271|gb|KE346361.1|	476519	476536	AC	17	+	8	AC
gi|514486271|gb|KE346361.1|	476531	476548	AAACAC	17	+	2	ACACAA
gi|514486271|gb|KE346361.1|	477484	477498	A	14	-	14	T
gi|514486271|gb|KE346361.1|	477511	477526	A	15	-	15	T
gi|514486271|gb|KE346361.1|	478368	478386	AAAACGC	18	+	2	GCAAAAC
gi|514486271|gb|KE346361.1|	478889	478921	A	32	+	32	A
gi|514486271|gb|KE346361.1|	481765	481779	AGAGC	14	+	2	GAGCA
gi|514486271|gb|KE346361.1|	482034	482051	AAGCTC	17	+	2	CAAGCT
gi|514486271|gb|KE346361.1|	482469	482487	AC	18	+	9	CA
gi|514486271|gb|KE346361.1|	483607	483621	ACCCCCC	14	-	2	GGGGGGT
gi|514486271|gb|KE346361.1|	484022	484039	ACCCG	17	-	3	GGGTC
gi|514486271|gb|KE346361.1|	484431	484446	A	15	+	15	A
gi|514486271|gb|KE346361.1|	484533	484547	AACCCCC	14	+	2	CAACCCC
gi|514486271|gb|KE346361.1|	484667	484682	ACTCCG	15	+	2	TCCGAC
gi|514486271|gb|KE346361.1|	484810	484825	A	15	+	15	A
gi|514486271|gb|KE346361.1|	485020	485042	A	22	+	22	A
gi|514486271|gb|KE346361.1|	485263	485278	AAAAAT	15	+	2	AAATAA
gi|514486271|gb|KE346361.1|	485291	485314	A	23	-	23	T
gi|514486271|gb|KE346361.1|	485694	485708	AAGAGGG	14	-	2	TTCCCTC
gi|514486271|gb|KE346361.1|	486861	486875	AAC	14	+	4	CAA
gi|514486271|gb|KE346361.1|	486870	486885	AACAGC	15	+	2	CAACAG
gi|514486271|gb|KE346361.1|	487223	487238	AGC	15	+	5	GCA
gi|514486271|gb|KE346361.1|	487463	487479	ACC	16	+	5	CCA
gi|514486271|gb|KE346361.1|	488519	488534	ACTGCCG	15	+	2	ACTGCCG
gi|514486271|gb|KE346361.1|	489337	489352	AAAAAG	15	-	2	TTTTCT
gi|514486271|gb|KE346361.1|	489525	489539	AAAAAC	14	-	2	TTGTTT
gi|514486271|gb|KE346361.1|	489943	489957	AACC	14	-	3	TTGG
gi|514486271|gb|KE346361.1|	490804	490821	A	17	+	17	A
gi|514486271|gb|KE346361.1|	491011	491025	A	14	+	14	A
gi|514486271|gb|KE346361.1|	492172	492188	AAAAAG	16	+	2	AAAAGA
gi|514486271|gb|KE346361.1|	493074	493094	A	20	+	20	A
gi|514486271|gb|KE346361.1|	493259	493274	C	15	-	15	G
gi|514486271|gb|KE346361.1|	493480	493511	A	31	+	31	A
gi|514486271|gb|KE346361.1|	493552	493570	A	18	-	18	T
gi|514486271|gb|KE346361.1|	493718	493738	A	20	+	20	A
gi|514486271|gb|KE346361.1|	494176	494190	AAGGG	14	-	2	TTCCC
gi|514486271|gb|KE346361.1|	494639	494655	ACTCTCC	16	-	2	GAGTGGA
gi|514486271|gb|KE346361.1|	495071	495085	AGCG	14	-	3	CTCG
gi|514486271|gb|KE346361.1|	495196	495210	AAAGCTC	14	-	2	CTTTGAG
gi|514486271|gb|KE346361.1|	495537	495554	ACTGAG	17	-	2	CTCAGT
gi|514486271|gb|KE346361.1|	496513	496542	ACC	29	+	9	CCA
gi|514486271|gb|KE346361.1|	496932	496948	AGC	16	-	5	GCT
gi|514486271|gb|KE346361.1|	498162	498185	AACAGC	23	+	3	CAGCAA
gi|514486271|gb|KE346361.1|	498502	498516	AAC	14	-	4	TTG
gi|514486271|gb|KE346361.1|	498623	498639	AAC	16	-	5	TTG
gi|514486271|gb|KE346361.1|	498655	498669	AACC	14	+	3	ACCA
gi|514486271|gb|KE346361.1|	498957	498973	AAGGG	16	-	3	TCCCT
gi|514486271|gb|KE346361.1|	499059	499076	AACTG	17	-	3	GTTCA
gi|514486271|gb|KE346361.1|	499677	499692	AGCATC	15	-	2	CTGATG
gi|514486271|gb|KE346361.1|	502940	502955	AAAAGC	15	+	2	AAAGCA
gi|514486271|gb|KE346361.1|	503363	503379	ACAGAG	16	-	2	TCTCTG
gi|514486271|gb|KE346361.1|	503420	503434	ACCGAG	14	-	2	TCTCGG
gi|514486271|gb|KE346361.1|	503501	503515	ACCGAG	14	-	2	TCTCGG
gi|514486271|gb|KE346361.1|	503531	503546	ACTCGG	15	+	2	CTCGGA
gi|514486271|gb|KE346361.1|	503546	503562	AGC	16	-	5	CTG
gi|514486271|gb|KE346361.1|	503624	503641	AGAGCG	17	+	2	CGAGAG
gi|514486271|gb|KE346361.1|	504163	504177	AGCCGC	14	-	2	GCTGCG
gi|514486271|gb|KE346361.1|	506044	506064	AGG	20	+	6	AGG
gi|514486271|gb|KE346361.1|	506096	506111	AAC	15	-	5	GTT
gi|514486271|gb|KE346361.1|	506113	506129	AAAC	16	-	4	TGTT
gi|514486271|gb|KE346361.1|	506877	506893	A	16	-	16	T
gi|514486271|gb|KE346361.1|	507612	507626	AAAGCT	14	+	2	AGCTAA
gi|514486271|gb|KE346361.1|	507914	507932	ACCTGC	18	-	3	GGTGCA
gi|514486271|gb|KE346361.1|	509050	509077	AGCTC	27	-	5	GAGCT
gi|514486271|gb|KE346361.1|	509193	509210	AAAAAC	17	-	2	TTTTTG
gi|514486271|gb|KE346361.1|	511454	511470	AGC	16	+	5	GCA
gi|514486271|gb|KE346361.1|	513273	513290	AGC	17	-	5	TGC
gi|514486271|gb|KE346361.1|	513954	513968	ACG	14	+	4	CGA
gi|514486271|gb|KE346361.1|	515446	515464	AGC	18	+	6	CAG
gi|514486271|gb|KE346361.1|	517353	517368	AAGCCGC	15	+	2	CGCAAGC
gi|514486271|gb|KE346361.1|	518746	518764	AGCGGCG	18	-	2	CTCGCCG
gi|514486271|gb|KE346361.1|	519119	519135	AGC	16	-	5	CTG
gi|514486271|gb|KE346361.1|	520229	520243	AAGCGCG	14	+	2	AAGCGCG
gi|514486271|gb|KE346361.1|	520648	520665	ACCAGC	17	-	2	TGCTGG
gi|514486271|gb|KE346361.1|	520660	520693	AGC	33	-	11	TGC
gi|514486271|gb|KE346361.1|	521306	521321	AACG	15	+	3	AACG
gi|514486271|gb|KE346361.1|	522786	522801	ACG	15	+	5	CGA
gi|514486271|gb|KE346361.1|	522893	522909	AGC	16	-	5	GCT
gi|514486271|gb|KE346361.1|	523021	523037	ATC	16	-	5	GAT
gi|514486271|gb|KE346361.1|	523213	523227	A	14	+	14	A
gi|514486271|gb|KE346361.1|	523680	523694	ACG	14	+	4	GAC
gi|514486271|gb|KE346361.1|	524028	524054	ACG	26	+	8	ACG
gi|514486271|gb|KE346361.1|	524287	524302	AAGACAC	15	+	2	CAAGACA
gi|514486271|gb|KE346361.1|	524345	524374	AGCCGG	29	-	4	GCTCCG
gi|514486271|gb|KE346361.1|	526010	526029	AAATTCC	19	-	2	TTTGGAA
gi|514486271|gb|KE346361.1|	527571	527588	AGGATG	17	+	2	GAGGAT
gi|514486271|gb|KE346361.1|	529664	529678	AAACATC	14	+	2	TCAAACA
gi|514486271|gb|KE346361.1|	532880	532894	AATGACC	14	+	2	ATGACCA
gi|514486271|gb|KE346361.1|	533055	533079	AGAGG	24	-	4	CTCCT
gi|514486271|gb|KE346361.1|	533124	533139	AACGATG	15	-	2	CATCGTT
gi|514486271|gb|KE346361.1|	533476	533494	ACACATC	18	-	2	TGTGATG
gi|514486271|gb|KE346361.1|	533495	533522	ACACATC	27	-	3	TGTGTGA
gi|514486271|gb|KE346361.1|	537754	537774	AGC	20	-	6	CTG
gi|514486271|gb|KE346361.1|	537775	537793	CCG	18	-	6	GCG
gi|514486271|gb|KE346361.1|	538945	538959	AGGGGCG	14	+	2	AGGGGCG
gi|514486271|gb|KE346361.1|	540003	540017	AACAGC	14	-	2	GCTGTT
gi|514486271|gb|KE346361.1|	540309	540323	AAACCAC	14	-	2	TGGTTTG
gi|514486271|gb|KE346361.1|	540799	540818	AAAGAAC	19	+	2	GAACAAA
gi|514486271|gb|KE346361.1|	541473	541487	AAAGAAG	14	+	2	AAGAAGA
gi|514486271|gb|KE346361.1|	541749	541765	A	16	+	16	A
gi|514486271|gb|KE346361.1|	543131	543156	A	25	-	25	T
gi|514486271|gb|KE346361.1|	543351	543368	A	17	-	17	T
gi|514486271|gb|KE346361.1|	543592	543611	A	19	-	19	T
gi|514486271|gb|KE346361.1|	544114	544134	AG	20	-	10	TC
gi|514486271|gb|KE346361.1|	544127	544141	AGAGAGG	14	-	2	CTCTCTC
gi|514486271|gb|KE346361.1|	544134	544157	AG	23	-	11	CT
gi|514486271|gb|KE346361.1|	544423	544437	AAAAC	14	+	2	AAAAC
gi|514486271|gb|KE346361.1|	544641	544655	AATCGAG	14	-	2	CTCGATT
gi|514486271|gb|KE346361.1|	544958	544975	A	17	+	17	A
gi|514486271|gb|KE346361.1|	546377	546391	ACTCGAG	14	-	2	CGAGTCT
gi|514486271|gb|KE346361.1|	546982	547084	AAACGC	102	-	17	CGTTTG
gi|514486271|gb|KE346361.1|	550585	550599	AAAAAAC	14	-	2	GTTTTTT
gi|514486271|gb|KE346361.1|	550976	550994	AGC	18	-	6	TGC
gi|514486271|gb|KE346361.1|	551581	551595	AAAAG	14	-	2	TTTTC
gi|514486271|gb|KE346361.1|	551621	551638	AAC	17	-	5	TTG
gi|514486271|gb|KE346361.1|	552531	552548	AAAAAAC	17	-	2	TTTTTTG
gi|514486271|gb|KE346361.1|	552545	552560	AAAAAC	15	-	2	TTTGTT
gi|514486271|gb|KE346361.1|	553260	553274	AAATATG	14	-	2	ATATTTC
gi|514486271|gb|KE346361.1|	554354	554368	ACG	14	+	4	GAC
gi|514486271|gb|KE346361.1|	554493	554517	AAAC	24	+	6	CAAA
gi|514486271|gb|KE346361.1|	554705	554720	AAGAAT	15	-	2	TTATTC
gi|514486271|gb|KE346361.1|	555028	555043	ACC	15	-	5	GTG
gi|514486271|gb|KE346361.1|	555740	555764	A	24	-	24	T
gi|514486271|gb|KE346361.1|	556391	556408	ACGAGC	17	-	2	GCTCGT
gi|514486271|gb|KE346361.1|	556847	556866	AAAC	19	-	4	TTTG
gi|514486271|gb|KE346361.1|	558854	558870	AAAAAC	16	+	2	AAAAAC
gi|514486271|gb|KE346361.1|	559157	559173	A	16	+	16	A
gi|514486271|gb|KE346361.1|	560353	560367	AACAAT	14	+	2	AACAAT
gi|514486271|gb|KE346361.1|	561105	561128	AGC	23	+	7	GCA
gi|514486271|gb|KE346361.1|	561321	561417	AG	96	+	48	GA
gi|514486271|gb|KE346361.1|	561973	561987	AAGG	14	-	3	TCCT
gi|514486271|gb|KE346361.1|	565083	565204	AC	121	+	60	AC
gi|514486271|gb|KE346361.1|	565716	565731	AAAC	15	+	3	AAAC
gi|514486271|gb|KE346361.1|	567143	567164	A	21	-	21	T
gi|514486271|gb|KE346361.1|	569052	569068	AAAAAAT	16	-	2	TTTTATT
gi|514486271|gb|KE346361.1|	569595	569609	AG	14	-	7	TC
gi|514486271|gb|KE346361.1|	569610	569624	AAAGAG	14	-	2	TTCTCT
gi|514486271|gb|KE346361.1|	569856	569871	AACTTC	15	+	2	TTCAAC
gi|514486271|gb|KE346361.1|	570145	570169	AGGCG	24	-	4	CCTCG
gi|514486271|gb|KE346361.1|	570211	570229	AG	18	-	9	TC
gi|514486271|gb|KE346361.1|	570338	570357	AG	19	-	9	CT
gi|514486271|gb|KE346361.1|	570435	570450	ACTC	15	-	3	GAGT
gi|514486271|gb|KE346361.1|	570458	570472	AAGTGAG	14	+	2	AGTGAGA
gi|514486271|gb|KE346361.1|	572400	572416	A	16	+	16	A
gi|514486271|gb|KE346361.1|	575176	575196	AAGAGTG	20	+	2	TGAAGAG
gi|514486271|gb|KE346361.1|	576156	576170	AAAACCC	14	-	2	TTTTGGG
gi|514486271|gb|KE346361.1|	576781	576798	AGC	17	+	5	CAG
gi|514486271|gb|KE346361.1|	577036	577063	AGC	27	+	9	CAG
gi|514486271|gb|KE346361.1|	577195	577218	AGC	23	+	7	CAG
gi|514486271|gb|KE346361.1|	577314	577330	AGC	16	+	5	GCA
gi|514486271|gb|KE346361.1|	577970	577992	AAC	22	+	7	ACA
gi|514486271|gb|KE346361.1|	579574	579600	AAAC	26	+	6	AACA
gi|514486271|gb|KE346361.1|	580353	580372	AG	19	+	9	AG
gi|514486271|gb|KE346361.1|	580950	580964	AGAGCC	14	-	2	TCTGGC
gi|514486271|gb|KE346361.1|	581441	581464	A	23	+	23	A
gi|514486271|gb|KE346361.1|	582431	582446	A	15	-	15	T
gi|514486271|gb|KE346361.1|	583378	583401	AAAC	23	+	5	AAAC
gi|514486271|gb|KE346361.1|	583399	583470	AAAC	71	+	17	AAAC
gi|514486271|gb|KE346361.1|	585002	585021	ACTG	19	-	4	CAGT
gi|514486271|gb|KE346361.1|	588279	588293	AGCGGC	14	+	2	GCAGCG
gi|514486271|gb|KE346361.1|	589938	589953	AC	15	+	7	AC
gi|514486271|gb|KE346361.1|	591323	591337	AGGGGCG	14	+	2	GCGAGGG
gi|514486271|gb|KE346361.1|	593485	593503	AGC	18	-	6	GCT
gi|514486271|gb|KE346361.1|	594203	594223	AAC	20	-	6	TTG
gi|514486271|gb|KE346361.1|	599144	599158	AAACATC	14	-	2	TGTTTGA
gi|514486271|gb|KE346361.1|	599688	599703	ACC	15	+	5	CCA
gi|514486271|gb|KE346361.1|	601775	601800	ATC	25	+	8	TCA
gi|514486271|gb|KE346361.1|	601801	601842	ATC	41	+	13	ATC
gi|514486271|gb|KE346361.1|	604840	604856	AAAAGCC	16	+	2	AAAAGCC
gi|514486271|gb|KE346361.1|	604916	604939	AG	23	+	11	GA
gi|514486271|gb|KE346361.1|	605073	605100	AACC	27	-	6	TGGT
gi|514486271|gb|KE346361.1|	605486	605500	AG	14	+	7	AG
gi|514486271|gb|KE346361.1|	605564	605584	AAGCATC	20	+	2	GCATCAA
gi|514486271|gb|KE346361.1|	605753	605778	ACTGAG	25	-	4	CAGTCT
gi|514486271|gb|KE346361.1|	605855	605869	AG	14	-	7	TC
gi|514486271|gb|KE346361.1|	606041	606055	AGC	14	+	4	CAG
gi|514486271|gb|KE346361.1|	606053	606067	AAC	14	+	4	CAA
gi|514486271|gb|KE346361.1|	606151	606165	AGGGCG	14	-	2	CCTCGC
gi|514486271|gb|KE346361.1|	606219	606236	AGAGCC	17	-	2	TCTGGC
gi|514486271|gb|KE346361.1|	607265	607279	AAAAAAC	14	+	2	AAAAAAC
gi|514486271|gb|KE346361.1|	608366	608390	A	24	-	24	T
gi|514486271|gb|KE346361.1|	608672	608686	ACGATCG	14	+	2	ATCGACG
gi|514486271|gb|KE346361.1|	611049	611069	A	20	+	20	A
gi|514486271|gb|KE346361.1|	611225	611244	A	19	+	19	A
gi|514486271|gb|KE346361.1|	611270	611288	A	18	-	18	T
gi|514486271|gb|KE346361.1|	612878	612892	AAAAAAG	14	-	2	CTTTTTT
gi|514486271|gb|KE346361.1|	613012	613028	AGAGCGC	16	+	2	GCGCAGA
gi|514486271|gb|KE346361.1|	613757	613773	A	16	+	16	A
gi|514486271|gb|KE346361.1|	613834	613848	AAAAG	14	-	2	CTTTT
gi|514486271|gb|KE346361.1|	613866	613884	A	18	-	18	T
gi|514486271|gb|KE346361.1|	614702	614718	AAC	16	+	5	CAA
gi|514486271|gb|KE346361.1|	615315	615329	AACGGCG	14	+	2	CGGCGAA
gi|514486271|gb|KE346361.1|	616095	616110	AAGCAGC	15	+	2	AGCAGCA
gi|514486271|gb|KE346361.1|	616153	616168	AGC	15	+	5	GCA
gi|514486271|gb|KE346361.1|	617371	617387	AC	16	-	8	GT
gi|514486271|gb|KE346361.1|	617836	617859	A	23	-	23	T
gi|514486271|gb|KE346361.1|	618014	618038	AAAAT	24	-	4	TTTTA
gi|514486271|gb|KE346361.1|	618037	618056	AAAAT	19	-	3	TTTTA
gi|514486271|gb|KE346361.1|	618049	618063	AAAAAAT	14	-	2	TTATTTT
gi|514486271|gb|KE346361.1|	618260	618294	A	34	+	34	A
gi|514486271|gb|KE346361.1|	619239	619254	AAAAAC	15	-	2	TTTGTT
gi|514486271|gb|KE346361.1|	619266	619295	AAAC	29	-	7	TTGT
gi|514486271|gb|KE346361.1|	620581	620610	A	29	-	29	T
gi|514486271|gb|KE346361.1|	621178	621201	A	23	+	23	A
gi|514486271|gb|KE346361.1|	621364	621384	AAT	20	-	6	TTA
gi|514486271|gb|KE346361.1|	621596	621616	A	20	+	20	A
gi|514486271|gb|KE346361.1|	621746	621760	AGGGGGG	14	-	2	CCCCTCC
gi|514486271|gb|KE346361.1|	621877	621891	AAAGAG	14	-	2	TCTTTC
gi|514486271|gb|KE346361.1|	622006	622027	AAAAAC	21	-	3	TTTTGT
gi|514486271|gb|KE346361.1|	622022	622036	AAAACCC	14	-	2	GTTTTGG
gi|514486271|gb|KE346361.1|	622253	622269	ACTGCT	16	+	2	ACTGCT
gi|514486271|gb|KE346361.1|	622317	622331	AAAACGC	14	-	2	TTTGCGT
gi|514486271|gb|KE346361.1|	622993	623011	CCG	18	+	6	CCG
gi|514486271|gb|KE346361.1|	623167	623182	CCG	15	+	5	CCG
gi|514486271|gb|KE346361.1|	623318	623332	AAG	14	-	4	TTC
gi|514486271|gb|KE346361.1|	624342	624357	ACGCATC	15	+	2	GCATCAC
gi|514486271|gb|KE346361.1|	624963	624977	AATGCC	14	-	2	GCATTG
gi|514486271|gb|KE346361.1|	628173	628190	ATC	17	+	5	CAT
gi|514486271|gb|KE346361.1|	631939	631953	AAC	14	+	4	AAC
gi|514486271|gb|KE346361.1|	633426	633446	A	20	+	20	A
gi|514486271|gb|KE346361.1|	634245	634273	A	28	+	28	A
gi|514486271|gb|KE346361.1|	634294	634308	A	14	+	14	A
gi|514486271|gb|KE346361.1|	634474	634490	A	16	+	16	A
gi|514486271|gb|KE346361.1|	634688	634708	A	20	+	20	A
gi|514486271|gb|KE346361.1|	635415	635436	A	21	-	21	T
gi|514486271|gb|KE346361.1|	636696	636719	AAAC	23	-	5	GTTT
gi|514486271|gb|KE346361.1|	638261	638283	A	22	-	22	T
gi|514486271|gb|KE346361.1|	638922	638948	AG	26	-	13	CT
gi|514486271|gb|KE346361.1|	639189	639205	ATC	16	-	5	GAT
gi|514486271|gb|KE346361.1|	641124	641144	A	20	+	20	A
gi|514486271|gb|KE346361.1|	641480	641494	A	14	+	14	A
gi|514486271|gb|KE346361.1|	641623	641639	AAAAAG	16	-	2	TTTTTC
gi|514486271|gb|KE346361.1|	641784	641807	A	23	-	23	T
gi|514486271|gb|KE346361.1|	642013	642037	A	24	-	24	T
gi|514486271|gb|KE346361.1|	642120	642136	AAGAAGC	16	-	2	CTTGCTT
gi|514486271|gb|KE346361.1|	642161	642185	AAAAGC	24	-	4	TTTGCT
gi|514486271|gb|KE346361.1|	644195	644210	AATTAC	15	+	2	AATTAC
gi|514486271|gb|KE346361.1|	644454	644468	AAAAG	14	+	2	AAAAG
gi|514486271|gb|KE346361.1|	644695	644714	A	19	-	19	T
gi|514486271|gb|KE346361.1|	644890	644911	ACG	21	+	7	ACG
gi|514486271|gb|KE346361.1|	644984	644998	AG	14	+	7	GA
gi|514486271|gb|KE346361.1|	644999	645106	AG	107	+	53	AG
gi|514486271|gb|KE346361.1|	646002	646027	A	25	-	25	T
gi|514486271|gb|KE346361.1|	646070	646084	AAAAG	14	-	2	CTTTT
gi|514486271|gb|KE346361.1|	646277	646295	AATAGT	18	-	3	ACTATT
gi|514486271|gb|KE346361.1|	647059	647074	ATC	15	-	5	ATG
gi|514486271|gb|KE346361.1|	647292	647312	AGC	20	-	6	TGC
gi|514486271|gb|KE346361.1|	647767	647781	AAC	14	+	4	ACA
gi|514486271|gb|KE346361.1|	648542	648558	AGGATG	16	-	2	CCTCAT
gi|514486271|gb|KE346361.1|	651174	651188	AGCCTGC	14	-	2	CAGGCTG
gi|514486271|gb|KE346361.1|	659068	659083	AGCGCG	15	+	2	GAGCGC
gi|514486271|gb|KE346361.1|	660196	660211	ACG	15	+	5	GAC
gi|514486271|gb|KE346361.1|	662824	662841	AAGGCG	17	+	2	GGCGAA
gi|514486271|gb|KE346361.1|	663580	663597	AGG	17	+	5	GAG
gi|514486271|gb|KE346361.1|	663787	663803	CCG	16	-	5	GGC
gi|514486271|gb|KE346361.1|	664804	664822	ACG	18	+	6	GAC
gi|514486271|gb|KE346361.1|	666403	666417	AC	14	+	7	CA
gi|514486271|gb|KE346361.1|	666600	666614	AAAAAC	14	+	2	AAAACA
gi|514486271|gb|KE346361.1|	667564	667588	ATC	24	-	8	TGA
gi|514486271|gb|KE346361.1|	669011	669034	ACC	23	+	7	CAC
gi|514486271|gb|KE346361.1|	669579	669597	ACC	18	-	6	GGT
gi|514486271|gb|KE346361.1|	670043	670059	AG	16	-	8	CT
gi|514486271|gb|KE346361.1|	671909	671923	AAAC	14	+	3	AACA
gi|514486271|gb|KE346361.1|	671975	672005	AAC	30	-	10	TTG
gi|514486271|gb|KE346361.1|	673321	673335	ACGCAGC	14	+	2	CGCAGCA
gi|514486271|gb|KE346361.1|	674741	674759	CCG	18	+	6	CGC
gi|514486271|gb|KE346361.1|	674775	674791	ATC	16	-	5	GAT
gi|514486271|gb|KE346361.1|	674917	674935	AGC	18	-	6	TGC
gi|514486271|gb|KE346361.1|	674939	674953	ACCATC	14	-	2	GTGATG
gi|514486271|gb|KE346361.1|	675127	675141	A	14	+	14	A
gi|514486271|gb|KE346361.1|	675136	675150	AAAAATC	14	+	2	AAAAATC
gi|514486271|gb|KE346361.1|	675470	675488	AG	18	+	9	GA
gi|514486271|gb|KE346361.1|	675628	675646	AATG	18	-	4	CATT
gi|514486271|gb|KE346361.1|	677818	677834	AAACCC	16	-	2	TTTGGG
gi|514486271|gb|KE346361.1|	678655	678674	ACG	19	-	6	GTC
gi|514486271|gb|KE346361.1|	679093	679109	ACG	16	-	5	GTC
gi|514486271|gb|KE346361.1|	679675	679689	AGC	14	-	4	TGC
gi|514486271|gb|KE346361.1|	680434	680530	AC	96	-	48	GT
gi|514486271|gb|KE346361.1|	680818	680832	ACACAGC	14	+	2	GCACACA
gi|514486271|gb|KE346361.1|	681219	681238	ACC	19	+	6	CCA
gi|514486271|gb|KE346361.1|	681529	681543	AAAAC	14	+	2	AAAAC
gi|514486271|gb|KE346361.1|	681595	681609	A	14	+	14	A
gi|514486271|gb|KE346361.1|	683234	683258	AAAC	24	-	6	TTGT
gi|514486271|gb|KE346361.1|	684944	684969	A	25	-	25	T
gi|514486271|gb|KE346361.1|	685280	685294	ACCGCC	14	-	2	GGCGGT
gi|514486271|gb|KE346361.1|	685377	685391	AATGAC	14	+	2	ATGACA
gi|514486271|gb|KE346361.1|	686741	686766	AGC	25	+	8	CAG
gi|514486271|gb|KE346361.1|	686898	686913	AAC	15	-	5	TTG
gi|514486271|gb|KE346361.1|	687578	687593	AAC	15	+	5	CAA
gi|514486271|gb|KE346361.1|	687821	687844	AAG	23	+	7	AAG
gi|514486271|gb|KE346361.1|	688250	688310	A	60	+	60	A
gi|514486271|gb|KE346361.1|	689508	689528	ACC	20	-	6	GTG
gi|514486271|gb|KE346361.1|	689994	690014	AGG	20	+	6	GAG
gi|514486271|gb|KE346361.1|	690364	690379	ACT	15	-	5	TAG
gi|514486271|gb|KE346361.1|	690461	690482	ATC	21	-	7	TGA
gi|514486271|gb|KE346361.1|	691221	691241	A	20	-	20	T
gi|514486271|gb|KE346361.1|	691373	691390	A	17	+	17	A
gi|514486271|gb|KE346361.1|	691613	691629	A	16	+	16	A
gi|514486271|gb|KE346361.1|	691672	691689	A	17	+	17	A
gi|514486271|gb|KE346361.1|	691851	691870	A	19	+	19	A
gi|514486271|gb|KE346361.1|	692056	692073	AAC	17	+	5	AAC
gi|514486271|gb|KE346361.1|	692071	692095	A	24	+	24	A
gi|514486271|gb|KE346361.1|	692232	692249	AAAAC	17	-	3	TTGTT
gi|514486271|gb|KE346361.1|	693579	693596	AGG	17	-	5	TCC
gi|514486271|gb|KE346361.1|	693834	693856	ACC	22	-	7	TGG
gi|514486271|gb|KE346361.1|	696193	696210	AACAGC	17	+	2	CAGCAA
gi|514486271|gb|KE346361.1|	696205	696229	AGC	24	+	8	CAG
gi|514486271|gb|KE346361.1|	698127	698152	AAGGAG	25	+	4	GAAGGA
gi|514486271|gb|KE346361.1|	700306	700330	AGG	24	+	8	GAG
gi|514486271|gb|KE346361.1|	703179	703196	AGG	17	+	5	AGG
gi|514486271|gb|KE346361.1|	704578	704593	A	15	+	15	A
gi|514486271|gb|KE346361.1|	704816	704831	AGCC	15	+	3	AGCC
gi|514486271|gb|KE346361.1|	705435	705450	AACC	15	+	3	CAAC
gi|514486271|gb|KE346361.1|	706062	706076	AACC	14	+	3	AACC
gi|514486271|gb|KE346361.1|	706708	706722	A	14	+	14	A
gi|514486271|gb|KE346361.1|	706871	706885	ACCTCG	14	-	2	AGGTCG
gi|514486271|gb|KE346361.1|	707143	707157	ATC	14	-	4	TGA
gi|514486271|gb|KE346361.1|	707430	707449	AAAAAAG	19	+	2	AAAAAGA
gi|514486271|gb|KE346361.1|	707443	707458	A	15	+	15	A
gi|514486271|gb|KE346361.1|	707634	707655	A	21	+	21	A
gi|514486271|gb|KE346361.1|	708572	708594	AAAAAT	22	+	3	AAAAAT
gi|514486271|gb|KE346361.1|	708793	708816	AG	23	-	11	CT
gi|514486271|gb|KE346361.1|	709135	709153	AACCC	18	+	3	AACCC
gi|514486271|gb|KE346361.1|	709170	709187	AACTCC	17	+	2	CTCCAA
gi|514486271|gb|KE346361.1|	710916	710930	AGCC	14	+	3	CCAG
gi|514486271|gb|KE346361.1|	712468	712482	AAG	14	-	4	TCT
gi|514486271|gb|KE346361.1|	713010	713026	AACCC	16	-	3	GGGTT
gi|514486271|gb|KE346361.1|	714944	714958	AAC	14	-	4	TGT
gi|514486271|gb|KE346361.1|	715528	715543	ACCCCC	15	+	2	CCACCC
gi|514486271|gb|KE346361.1|	716514	716528	ACCAGC	14	-	2	TGGTGC
gi|514486271|gb|KE346361.1|	717730	717746	AAAAC	16	+	3	AACAA
gi|514486271|gb|KE346361.1|	717769	717783	AAACC	14	+	2	AAACC
gi|514486271|gb|KE346361.1|	717862	717890	AC	28	+	14	AC
gi|514486271|gb|KE346361.1|	719307	719321	AGC	14	+	4	GCA
gi|514486271|gb|KE346361.1|	719845	719892	A	47	+	47	A
gi|514486271|gb|KE346361.1|	719929	719943	AAAAC	14	-	2	TTTTG
gi|514486271|gb|KE346361.1|	722360	722374	ACTCGCG	14	-	2	GCGAGTC
gi|514486271|gb|KE346361.1|	724093	724107	AGATGG	14	-	2	CCATCT
gi|514486271|gb|KE346361.1|	724199	724229	AACGCC	30	-	5	TGGCGT
gi|514486271|gb|KE346361.1|	725630	725657	AACAGC	27	-	4	TGTTGC
gi|514486271|gb|KE346361.1|	725965	725985	ACGATG	20	-	3	TCGTCA
gi|514486271|gb|KE346361.1|	726527	726541	AACAGGC	14	-	2	TTGCCTG
gi|514486271|gb|KE346361.1|	726557	726574	ATC	17	+	5	ATC
gi|514486271|gb|KE346361.1|	727317	727333	ACGCTC	16	+	2	CACGCT
gi|514486271|gb|KE346361.1|	727864	727881	A	17	+	17	A
gi|514486271|gb|KE346361.1|	730486	730502	ACATCC	16	+	2	CATCCA
gi|514486271|gb|KE346361.1|	730503	730517	AC	14	+	7	AC
gi|514486271|gb|KE346361.1|	730875	730890	AATGTG	15	-	2	ACATTC
gi|514486271|gb|KE346361.1|	731002	731023	A	21	-	21	T
gi|514486271|gb|KE346361.1|	731968	731992	AAC	24	+	8	CAA
gi|514486271|gb|KE346361.1|	733224	733240	ACACTC	16	-	2	GTGAGT
gi|514486271|gb|KE346361.1|	733444	733461	AAC	17	+	5	CAA
gi|514486271|gb|KE346361.1|	733459	733477	AGC	18	+	6	CAG
gi|514486271|gb|KE346361.1|	733601	733618	AAGGAC	17	+	2	GACAAG
gi|514486271|gb|KE346361.1|	733628	733648	AAGGAC	20	+	3	GACAAG
gi|514486271|gb|KE346361.1|	733651	733671	AAGGAC	20	+	3	CAAGGA
gi|514486271|gb|KE346361.1|	733734	733752	ACCAGC	18	-	3	CTGGTG
gi|514486271|gb|KE346361.1|	734108	734123	AGG	15	-	5	TCC
gi|514486271|gb|KE346361.1|	734633	734649	AAAAAC	16	-	2	TTTTTG
gi|514486271|gb|KE346361.1|	734653	734669	ACACGC	16	-	2	GTGCGT
gi|514486271|gb|KE346361.1|	734777	734795	ACGATG	18	+	3	GACGAT
gi|514486271|gb|KE346361.1|	734815	734845	AGC	30	+	10	AGC
gi|514486271|gb|KE346361.1|	735314	735335	AGC	21	+	7	GCA
gi|514486271|gb|KE346361.1|	744718	744744	A	26	+	26	A
gi|514486271|gb|KE346361.1|	745285	745307	AGGGGG	22	+	3	GGGGAG
gi|514486271|gb|KE346361.1|	746337	746353	A	16	-	16	T
gi|514486271|gb|KE346361.1|	746558	746572	A	14	+	14	A
gi|514486271|gb|KE346361.1|	749637	749651	A	14	-	14	T
gi|514486271|gb|KE346361.1|	751742	751760	AAAAAG	18	-	3	CTTTTT
gi|514486271|gb|KE346361.1|	751762	751784	AAAAACG	22	-	3	GTTTTTC
gi|514486271|gb|KE346361.1|	752400	752415	A	15	+	15	A
gi|514486271|gb|KE346361.1|	755290	755307	A	17	-	17	T
gi|514486271|gb|KE346361.1|	755309	755324	A	15	-	15	T
gi|514486271|gb|KE346361.1|	755333	755348	AAAC	15	-	3	TTTG
gi|514486271|gb|KE346361.1|	755363	755380	AAAAAAC	17	-	2	TTTGTTT
gi|514486271|gb|KE346361.1|	755967	755982	AATC	15	+	3	CAAT
gi|514486271|gb|KE346361.1|	756345	756361	A	16	-	16	T
gi|514486271|gb|KE346361.1|	756582	756604	A	22	+	22	A
gi|514486271|gb|KE346361.1|	756632	756646	ACTCTC	14	+	2	TCTCAC
gi|514486271|gb|KE346361.1|	756643	756658	ACTCTC	15	+	2	CTCACT
gi|514486271|gb|KE346361.1|	756893	756908	AAT	15	-	5	TAT
gi|514486271|gb|KE346361.1|	760028	760053	A	25	-	25	T
gi|514486271|gb|KE346361.1|	760108	760128	A	20	-	20	T
gi|514486271|gb|KE346361.1|	760758	760775	ACCTCG	17	+	2	CGACCT
gi|514486271|gb|KE346361.1|	762193	762208	AC	15	-	7	TG
gi|514486271|gb|KE346361.1|	762553	762570	ACTGAT	17	+	2	TGATAC
gi|514486271|gb|KE346361.1|	762571	762606	ACTGAT	35	+	5	TGATAC
gi|514486271|gb|KE346361.1|	762607	762625	AGCATC	18	-	3	TGATGC
gi|514486271|gb|KE346361.1|	763488	763523	ATC	35	-	11	TGA
gi|514486271|gb|KE346361.1|	763521	763539	AAC	18	-	6	TGT
gi|514486271|gb|KE346361.1|	764309	764323	ATGCCCC	14	+	2	GCCCCAT
gi|514486271|gb|KE346361.1|	765688	765706	A	18	-	18	T
gi|514486271|gb|KE346361.1|	768909	768925	AAAAGC	16	+	2	AAAAGC
gi|514486271|gb|KE346361.1|	769172	769199	AACAGC	27	-	4	CTGTTG
gi|514486271|gb|KE346361.1|	769209	769223	AGC	14	-	4	TGC
gi|514486271|gb|KE346361.1|	770640	770654	ACG	14	-	4	CGT
gi|514486271|gb|KE346361.1|	771057	771078	AGC	21	+	7	AGC
gi|514486271|gb|KE346361.1|	771549	771564	AGCTCC	15	-	2	CTGGAG
gi|514486271|gb|KE346361.1|	771694	771711	ACAGCC	17	-	2	TGGCTG
gi|514486271|gb|KE346361.1|	771848	771874	A	26	+	26	A
gi|514486271|gb|KE346361.1|	771904	771919	AAACG	15	+	3	ACGAA
gi|514486271|gb|KE346361.1|	772830	772849	A	19	-	19	T
gi|514486271|gb|KE346361.1|	773773	773803	AAC	30	-	10	TTG
gi|514486271|gb|KE346361.1|	774082	774099	AATAGTG	17	-	2	ATTCACT
gi|514486271|gb|KE346361.1|	774475	774491	AACGAC	16	-	2	TCGTTG
gi|514486271|gb|KE346361.1|	774685	774706	A	21	-	21	T
gi|514486271|gb|KE346361.1|	774711	774727	A	16	-	16	T
gi|514486271|gb|KE346361.1|	774970	774987	AACACC	17	+	2	CCAACA
gi|514486271|gb|KE346361.1|	775237	775268	AAG	31	-	10	TCT
gi|514486271|gb|KE346361.1|	775431	775461	A	30	-	30	T
gi|514486271|gb|KE346361.1|	776897	776916	AG	19	-	9	TC
gi|514486271|gb|KE346361.1|	776946	776960	ACACAT	14	-	2	GTATGT
gi|514486271|gb|KE346361.1|	777757	777779	ACTC	22	-	5	GAGT
gi|514486271|gb|KE346361.1|	778061	778076	AAAAAAC	15	+	2	AAAAAAC
gi|514486271|gb|KE346361.1|	778831	778845	A	14	+	14	A
gi|514486271|gb|KE346361.1|	779329	779353	AAAAAGC	24	+	3	AAAGCAA
gi|514486271|gb|KE346361.1|	779591	779606	AAGTCC	15	-	2	GGACTT
gi|514486271|gb|KE346361.1|	781782	781801	AAACG	19	+	3	ACGAA
gi|514486271|gb|KE346361.1|	782226	782244	ACC	18	+	6	CCA
gi|514486271|gb|KE346361.1|	782242	782260	AGC	18	+	6	CAG
gi|514486271|gb|KE346361.1|	782257	782306	AGAGCC	49	+	8	CAGAGC
gi|514486271|gb|KE346361.1|	782376	782399	ACG	23	+	7	GAC
gi|514486271|gb|KE346361.1|	782394	782408	ACGATG	14	+	2	GACGAT
gi|514486271|gb|KE346361.1|	782713	782727	AAAAC	14	+	2	AAAAC
gi|514486271|gb|KE346361.1|	785146	785207	AGC	61	-	20	CTG
gi|514486271|gb|KE346361.1|	787470	787485	ACGGCG	15	-	2	CGTCGC
gi|514486271|gb|KE346361.1|	787480	787497	AACGGC	17	-	2	GCCGTT
gi|514486271|gb|KE346361.1|	787717	787749	ATC	32	-	10	TGA
gi|514486271|gb|KE346361.1|	787899	787918	A	19	+	19	A
gi|514486271|gb|KE346361.1|	788430	788445	ATC	15	+	5	TCA
gi|514486271|gb|KE346361.1|	788447	788470	AGCATC	23	+	3	ATCAGC
gi|514486271|gb|KE346361.1|	788471	788491	AGC	20	+	6	AGC
gi|514486271|gb|KE346361.1|	788583	788597	CCCGCCG	14	+	2	CCGCCGC
gi|514486271|gb|KE346361.1|	789889	789903	AAGAAGC	14	-	2	CTTCTTG
gi|514486271|gb|KE346361.1|	790360	790377	ACGAGG	17	-	2	TCGTCC
gi|514486271|gb|KE346361.1|	792302	792317	AGCG	15	-	3	CTCG
gi|514486271|gb|KE346361.1|	792528	792542	ACTCG	14	-	2	CGAGT
gi|514486271|gb|KE346361.1|	792700	792726	A	26	+	26	A
gi|514486271|gb|KE346361.1|	793478	793492	AACAGC	14	+	2	AACAGC
gi|514486271|gb|KE346361.1|	793587	793601	AAAAAC	14	+	2	AACAAA
gi|514486271|gb|KE346361.1|	793596	793619	A	23	+	23	A
gi|514486271|gb|KE346361.1|	793916	793935	ATCGGC	19	+	3	CATCGG
gi|514486271|gb|KE346361.1|	794130	794146	AAAC	16	+	4	CAAA
gi|514486271|gb|KE346361.1|	794143	794157	A	14	+	14	A
gi|514486271|gb|KE346361.1|	795209	795258	AGC	49	+	16	GCA
gi|514486271|gb|KE346361.1|	795553	795571	AG	18	-	9	TC
gi|514486271|gb|KE346361.1|	795934	795948	AAGGAC	14	+	2	ACAAGG
gi|514486271|gb|KE346361.1|	795958	795972	AAGGAC	14	+	2	ACAAGG
gi|514486271|gb|KE346361.1|	796737	796751	ACATGCC	14	-	2	ATGTGGC
gi|514486271|gb|KE346361.1|	797971	797992	ACCAT	21	+	4	CCATA
gi|514486271|gb|KE346361.1|	799038	799052	AAACGGC	14	+	2	GGCAAAC
gi|514486271|gb|KE346361.1|	799307	799324	ACCAGC	17	-	2	GGTGCT
gi|514486271|gb|KE346361.1|	799604	799619	ACCCCC	15	-	2	GGGGGT
gi|514486271|gb|KE346361.1|	800204	800219	AACAGC	15	-	2	TTGCTG
gi|514486271|gb|KE346361.1|	803468	803483	AAAAG	15	-	3	CTTTT
gi|514486271|gb|KE346361.1|	805159	805175	AGG	16	+	5	AGG
gi|514486271|gb|KE346361.1|	806116	806130	AGC	14	-	4	GCT
gi|514486271|gb|KE346361.1|	807005	807019	AAAC	14	+	3	AACA
gi|514486271|gb|KE346361.1|	807062	807076	AAGGAC	14	-	2	CTTGTC
gi|514486271|gb|KE346361.1|	807954	807969	AAAC	15	+	3	AAAC
gi|514486271|gb|KE346361.1|	808730	808744	ACCAGC	14	+	2	CACCAG
gi|514486271|gb|KE346361.1|	808796	808819	A	23	+	23	A
gi|514486271|gb|KE346361.1|	808921	808935	AAGACG	14	+	2	AAGACG
gi|514486271|gb|KE346361.1|	809355	809383	ACAGAG	28	+	4	GAGACA
gi|514486271|gb|KE346361.1|	809619	809644	A	25	-	25	T
gi|514486271|gb|KE346361.1|	810491	810509	AGAGG	18	+	3	AGGAG
gi|514486271|gb|KE346361.1|	810761	810776	CCG	15	+	5	CGC
gi|514486271|gb|KE346361.1|	810888	810906	AAAAC	18	+	3	AAACA
gi|514486271|gb|KE346361.1|	810902	810916	A	14	+	14	A
gi|514486271|gb|KE346361.1|	811877	811891	AAAG	14	+	3	AAAG
gi|514486271|gb|KE346361.1|	812501	812519	CCG	18	-	6	GGC
gi|514486271|gb|KE346361.1|	812977	812999	AGC	22	+	7	CAG
gi|514486271|gb|KE346361.1|	813315	813329	AACTTCC	14	-	2	AGTTGGA
gi|514486271|gb|KE346361.1|	813332	813351	A	19	+	19	A
gi|514486271|gb|KE346361.1|	814159	814176	ACGATG	17	+	2	GACGAT
gi|514486271|gb|KE346361.1|	814171	814191	ACG	20	+	6	GAC
gi|514486271|gb|KE346361.1|	814645	814661	AGC	16	+	5	AGC
gi|514486271|gb|KE346361.1|	818339	818353	AAAGCG	14	-	2	GCTTTC
gi|514486271|gb|KE346361.1|	818508	818553	A	45	+	45	A
gi|514486271|gb|KE346361.1|	821526	821541	AGCCTG	15	-	2	CAGGCT
gi|514486271|gb|KE346361.1|	828923	828937	AACTCC	14	-	2	TGGAGT
gi|514486271|gb|KE346361.1|	831170	831184	A	14	+	14	A
gi|514486271|gb|KE346361.1|	831888	831904	AC	16	+	8	AC
gi|514486271|gb|KE346361.1|	834295	834310	AGCTCG	15	+	2	TCGAGC
gi|514486271|gb|KE346361.1|	835229	835246	AGG	17	+	5	AGG
gi|514486271|gb|KE346361.1|	835858	835874	AGGCCC	16	+	2	AGGCCC
gi|514486271|gb|KE346361.1|	836752	836769	AAAAAAC	17	-	2	TTTTGTT
gi|514486271|gb|KE346361.1|	837034	837054	ACGATGG	20	-	2	TCCATCG
gi|514486271|gb|KE346361.1|	837077	837097	AAGATGG	20	-	2	TTCCATC
gi|514486271|gb|KE346361.1|	837425	837440	A	15	+	15	A
gi|514486271|gb|KE346361.1|	837452	837472	A	20	-	20	T
gi|514486271|gb|KE346361.1|	837574	837590	AAGGAGG	16	-	2	TCCTTCC
gi|514486271|gb|KE346361.1|	838093	838107	AAAAG	14	+	2	AAAAG
gi|514486271|gb|KE346361.1|	838494	838508	AGATGGC	14	-	2	TGCCATC
gi|514486271|gb|KE346361.1|	842240	842264	ACG	24	+	8	CGA
gi|514486271|gb|KE346361.1|	842268	842286	ATC	18	-	6	GAT
gi|514486271|gb|KE346361.1|	842485	842501	AGC	16	-	5	CTG
gi|514486271|gb|KE346361.1|	846195	846210	ACCGTC	15	-	2	ACGGTG
gi|514486271|gb|KE346361.1|	847154	847168	AACTGG	14	+	2	GGAACT
gi|514486271|gb|KE346361.1|	847678	847693	A	15	+	15	A
gi|514486271|gb|KE346361.1|	847885	847905	A	20	+	20	A
gi|514486271|gb|KE346361.1|	848099	848119	A	20	+	20	A
gi|514486271|gb|KE346361.1|	848282	848296	A	14	+	14	A
gi|514486271|gb|KE346361.1|	848291	848308	AAAAAT	17	+	2	AAAAAT
gi|514486271|gb|KE346361.1|	848669	848683	AAG	14	+	4	GAA
gi|514486271|gb|KE346361.1|	849782	849799	AAAC	17	+	4	ACAA
gi|514486271|gb|KE346361.1|	849806	849828	A	22	+	22	A
gi|514486271|gb|KE346361.1|	850312	850333	A	21	+	21	A
gi|514486271|gb|KE346361.1|	850344	850360	A	16	+	16	A
gi|514486271|gb|KE346361.1|	850615	850633	AC	18	+	9	AC
gi|514486271|gb|KE346361.1|	850676	850690	AAAGCC	14	+	2	AAAGCC
gi|514486271|gb|KE346361.1|	850779	850795	AG	16	-	8	TC
gi|514486271|gb|KE346361.1|	850796	850810	AG	14	-	7	CT
gi|514486271|gb|KE346361.1|	852036	852051	AC	15	-	7	TG
gi|514486271|gb|KE346361.1|	852123	852143	AAAGCC	20	+	3	CCAAAG
gi|514486271|gb|KE346361.1|	852169	852188	A	19	-	19	T
gi|514486271|gb|KE346361.1|	852194	852208	A	14	-	14	T
gi|514486271|gb|KE346361.1|	852219	852233	A	14	-	14	T
gi|514486271|gb|KE346361.1|	855835	855852	ACC	17	-	5	TGG
gi|514486271|gb|KE346361.1|	856076	856094	ACC	18	+	6	CAC
gi|514486271|gb|KE346361.1|	856089	856103	ACCACT	14	+	2	ACCACT
gi|514486271|gb|KE346361.1|	856186	856203	ACGAGG	17	-	2	TCGTCC
gi|514486271|gb|KE346361.1|	856521	856536	ACTGAG	15	+	2	ACTGAG
gi|514486271|gb|KE346361.1|	856575	856590	AATCATC	15	-	2	TGATGAT
gi|514486271|gb|KE346361.1|	856691	856705	AATAGC	14	+	2	AATAGC
gi|514486271|gb|KE346361.1|	857766	857784	AGC	18	-	6	TGC
gi|514486271|gb|KE346361.1|	858037	858053	ACGAGG	16	+	2	GAGGAC
gi|514486271|gb|KE346361.1|	858500	858515	AAACAAC	15	-	2	TTGTTGT
gi|514486271|gb|KE346361.1|	858540	858554	AACAGAC	14	+	2	GACAACA
gi|514486271|gb|KE346361.1|	858589	858603	A	14	+	14	A
gi|514486271|gb|KE346361.1|	858932	858948	AAC	16	+	5	AAC
gi|514486271|gb|KE346361.1|	859127	859142	AGCATC	15	-	2	TGCTGA
gi|514486271|gb|KE346361.1|	859773	859795	A	22	-	22	T
gi|514486271|gb|KE346361.1|	859792	859806	AAACC	14	-	2	TTTGG
gi|514486271|gb|KE346361.1|	860027	860045	AGCCGC	18	-	3	GGCTGC
gi|514486271|gb|KE346361.1|	861705	861720	AAGAGG	15	-	2	CCTCTT
gi|514486271|gb|KE346361.1|	861899	861913	AAAAAG	14	+	2	AAAAAG
gi|514486271|gb|KE346361.1|	862480	862527	AG	47	+	23	GA
gi|514486271|gb|KE346361.1|	862736	862755	AGC	19	-	6	TGC
gi|514486271|gb|KE346361.1|	864077	864094	AC	17	-	8	GT
gi|514486271|gb|KE346361.1|	864361	864378	ATC	17	+	5	CAT
gi|514486271|gb|KE346361.1|	864998	865024	AACTGG	26	+	4	AACTGG
gi|514486271|gb|KE346361.1|	865247	865262	AAACC	15	-	3	GTTTG
gi|514486271|gb|KE346361.1|	865259	865273	AAC	14	-	4	TTG
gi|514486271|gb|KE346361.1|	865646	865669	AGATGC	23	+	3	TGCAGA
gi|514486271|gb|KE346361.1|	866688	866702	AGCTGC	14	+	2	GCTGCA
gi|514486271|gb|KE346361.1|	868796	868819	A	23	+	23	A
gi|514486271|gb|KE346361.1|	871279	871294	AAAAGTC	15	+	2	CAAAAGT
gi|514486271|gb|KE346361.1|	871434	871450	AAC	16	-	5	TGT
gi|514486271|gb|KE346361.1|	872201	872216	AAAAC	15	+	3	CAAAA
gi|514486271|gb|KE346361.1|	873056	873072	AAAAAC	16	+	2	AAACAA
gi|514486271|gb|KE346361.1|	873077	873108	AAAAGC	31	+	5	CAAAAG
gi|514486271|gb|KE346361.1|	873425	873439	AAAAAC	14	+	2	AACAAA
gi|514486271|gb|KE346361.1|	873564	873581	ACAGAG	17	+	2	AGAGAC
gi|514486271|gb|KE346361.1|	873611	873627	AAAAAC	16	+	2	AAAAAC
gi|514486271|gb|KE346361.1|	875034	875054	A	20	-	20	T
gi|514486271|gb|KE346361.1|	875174	875194	AAT	20	-	6	TTA
gi|514486271|gb|KE346361.1|	879535	879551	AACAAGC	16	-	2	TGCTTGT
gi|514486271|gb|KE346361.1|	879545	879559	AAC	14	-	4	TTG
gi|514486271|gb|KE346361.1|	879851	879870	AAG	19	+	6	AGA
gi|514486271|gb|KE346361.1|	879871	879909	AAG	38	+	12	AAG
gi|514486271|gb|KE346361.1|	880328	880349	AAGTGAG	21	+	3	AAGTGAG
gi|514486271|gb|KE346361.1|	880350	880371	AAGTGAG	21	+	3	AGTGAGA
gi|514486271|gb|KE346361.1|	880844	880861	AAGGAGG	17	-	2	CCTCCTT
gi|514486271|gb|KE346361.1|	881128	881142	ACTCC	14	+	2	CTCCA
gi|514486271|gb|KE346361.1|	882867	882881	AGCG	14	-	3	CGCT
gi|514486271|gb|KE346361.1|	883283	883297	ACG	14	-	4	TCG
gi|514486271|gb|KE346361.1|	883427	883441	ACG	14	-	4	TCG
gi|514486271|gb|KE346361.1|	883544	883568	ACG	24	-	8	TCG
gi|514486271|gb|KE346361.1|	884125	884139	AGCATCG	14	+	2	ATCGAGC
gi|514486271|gb|KE346361.1|	884676	884690	AAAC	14	+	3	AAAC
gi|514486271|gb|KE346361.1|	889150	889167	ACTC	17	-	4	GAGT
gi|514486271|gb|KE346361.1|	889303	889333	AGG	30	+	10	GGA
gi|514486271|gb|KE346361.1|	889740	889759	A	19	-	19	T
gi|514486271|gb|KE346361.1|	890048	890062	A	14	+	14	A
gi|514486271|gb|KE346361.1|	890065	890082	A	17	+	17	A
gi|514486271|gb|KE346361.1|	890412	890441	A	29	-	29	T
gi|514486271|gb|KE346361.1|	890652	890669	A	17	-	17	T
gi|514486271|gb|KE346361.1|	890683	890699	A	16	-	16	T
gi|514486271|gb|KE346361.1|	890982	891027	A	45	-	45	T
gi|514486271|gb|KE346361.1|	891892	891983	AG	91	-	45	TC
gi|514486271|gb|KE346361.1|	891984	892001	AG	17	-	8	TC
gi|514486271|gb|KE346361.1|	893401	893415	AAGCC	14	+	2	CCAAG
gi|514486271|gb|KE346361.1|	893866	893880	AAATCCG	14	-	2	TTTCGGA
gi|514486271|gb|KE346361.1|	894130	894146	A	16	+	16	A
gi|514486271|gb|KE346361.1|	894467	894484	ACGGCC	17	-	2	GGCCGT
gi|514486271|gb|KE346361.1|	894981	894995	AGCGGGG	14	-	2	TCCCCGC
gi|514486271|gb|KE346361.1|	895529	895545	AAAAAC	16	-	2	TTTTGT
gi|514486271|gb|KE346361.1|	895837	895851	AAAGTC	14	+	2	AAAGTC
gi|514486271|gb|KE346361.1|	898402	898421	AAATGAT	19	+	2	AATGATA
gi|514486271|gb|KE346361.1|	898523	898540	ACC	17	-	5	TGG
gi|514486271|gb|KE346361.1|	898868	898882	AAGC	14	+	3	CAAG
gi|514486271|gb|KE346361.1|	898904	898930	A	26	+	26	A
gi|514486271|gb|KE346361.1|	898951	898974	A	23	+	23	A
gi|514486271|gb|KE346361.1|	899126	899142	AAGCGAC	16	+	2	GACAAGC
gi|514486271|gb|KE346361.1|	899164	899181	A	17	+	17	A
gi|514486271|gb|KE346361.1|	899690	899704	AGATCG	14	+	2	GATCGA
gi|514486271|gb|KE346361.1|	900827	900844	ACG	17	+	5	GAC
gi|514486271|gb|KE346361.1|	902406	902427	A	21	-	21	T
gi|514486271|gb|KE346361.1|	902421	902437	AAAAAAG	16	-	2	TTTTTTC
gi|514486271|gb|KE346361.1|	902432	902446	AAG	14	-	4	TTC
gi|514486271|gb|KE346361.1|	902600	902616	AG	16	-	8	CT
gi|514486271|gb|KE346361.1|	907579	907594	ACG	15	-	5	GTC
gi|514486271|gb|KE346361.1|	908088	908113	A	25	+	25	A
gi|514486271|gb|KE346361.1|	908159	908178	A	19	+	19	A
gi|514486271|gb|KE346361.1|	908331	908353	A	22	+	22	A
gi|514486271|gb|KE346361.1|	908737	908763	A	26	+	26	A
gi|514486271|gb|KE346361.1|	909578	909592	AATCTGT	14	+	2	AATCTGT
gi|514486271|gb|KE346361.1|	909865	909884	AAAAACC	19	+	2	AAAAACC
gi|514486271|gb|KE346361.1|	911111	911125	AAAGGGG	14	+	2	GGGGAAA
gi|514486271|gb|KE346361.1|	912103	912117	ACACAT	14	+	2	CATACA
gi|514486271|gb|KE346361.1|	912184	912198	ACACAT	14	+	2	CATACA
gi|514486271|gb|KE346361.1|	914978	914992	AAC	14	+	4	CAA
gi|514486271|gb|KE346361.1|	914990	915004	ATC	14	+	4	CAT
gi|514486271|gb|KE346361.1|	915051	915068	AAAGCC	17	+	2	AAAGCC
gi|514486271|gb|KE346361.1|	915378	915396	ACACACG	18	+	2	ACACGAC
gi|514486271|gb|KE346361.1|	915449	915463	AACCAC	14	-	2	GTTGTG
gi|514486271|gb|KE346361.1|	915973	915989	ACC	16	-	5	TGG
gi|514486271|gb|KE346361.1|	916767	916783	A	16	+	16	A
gi|514486271|gb|KE346361.1|	916821	916835	AAAAAAG	14	+	2	AAAAAAG
gi|514486271|gb|KE346361.1|	917155	917185	A	30	+	30	A
gi|514486271|gb|KE346361.1|	917507	917521	AGGG	14	+	3	GGGA
gi|514486271|gb|KE346361.1|	917560	917581	A	21	+	21	A
gi|514486271|gb|KE346361.1|	918324	918347	A	23	-	23	T
gi|514486271|gb|KE346361.1|	919001	919015	AAAAC	14	-	2	TTTTG
gi|514486271|gb|KE346361.1|	919074	919089	AGCGCC	15	+	2	CCAGCG
gi|514486271|gb|KE346361.1|	920341	920360	A	19	-	19	T
gi|514486271|gb|KE346361.1|	924005	924021	AACATGC	16	-	2	ATGTTGC
gi|514486271|gb|KE346361.1|	924331	924349	AAAAC	18	+	3	CAAAA
gi|514486271|gb|KE346361.1|	925141	925156	A	15	+	15	A
gi|514486271|gb|KE346361.1|	925372	925386	AAAAT	14	+	2	AAAAT
gi|514486271|gb|KE346361.1|	925406	925420	ACGAGTG	14	-	2	ACTCGTC
gi|514486271|gb|KE346361.1|	925596	925612	AAAAAAT	16	+	2	AATAAAA
gi|514486271|gb|KE346361.1|	925610	925629	AAAAAAT	19	+	2	AAAAAAT
gi|514486271|gb|KE346361.1|	925622	925640	AAAAAT	18	+	3	ATAAAA
gi|514486271|gb|KE346361.1|	925817	925837	A	20	+	20	A
gi|514486271|gb|KE346361.1|	927531	927554	AG	23	+	11	AG
gi|514486271|gb|KE346361.1|	927658	927687	AATG	29	+	7	GAAT
gi|514486271|gb|KE346361.1|	927976	927990	ACTCATC	14	-	2	GTGATGA
gi|514486271|gb|KE346361.1|	927994	928008	AATCATC	14	-	2	TGATGAT
gi|514486271|gb|KE346361.1|	928003	928017	AATGATG	14	+	2	ATGATGA
gi|514486271|gb|KE346361.1|	928010	928025	ATC	15	-	5	ATG
gi|514486271|gb|KE346361.1|	928109	928123	AGC	14	-	4	CTG
gi|514486271|gb|KE346361.1|	928135	928149	AAGCGC	14	-	2	TGCGCT
gi|514486271|gb|KE346361.1|	928232	928246	CCCGCCG	14	-	2	GGCGGCG
gi|514486271|gb|KE346361.1|	931068	931083	AG	15	-	7	CT
gi|514486271|gb|KE346361.1|	931507	931527	AC	20	+	10	AC
gi|514486271|gb|KE346361.1|	931763	931778	AATCCT	15	+	2	CCTAAT
gi|514486271|gb|KE346361.1|	935481	935499	AAAACAC	18	-	2	GTTTTGT
gi|514486271|gb|KE346361.1|	937560	937575	ACGG	15	+	3	GGAC
gi|514486271|gb|KE346361.1|	938578	938592	ATC	14	-	4	TGA
gi|514486271|gb|KE346361.1|	938812	938833	AAGCGC	21	-	3	TTGCGC
gi|514486271|gb|KE346361.1|	939465	939481	ATC	16	-	5	TGA
gi|514486271|gb|KE346361.1|	939491	939505	AAGGG	14	-	2	CCCTT
gi|514486271|gb|KE346361.1|	940435	940450	AC	15	-	7	TG
gi|514486271|gb|KE346361.1|	940487	940504	A	17	-	17	T
gi|514486271|gb|KE346361.1|	941975	941992	ACCAGC	17	+	2	CAGCAC
gi|514486271|gb|KE346361.1|	942376	942414	AAGTG	38	+	7	TGAAG
gi|514486271|gb|KE346361.1|	942596	942611	AAATCCC	15	-	2	GGGATTT
gi|514486271|gb|KE346361.1|	942680	942696	AACAGC	16	+	2	AACAGC
gi|514486271|gb|KE346361.1|	944978	944992	AAAAAAC	14	+	2	AAAACAA
gi|514486271|gb|KE346361.1|	947084	947107	AAAC	23	+	5	AAAC
gi|514486271|gb|KE346361.1|	947197	947215	AAGAGG	18	-	3	CTCTTC
gi|514486271|gb|KE346361.1|	947585	947599	AGGATGG	14	-	2	ATCCTCC
gi|514486271|gb|KE346361.1|	947766	947784	AAAGCC	18	+	3	CAAAGC
gi|514486271|gb|KE346361.1|	947932	947948	ATC	16	+	5	ATC
gi|514486271|gb|KE346361.1|	949959	949975	AAC	16	+	5	CAA
gi|514486271|gb|KE346361.1|	951351	951365	AGC	14	-	4	GCT
gi|514486271|gb|KE346361.1|	952099	952113	AAAAAAC	14	+	2	AAAACAA
gi|514486271|gb|KE346361.1|	955878	955893	AAGAG	15	+	3	GAGAA
gi|514486271|gb|KE346361.1|	957045	957060	AAAC	15	+	3	CAAA
gi|514486271|gb|KE346361.1|	957257	957282	AGGG	25	+	6	GGGA
gi|514486271|gb|KE346361.1|	958124	958140	AAAAAAG	16	+	2	AAAGAAA
gi|514486271|gb|KE346361.1|	958574	958588	AAAGC	14	+	2	CAAAG
gi|514486271|gb|KE346361.1|	959150	959169	A	19	+	19	A
gi|514486271|gb|KE346361.1|	959909	959924	A	15	+	15	A
gi|514486271|gb|KE346361.1|	959966	959986	AGCC	20	-	5	CTGG
gi|514486271|gb|KE346361.1|	960670	960689	AATACAC	19	-	2	TGTGTAT
gi|514486271|gb|KE346361.1|	961564	961590	AC	26	-	13	TG
gi|514486271|gb|KE346361.1|	961908	961923	A	15	-	15	T
gi|514486271|gb|KE346361.1|	962264	962279	A	15	-	15	T
gi|514486271|gb|KE346361.1|	963787	963803	AAAC	16	+	4	ACAA
gi|514486271|gb|KE346361.1|	963867	963881	AC	14	+	7	CA
gi|514486271|gb|KE346361.1|	964409	964423	AAAAC	14	+	2	AAAAC
gi|514486271|gb|KE346361.1|	964420	964434	AAAAC	14	+	2	AAAAC
gi|514486271|gb|KE346361.1|	964427	964441	AAAAAC	14	+	2	AACAAA
gi|514486271|gb|KE346361.1|	964903	964918	AAAAAC	15	-	2	TTTTTG
gi|514486271|gb|KE346361.1|	964996	965011	AATGTC	15	+	2	GTCAAT
gi|514486271|gb|KE346361.1|	965244	965273	A	29	+	29	A
gi|514486271|gb|KE346361.1|	965555	965570	ACCTCCC	15	-	2	GTGGGAG
gi|514486271|gb|KE346361.1|	965645	965660	ACCACG	15	+	2	CACGAC
gi|514486271|gb|KE346361.1|	966107	966132	AATC	25	+	6	TCAA
gi|514486271|gb|KE346361.1|	967369	967391	A	22	+	22	A
gi|514486271|gb|KE346361.1|	967596	967610	AAAAC	14	+	2	AAAAC
gi|514486271|gb|KE346361.1|	967606	967621	A	15	+	15	A
gi|514486271|gb|KE346361.1|	967664	967688	A	24	-	24	T
gi|514486271|gb|KE346361.1|	968031	968049	AAAAAAG	18	-	2	TTTTTCT
gi|514486271|gb|KE346361.1|	968044	968070	AAAAAAG	26	-	3	TTTTTCT
gi|514486271|gb|KE346361.1|	968064	968078	A	14	-	14	T
gi|514486271|gb|KE346361.1|	968083	968098	AAAT	15	+	3	AAAT
gi|514486271|gb|KE346361.1|	968190	968225	ACAGAG	35	-	5	TCTCTG
gi|514486271|gb|KE346361.1|	968313	968327	AAAAAC	14	-	2	GTTTTT
gi|514486271|gb|KE346361.1|	968333	968348	A	15	-	15	T
gi|514486271|gb|KE346361.1|	968356	968383	AAAC	27	-	6	TTGT
gi|514486271|gb|KE346361.1|	969682	969701	A	19	+	19	A
gi|514486271|gb|KE346361.1|	972898	972918	A	20	-	20	T
gi|514486271|gb|KE346361.1|	973732	973762	A	30	+	30	A
gi|514486271|gb|KE346361.1|	974316	974333	A	17	-	17	T
gi|514486271|gb|KE346361.1|	974516	974531	AAGGCG	15	-	2	GCCTTC
gi|514486271|gb|KE346361.1|	976199	976218	CCG	19	-	6	GGC
gi|514486271|gb|KE346361.1|	977705	977731	AAAAAAG	26	+	3	AAAAAGA
gi|514486271|gb|KE346361.1|	978523	978537	A	14	-	14	T
gi|514486271|gb|KE346361.1|	979013	979029	A	16	-	16	T
gi|514486271|gb|KE346361.1|	979201	979219	A	18	+	18	A
gi|514486271|gb|KE346361.1|	979350	979365	AACTCTC	15	-	2	GAGAGTT
gi|514486271|gb|KE346361.1|	979491	979518	AGCC	27	-	6	TGGC
gi|514486271|gb|KE346361.1|	980162	980182	AAAC	20	-	5	TTTG
gi|514486271|gb|KE346361.1|	981105	981120	A	15	-	15	T
gi|514486271|gb|KE346361.1|	981424	981439	AGCGGC	15	-	2	GCTGCC
gi|514486271|gb|KE346361.1|	981463	981489	AACAGC	26	+	4	CAACAG
gi|514486271|gb|KE346361.1|	981619	981634	AGC	15	-	5	GCT
gi|514486271|gb|KE346361.1|	982039	982053	AAACGAC	14	-	2	GTTTGTC
gi|514486271|gb|KE346361.1|	982245	982262	A	17	-	17	T
gi|514486271|gb|KE346361.1|	983870	983884	AAAAAAC	14	-	2	GTTTTTT
gi|514486271|gb|KE346361.1|	984668	984684	AGCCGC	16	-	2	GCGGCT
gi|514486271|gb|KE346361.1|	984977	984991	AAC	14	+	4	ACA
gi|514486271|gb|KE346361.1|	985043	985058	A	15	+	15	A
gi|514486271|gb|KE346361.1|	986927	986942	AAAC	15	+	3	AACA
gi|514486271|gb|KE346361.1|	987217	987232	AATG	15	+	3	GAAT
gi|514486271|gb|KE346361.1|	987660	987683	AGC	23	-	7	TGC
gi|514486271|gb|KE346361.1|	987919	987935	AG	16	+	8	GA
gi|514486271|gb|KE346361.1|	988160	988190	A	30	+	30	A
gi|514486271|gb|KE346361.1|	988394	988409	AAAAGCG	15	+	2	AGCGAAA
gi|514486271|gb|KE346361.1|	988405	988431	A	26	+	26	A
gi|514486271|gb|KE346361.1|	988450	988464	A	14	+	14	A
gi|514486271|gb|KE346361.1|	988744	988761	AAGGTGC	17	+	2	AGGTGCA
gi|514486271|gb|KE346361.1|	989576	989593	ACG	17	-	5	TCG
gi|514486271|gb|KE346361.1|	990781	990796	AATC	15	+	3	CAAT
gi|514486271|gb|KE346361.1|	994070	994100	ACTGGC	30	+	5	GGCACT
gi|514486271|gb|KE346361.1|	994102	994124	AGCATC	22	+	3	CAGCAT
gi|514486271|gb|KE346361.1|	994365	994381	ACC	16	-	5	TGG
gi|514486271|gb|KE346361.1|	995623	995638	AAAAAC	15	+	2	AAACAA
gi|514486271|gb|KE346361.1|	998000	998020	A	20	+	20	A
gi|514486271|gb|KE346361.1|	998495	998512	AAT	17	+	5	AAT
gi|514486271|gb|KE346361.1|	998910	998924	AAAAG	14	+	2	AAAAG
gi|514486271|gb|KE346361.1|	998920	998934	A	14	+	14	A
gi|514486271|gb|KE346361.1|	999680	999703	A	23	+	23	A
gi|514486271|gb|KE346361.1|	1001579	1001593	AAAAAAC	14	-	2	GTTTTTT
gi|514486271|gb|KE346361.1|	1002169	1002183	ACTCTC	14	-	2	GAGTGA
gi|514486271|gb|KE346361.1|	1002177	1002192	ACATCTC	15	-	2	GTGAGAT
gi|514486271|gb|KE346361.1|	1002408	1002425	ACTGAGG	17	-	2	TCCTCAG
gi|514486271|gb|KE346361.1|	1002519	1002535	ACG	16	+	5	CGA
gi|514486271|gb|KE346361.1|	1002759	1002777	ACATCC	18	+	3	CATCCA
gi|514486271|gb|KE346361.1|	1003313	1003328	A	15	+	15	A
gi|514486271|gb|KE346361.1|	1009357	1009375	AGGCGC	18	+	3	GCAGGC
gi|514486271|gb|KE346361.1|	1009936	1009950	AAAAAAG	14	+	2	GAAAAAA
gi|514486271|gb|KE346361.1|	1010040	1010091	AG	51	-	25	CT
gi|514486271|gb|KE346361.1|	1010103	1010120	AACAGC	17	+	2	AACAGC
gi|514486271|gb|KE346361.1|	1010170	1010184	ATC	14	-	4	ATG
gi|514486271|gb|KE346361.1|	1011729	1011745	ACG	16	+	5	GAC
gi|514486271|gb|KE346361.1|	1011863	1011878	ACC	15	-	5	TGG
gi|514486271|gb|KE346361.1|	1012094	1012109	AAAAAGC	15	+	2	AGCAAAA
gi|514486271|gb|KE346361.1|	1012504	1012520	AAGAG	16	-	3	TTCTC
gi|514486271|gb|KE346361.1|	1012727	1012741	A	14	+	14	A
gi|514486271|gb|KE346361.1|	1012826	1012848	AGAGCG	22	+	3	GAGAGC
gi|514486271|gb|KE346361.1|	1012932	1012953	A	21	-	21	T
gi|514486271|gb|KE346361.1|	1013773	1013795	AGCGCC	22	-	3	CTGGCG
gi|514486271|gb|KE346361.1|	1016410	1016425	ACGGAG	15	+	2	AGACGG
gi|514486271|gb|KE346361.1|	1016789	1016805	CCG	16	+	5	CCG
gi|514486271|gb|KE346361.1|	1016939	1016960	A	21	-	21	T
gi|514486271|gb|KE346361.1|	1017330	1017348	AAAAAG	18	-	3	CTTTTT
gi|514486271|gb|KE346361.1|	1017341	1017356	AAAAAAG	15	-	2	TCTTTTT
gi|514486271|gb|KE346361.1|	1018112	1018126	AAGTCG	14	-	2	TTCGAC
gi|514486271|gb|KE346361.1|	1022604	1022618	ACTCCC	14	+	2	CCACTC
gi|514486271|gb|KE346361.1|	1022896	1022911	A	15	-	15	T
gi|514486271|gb|KE346361.1|	1022945	1022960	A	15	-	15	T
gi|514486271|gb|KE346361.1|	1023181	1023202	A	21	-	21	T
gi|514486271|gb|KE346361.1|	1023839	1023853	AAGC	14	-	3	CTTG
gi|514486271|gb|KE346361.1|	1024591	1024605	ACGAGG	14	+	2	GACGAG
gi|514486271|gb|KE346361.1|	1026566	1026582	ACG	16	-	5	GTC
gi|514486271|gb|KE346361.1|	1027053	1027067	AAATC	14	-	2	TTTGA
gi|514486271|gb|KE346361.1|	1027850	1027872	AC	22	+	11	CA
gi|514486271|gb|KE346361.1|	1028171	1028186	ACAGAG	15	-	2	CTCTGT
gi|514486271|gb|KE346361.1|	1029190	1029204	AAAAC	14	+	2	ACAAA
gi|514486271|gb|KE346361.1|	1029564	1029581	AATGGTC	17	+	2	ATGGTCA
gi|514486271|gb|KE346361.1|	1030327	1030341	ATCCCC	14	-	2	TGGGGA
gi|514486271|gb|KE346361.1|	1032498	1032518	AAC	20	-	6	TTG
gi|514486271|gb|KE346361.1|	1032515	1032533	AACG	18	-	4	GTTC
gi|514486271|gb|KE346361.1|	1032896	1032913	CCG	17	-	5	GCG
gi|514486271|gb|KE346361.1|	1033292	1033313	A	21	-	21	T
gi|514486271|gb|KE346361.1|	1033965	1033981	AC	16	-	8	TG
gi|514486271|gb|KE346361.1|	1034186	1034228	A	42	-	42	T
gi|514486271|gb|KE346361.1|	1034306	1034326	AACAGC	20	-	3	CTGTTG
gi|514486271|gb|KE346361.1|	1034472	1034486	ATC	14	-	4	GAT
gi|514486271|gb|KE346361.1|	1035031	1035046	AAGCGAC	15	+	2	GCGACAA
gi|514486271|gb|KE346361.1|	1035539	1035615	AGC	76	-	25	TGC
gi|514486271|gb|KE346361.1|	1035778	1035792	AAAAAGG	14	-	2	CTTTTTC
gi|514486271|gb|KE346361.1|	1036017	1036033	AAAACC	16	+	2	AACCAA
gi|514486271|gb|KE346361.1|	1037021	1037041	A	20	+	20	A
gi|514486271|gb|KE346361.1|	1037162	1037176	AACCACC	14	-	2	TGGTGGT
gi|514486271|gb|KE346361.1|	1037172	1037186	AACCACC	14	-	2	TGGTGGT
gi|514486271|gb|KE346361.1|	1037249	1037265	AAAAT	16	+	3	ATAAA
gi|514486271|gb|KE346361.1|	1037266	1037280	AAAAT	14	+	2	AAAAT
gi|514486271|gb|KE346361.1|	1037273	1037292	AAAAAT	19	+	3	AATAAA
gi|514486271|gb|KE346361.1|	1037472	1037487	A	15	-	15	T
gi|514486271|gb|KE346361.1|	1037915	1037929	AACATG	14	-	2	TGTTCA
gi|514486271|gb|KE346361.1|	1039700	1039724	AAGGCG	24	+	4	AAGGCG
gi|514486271|gb|KE346361.1|	1039894	1039923	ACAGAG	29	+	4	AGAGAC
gi|514486271|gb|KE346361.1|	1040781	1040799	AG	18	-	9	CT
gi|514486271|gb|KE346361.1|	1041749	1041779	AAC	30	-	10	TTG
gi|514486271|gb|KE346361.1|	1044174	1044189	AGAGGCG	15	-	2	CGCCTCT
gi|514486271|gb|KE346361.1|	1044237	1044256	A	19	-	19	T
gi|514486271|gb|KE346361.1|	1044319	1044333	AGGGGCG	14	-	2	CTCGCCC
gi|514486271|gb|KE346361.1|	1044707	1044730	A	23	-	23	T
gi|514486271|gb|KE346361.1|	1044922	1044936	AAAAT	14	-	2	TTTTA
gi|514486271|gb|KE346361.1|	1045093	1045107	A	14	-	14	T
gi|514486271|gb|KE346361.1|	1045280	1045296	A	16	+	16	A
gi|514486271|gb|KE346361.1|	1045337	1045352	AAAAAAT	15	-	2	TTATTTT
gi|514486271|gb|KE346361.1|	1045353	1045371	AAAAAAT	18	-	2	TTTTTAT
gi|514486271|gb|KE346361.1|	1045372	1045390	AAAAAAT	18	-	2	TTTTTAT
gi|514486271|gb|KE346361.1|	1045458	1045474	AACAGC	16	-	2	GTTGCT
gi|514486271|gb|KE346361.1|	1045594	1045611	AAAAAC	17	-	2	TTGTTT
gi|514486271|gb|KE346361.1|	1045627	1045648	AAAAAC	21	-	3	TTTGTT
gi|514486271|gb|KE346361.1|	1045657	1045679	A	22	-	22	T
gi|514486271|gb|KE346361.1|	1046024	1046039	A	15	-	15	T
gi|514486271|gb|KE346361.1|	1046436	1046451	AAAAAAC	15	-	2	TTTTTGT
gi|514486271|gb|KE346361.1|	1046452	1046469	A	17	-	17	T
gi|514486271|gb|KE346361.1|	1047080	1047097	AAAAAC	17	-	2	TTTTTG
gi|514486271|gb|KE346361.1|	1047388	1047406	AC	18	-	9	TG
gi|514486271|gb|KE346361.1|	1047640	1047655	AAC	15	-	5	TGT
gi|514486271|gb|KE346361.1|	1048431	1048448	A	17	-	17	T
gi|514486271|gb|KE346361.1|	1048470	1048484	AAC	14	-	4	TTG
gi|514486271|gb|KE346361.1|	1048993	1049042	AG	49	-	24	TC
gi|514486271|gb|KE346361.1|	1049043	1049057	AG	14	-	7	TC
gi|514486271|gb|KE346361.1|	1049189	1049205	AAACG	16	+	3	ACGAA
gi|514486271|gb|KE346361.1|	1049748	1049764	AGCCTAT	16	-	2	CTATAGG
gi|514486271|gb|KE346361.1|	1050692	1050708	AGC	16	-	5	GCT
gi|514486271|gb|KE346361.1|	1050706	1050720	AAC	14	-	4	TGT
gi|514486271|gb|KE346361.1|	1050727	1050744	AAC	17	-	5	TGT
gi|514486271|gb|KE346361.1|	1053591	1053608	AT	17	+	8	TA
gi|514486271|gb|KE346361.1|	1053607	1053631	AC	24	-	12	TG
gi|514486271|gb|KE346361.1|	1053794	1053810	ACT	16	-	5	GTA
gi|514486271|gb|KE346361.1|	1053934	1053954	ACG	20	+	6	CGA
gi|514486271|gb|KE346361.1|	1054168	1054184	CCG	16	-	5	CGG
gi|514486271|gb|KE346361.1|	1054239	1054253	A	14	+	14	A
gi|514486271|gb|KE346361.1|	1054266	1054285	A	19	+	19	A
gi|514486271|gb|KE346361.1|	1054901	1054952	A	51	+	51	A
gi|514486271|gb|KE346361.1|	1055038	1055052	AGATCGG	14	-	2	CCGATCT
gi|514486271|gb|KE346361.1|	1055517	1055531	ACCCCC	14	-	2	GGGTGG
gi|514486271|gb|KE346361.1|	1058461	1058475	ACCCCC	14	+	2	CCCCAC
gi|514486271|gb|KE346361.1|	1063227	1063241	A	14	+	14	A
gi|514486271|gb|KE346361.1|	1063542	1063556	AAACCCC	14	-	2	GGGGTTT
gi|514486271|gb|KE346361.1|	1064864	1064879	AACAGC	15	+	2	CAACAG
gi|514486271|gb|KE346361.1|	1066444	1066459	AAAAC	15	+	3	CAAAA
gi|514486271|gb|KE346361.1|	1066944	1066958	AAAAG	14	+	2	AAAAG
gi|514486271|gb|KE346361.1|	1067288	1067305	AGCCGC	17	+	2	CAGCCG
gi|514486271|gb|KE346361.1|	1067306	1067322	AGCCGC	16	+	2	CAGCCG
gi|514486271|gb|KE346361.1|	1069747	1069766	AAAAAAC	19	+	2	AAAAAAC
gi|514486271|gb|KE346361.1|	1070360	1070375	AAAAC	15	+	3	AAAAC
gi|514486271|gb|KE346361.1|	1070384	1070405	AC	21	+	10	AC
gi|514486271|gb|KE346361.1|	1071154	1071168	AC	14	+	7	AC
gi|514486271|gb|KE346361.1|	1072806	1072821	AGGGGGG	15	+	2	GGGGGAG
gi|514486271|gb|KE346361.1|	1072921	1072936	AGC	15	+	5	AGC
gi|514486271|gb|KE346361.1|	1073026	1073049	AGAGGG	23	+	3	GAGAGG
gi|514486271|gb|KE346361.1|	1073314	1073328	ACACACC	14	+	2	CACACAC
gi|514486271|gb|KE346361.1|	1073321	1073389	AC	68	+	34	CA
gi|514486271|gb|KE346361.1|	1073689	1073705	AAAATG	16	-	2	TTTTCA
gi|514486271|gb|KE346361.1|	1074578	1074592	ACCCAT	14	+	2	CCATAC
gi|514486271|gb|KE346361.1|	1074632	1074649	ACC	17	+	5	CCA
gi|514486271|gb|KE346361.1|	1076980	1076995	ACATGC	15	+	2	ATGCAC
gi|514486271|gb|KE346361.1|	1078532	1078551	AAGCACG	19	-	2	TGCTTCG
gi|514486271|gb|KE346361.1|	1078903	1078918	AAGAGGG	15	-	2	CTCTTCC
gi|514486271|gb|KE346361.1|	1078982	1078999	AACAGC	17	+	2	CAACAG
gi|514486271|gb|KE346361.1|	1080403	1080441	AG	38	+	19	AG
gi|514486271|gb|KE346361.1|	1081198	1081214	AAAAAAG	16	+	2	AAGAAAA
gi|514486271|gb|KE346361.1|	1081870	1081890	A	20	-	20	T
gi|514486271|gb|KE346361.1|	1082116	1082134	AGC	18	-	6	GCT
gi|514486271|gb|KE346361.1|	1082127	1082144	AAGCAGC	17	-	2	TGCTGCT
gi|514486271|gb|KE346361.1|	1082477	1082492	AAACAAC	15	+	2	ACAAACA
gi|514486271|gb|KE346361.1|	1082518	1082535	AAAAAT	17	-	2	TTTTTA
gi|514486271|gb|KE346361.1|	1082528	1082543	AAAAAAT	15	-	2	TATTTTT
gi|514486271|gb|KE346361.1|	1082698	1082713	A	15	-	15	T
gi|514486271|gb|KE346361.1|	1086770	1086784	AGCGGC	14	-	2	GCCGCT
gi|514486271|gb|KE346361.1|	1086779	1086803	AGC	24	-	8	GCT
gi|514486271|gb|KE346361.1|	1087298	1087313	ACGATG	15	+	2	TGACGA
gi|514486271|gb|KE346361.1|	1087506	1087528	ACG	22	-	7	GTC
gi|514486271|gb|KE346361.1|	1087614	1087634	ATCGCC	20	+	3	CCATCG
gi|514486271|gb|KE346361.1|	1087669	1087694	ACAGGC	25	-	4	GTGCCT
gi|514486271|gb|KE346361.1|	1088541	1088556	ACCACG	15	+	2	CGACCA
gi|514486271|gb|KE346361.1|	1090167	1090182	AAAGTGC	15	-	2	CTTTGCA
gi|514486271|gb|KE346361.1|	1093485	1093499	AAGCAG	14	+	2	AGAAGC
gi|514486271|gb|KE346361.1|	1094747	1094766	ATC	19	-	6	GAT
gi|514486271|gb|KE346361.1|	1095184	1095202	AAAG	18	+	4	GAAA
gi|514486271|gb|KE346361.1|	1096951	1096970	AAGAG	19	+	3	AAGAG
gi|514486271|gb|KE346361.1|	1097663	1097678	CCG	15	-	5	GCG
gi|514486271|gb|KE346361.1|	1098144	1098164	AAAAAAG	20	+	2	AAAAAAG
gi|514486271|gb|KE346361.1|	1098425	1098439	AACTGAG	14	-	2	TCTCAGT
gi|514486271|gb|KE346361.1|	1098451	1098465	AACTGAG	14	-	2	TCTCAGT
gi|514486271|gb|KE346361.1|	1098769	1098784	ACG	15	+	5	CGA
gi|514486271|gb|KE346361.1|	1098932	1098948	ACCG	16	+	4	CGAC
gi|514486271|gb|KE346361.1|	1099171	1099186	ACG	15	+	5	CGA
gi|514486271|gb|KE346361.1|	1099946	1099960	AAGATG	14	+	2	GAAGAT
gi|514486271|gb|KE346361.1|	1099964	1099978	AGGATG	14	+	2	GATGAG
gi|514486271|gb|KE346361.1|	1101746	1101761	A	15	-	15	T
gi|514486271|gb|KE346361.1|	1101885	1101899	A	14	-	14	T
gi|514486271|gb|KE346361.1|	1103469	1103486	AC	17	+	8	CA
gi|514486271|gb|KE346361.1|	1104200	1104214	ACTATC	14	-	2	GTGATA
gi|514486271|gb|KE346361.1|	1104933	1104949	AAG	16	-	5	TCT
gi|514486271|gb|KE346361.1|	1107411	1107425	ATCATG	14	+	2	TGATCA
gi|514486271|gb|KE346361.1|	1107655	1107676	AAC	21	+	7	CAA
gi|514486271|gb|KE346361.1|	1107680	1107699	AAACAAG	19	+	2	AGAAACA
gi|514486271|gb|KE346361.1|	1110472	1110487	AAACCC	15	+	2	CCCAAA
gi|514486271|gb|KE346361.1|	1112951	1112965	AGAGCG	14	+	2	CGAGAG
gi|514486271|gb|KE346361.1|	1117182	1117196	AGAGCC	14	+	2	CCAGAG
gi|514486271|gb|KE346361.1|	1117549	1117563	AACCAGC	14	-	2	CTGGTTG
gi|514486271|gb|KE346361.1|	1123451	1123466	AGC	15	-	5	TGC
gi|514486271|gb|KE346361.1|	1124274	1124288	AACAGC	14	-	2	TGTTGC
gi|514486271|gb|KE346361.1|	1124303	1124323	AACAGC	20	-	3	TGTTGC
gi|514486271|gb|KE346361.1|	1124333	1124348	AACAGC	15	-	2	TGCTGT
gi|514486271|gb|KE346361.1|	1124522	1124536	AGCCGC	14	-	2	GCGGCT
gi|514486271|gb|KE346361.1|	1125488	1125502	AAC	14	-	4	GTT
gi|514486271|gb|KE346361.1|	1127272	1127292	ACG	20	+	6	CGA
gi|514486271|gb|KE346361.1|	1127435	1127449	CCG	14	-	4	GCG
gi|514486271|gb|KE346361.1|	1127584	1127604	CCG	20	+	6	GCC
gi|514486271|gb|KE346361.1|	1127697	1127711	AGC	14	+	4	CAG
gi|514486271|gb|KE346361.1|	1127831	1127845	ACCATC	14	-	2	TGATGG
gi|514486271|gb|KE346361.1|	1128015	1128029	AAAAG	14	+	2	AGAAA
gi|514486271|gb|KE346361.1|	1128443	1128457	ACCTGC	14	-	2	GGTGCA
gi|514486271|gb|KE346361.1|	1128829	1128844	ACCGGCC	15	+	2	CGGCCAC
gi|514486271|gb|KE346361.1|	1131392	1131408	ACG	16	+	5	GAC
gi|514486271|gb|KE346361.1|	1132237	1132272	AGC	35	+	11	AGC
gi|514486271|gb|KE346361.1|	1137021	1137040	ATC	19	+	6	CAT
gi|514486271|gb|KE346361.1|	1138189	1138206	ACACAG	17	-	2	CTGTGT
gi|514486271|gb|KE346361.1|	1138226	1138243	AAC	17	-	5	TGT
gi|514486271|gb|KE346361.1|	1138241	1138258	AGC	17	-	5	TGC
gi|514486271|gb|KE346361.1|	1140369	1140383	AAGTGAC	14	+	2	AGTGACA
gi|514486271|gb|KE346361.1|	1145395	1145413	AGC	18	+	6	GCA
gi|514486271|gb|KE346361.1|	1145819	1145842	AGC	23	+	7	GCA
gi|514486271|gb|KE346361.1|	1146942	1146956	AAAACG	14	-	2	TCGTTT
gi|514486271|gb|KE346361.1|	1147511	1147525	A	14	+	14	A
gi|514486271|gb|KE346361.1|	1148333	1148354	AAACC	21	-	4	TTGGT
gi|514486271|gb|KE346361.1|	1148680	1148698	AAAAAC	18	-	3	TGTTTT
gi|514486271|gb|KE346361.1|	1150863	1150877	AAAC	14	-	3	GTTT
gi|514486271|gb|KE346361.1|	1150878	1150893	AAAC	15	-	3	TGTT
gi|514486271|gb|KE346361.1|	1153751	1153765	AGCCGC	14	-	2	GCGGCT
gi|514486271|gb|KE346361.1|	1157466	1157481	AAAGGGT	15	-	2	CTTTACC
gi|514486271|gb|KE346361.1|	1158166	1158187	AGC	21	-	7	TGC
gi|514486271|gb|KE346361.1|	1159477	1159493	AAC	16	-	5	TGT
gi|514486271|gb|KE346361.1|	1159646	1159665	A	19	-	19	T
gi|514486271|gb|KE346361.1|	1159663	1159680	AAC	17	-	5	TTG
gi|514486271|gb|KE346361.1|	1159743	1159757	AATCTAC	14	-	2	GATTGTA
gi|514486271|gb|KE346361.1|	1160777	1160792	A	15	-	15	T
gi|514486271|gb|KE346361.1|	1162846	1162863	AG	17	+	8	AG
gi|514486271|gb|KE346361.1|	1163087	1163101	AGC	14	+	4	GCA
gi|514486271|gb|KE346361.1|	1163240	1163254	AC	14	+	7	AC
gi|514486271|gb|KE346361.1|	1163484	1163509	AACAGAC	25	+	3	ACAGACA
gi|514486271|gb|KE346361.1|	1163683	1163701	AC	18	-	9	TG
gi|514486271|gb|KE346361.1|	1164683	1164712	ATCC	29	-	7	GGAT
gi|514486271|gb|KE346361.1|	1165424	1165447	AGC	23	+	7	CAG
gi|514486271|gb|KE346361.1|	1166466	1166481	AAC	15	+	5	ACA
gi|514486271|gb|KE346361.1|	1166479	1166495	AGC	16	+	5	CAG
gi|514486271|gb|KE346361.1|	1168390	1168405	A	15	-	15	T
gi|514486271|gb|KE346361.1|	1168717	1168731	A	14	-	14	T
gi|514486271|gb|KE346361.1|	1170225	1170244	AAAAAAT	19	-	2	TTTTTTA
gi|514486271|gb|KE346361.1|	1170476	1170490	AAGAGTG	14	+	2	GAGTGAA
gi|514486271|gb|KE346361.1|	1170506	1170533	ACAGTCC	27	-	3	TGTGGAC
gi|514486271|gb|KE346361.1|	1170930	1170954	AGC	24	+	8	CAG
gi|514486271|gb|KE346361.1|	1171141	1171155	AATCAG	14	-	2	TCTGAT
gi|514486271|gb|KE346361.1|	1171150	1171164	AATCCG	14	-	2	GATTCG
gi|514486271|gb|KE346361.1|	1171824	1171838	AAAAAC	14	-	2	TTTGTT
gi|514486271|gb|KE346361.1|	1172120	1172139	A	19	-	19	T
gi|514486271|gb|KE346361.1|	1172226	1172242	ATC	16	+	5	CAT
gi|514486271|gb|KE346361.1|	1172237	1172257	ACGATG	20	-	3	TCATCG
gi|514486271|gb|KE346361.1|	1172494	1172508	AACAGC	14	+	2	CAGCAA
gi|514486271|gb|KE346361.1|	1172700	1172722	AGC	22	-	7	CTG
gi|514486271|gb|KE346361.1|	1175556	1175570	AAAAAC	14	-	2	TTTTTG
gi|514486271|gb|KE346361.1|	1175743	1175769	A	26	-	26	T
gi|514486271|gb|KE346361.1|	1175786	1175800	A	14	-	14	T
gi|514486271|gb|KE346361.1|	1175810	1175824	A	14	-	14	T
gi|514486271|gb|KE346361.1|	1175992	1176036	A	44	-	44	T
gi|514486271|gb|KE346361.1|	1176101	1176115	AGC	14	+	4	GCA
gi|514486271|gb|KE346361.1|	1176201	1176216	AGCAGG	15	+	2	AGCAGG
gi|514486271|gb|KE346361.1|	1176256	1176273	AGCAGG	17	+	2	AGCAGG
gi|514486271|gb|KE346361.1|	1176699	1176720	ACG	21	-	7	CGT
gi|514486271|gb|KE346361.1|	1177066	1177080	AGCTGC	14	+	2	GCAGCT
gi|514486271|gb|KE346361.1|	1179678	1179693	ACGAGG	15	+	2	ACGAGG
gi|514486271|gb|KE346361.1|	1180314	1180331	ACCGCC	17	+	2	CCGCCA
gi|514486271|gb|KE346361.1|	1180326	1180346	CCG	20	+	6	CCG
gi|514486271|gb|KE346361.1|	1181253	1181269	A	16	+	16	A
gi|514486271|gb|KE346361.1|	1181658	1181689	AAGCAG	31	-	5	TCTGCT
gi|514486271|gb|KE346361.1|	1181735	1181751	AAGAGC	16	-	2	CTCTTG
gi|514486271|gb|KE346361.1|	1182077	1182092	AAAC	15	+	3	AAAC
gi|514486271|gb|KE346361.1|	1183953	1183990	A	37	-	37	T
gi|514486271|gb|KE346361.1|	1184083	1184106	ACAG	23	-	5	TCTG
gi|514486271|gb|KE346361.1|	1184139	1184154	AGCCGC	15	+	2	CAGCCG
gi|514486271|gb|KE346361.1|	1184295	1184311	AGC	16	-	5	CTG
gi|514486271|gb|KE346361.1|	1184339	1184357	AGCTCG	18	+	3	TCGAGC
gi|514486271|gb|KE346361.1|	1184512	1184529	ATC	17	-	5	GAT
gi|514486271|gb|KE346361.1|	1184619	1184633	AG	14	+	7	AG
gi|514486271|gb|KE346361.1|	1184726	1184740	AAAATCG	14	-	2	TTCGATT
gi|514486271|gb|KE346361.1|	1184931	1184945	AGC	14	+	4	CAG
gi|514486271|gb|KE346361.1|	1185426	1185440	ACC	14	+	4	CAC
gi|514486271|gb|KE346361.1|	1186956	1186970	A	14	-	14	T
gi|514486271|gb|KE346361.1|	1187517	1187533	ACATG	16	+	3	GACAT
gi|514486271|gb|KE346361.1|	1188863	1188879	AAAC	16	+	4	AAAC
gi|514486271|gb|KE346361.1|	1190003	1190033	AGC	30	-	10	CTG
gi|514486271|gb|KE346361.1|	1191746	1191760	AAAGTGC	14	+	2	TGCAAAG
gi|514486271|gb|KE346361.1|	1191763	1191777	AAAAAAC	14	-	2	TGTTTTT
gi|514486271|gb|KE346361.1|	1191902	1191940	A	38	-	38	T
gi|514486271|gb|KE346361.1|	1192001	1192015	AC	14	-	7	TG
gi|514486271|gb|KE346361.1|	1192249	1192278	A	29	+	29	A
gi|514486271|gb|KE346361.1|	1192294	1192324	A	30	-	30	T
gi|514486271|gb|KE346361.1|	1192611	1192634	AGAGGG	23	+	3	GGGAGA
gi|514486271|gb|KE346361.1|	1192672	1192696	A	24	+	24	A
gi|514486271|gb|KE346361.1|	1192885	1192899	AAAGG	14	-	2	CCTTT
gi|514486271|gb|KE346361.1|	1193408	1193437	A	29	+	29	A
gi|514486271|gb|KE346361.1|	1193459	1193477	AAAAT	18	+	3	AAAAT
gi|514486271|gb|KE346361.1|	1194345	1194359	ATC	14	+	4	ATC
gi|514486271|gb|KE346361.1|	1194708	1194735	AACCACC	27	+	3	ACCACCA
gi|514486271|gb|KE346361.1|	1194820	1194834	A	14	-	14	T
gi|514486271|gb|KE346361.1|	1194922	1194937	ACGGCG	15	+	2	ACGGCG
gi|514486271|gb|KE346361.1|	1195612	1195626	AAGACCC	14	+	2	CCCAAGA
gi|514486271|gb|KE346361.1|	1196494	1196518	A	24	-	24	T
gi|514486271|gb|KE346361.1|	1196577	1196596	AAGGGGG	19	-	2	CCCCCTT
gi|514486271|gb|KE346361.1|	1196592	1196614	AAGGGGG	22	-	3	CCCCCTT
gi|514486271|gb|KE346361.1|	1197468	1197482	A	14	-	14	T
gi|514486271|gb|KE346361.1|	1198024	1198053	A	29	+	29	A
gi|514486271|gb|KE346361.1|	1198252	1198287	A	35	+	35	A
gi|514486271|gb|KE346361.1|	1198365	1198380	AAAAAAT	15	-	2	TATTTTT
gi|514486271|gb|KE346361.1|	1198416	1198431	AAAAAAT	15	-	2	TTTTATT
gi|514486271|gb|KE346361.1|	1198612	1198632	AAAAC	20	+	4	CAAAA
gi|514486271|gb|KE346361.1|	1198664	1198682	A	18	-	18	T
gi|514486271|gb|KE346361.1|	1198886	1198907	AGGATG	21	-	3	TCCTCA
gi|514486271|gb|KE346361.1|	1198909	1198923	ATC	14	+	4	TCA
gi|514486271|gb|KE346361.1|	1199542	1199559	A	17	-	17	T
gi|514486271|gb|KE346361.1|	1201001	1201017	A	16	-	16	T
gi|514486271|gb|KE346361.1|	1201027	1201047	A	20	-	20	T
gi|514486271|gb|KE346361.1|	1201266	1201286	A	20	-	20	T
gi|514486271|gb|KE346361.1|	1201463	1201484	A	21	-	21	T
gi|514486271|gb|KE346361.1|	1201502	1201523	A	21	-	21	T
gi|514486271|gb|KE346361.1|	1201704	1201720	A	16	-	16	T
gi|514486271|gb|KE346361.1|	1201746	1201771	A	25	-	25	T
gi|514486271|gb|KE346361.1|	1201926	1201949	ACGG	23	-	5	CGTC
gi|514486271|gb|KE346361.1|	1202387	1202401	ACG	14	-	4	TCG
gi|514486271|gb|KE346361.1|	1203481	1203495	AAAGTCC	14	-	2	GACTTTG
gi|514486271|gb|KE346361.1|	1203720	1203741	AG	21	-	10	TC
gi|514486271|gb|KE346361.1|	1203990	1204006	AAC	16	-	5	GTT
gi|514486271|gb|KE346361.1|	1204240	1204261	AGCTCC	21	+	3	CCAGCT
gi|514486271|gb|KE346361.1|	1204435	1204449	ACAGGC	14	+	2	GCACAG
gi|514486271|gb|KE346361.1|	1204519	1204533	CCG	14	+	4	GCC
gi|514486271|gb|KE346361.1|	1204542	1204563	AGC	21	-	7	TGC
gi|514486271|gb|KE346361.1|	1204582	1204600	AGGATC	18	+	3	GGATCA
gi|514486271|gb|KE346361.1|	1205914	1205935	ACG	21	-	7	TCG
gi|514486271|gb|KE346361.1|	1206025	1206039	ACTGATC	14	-	2	GTGATCA
gi|514486271|gb|KE346361.1|	1206932	1206946	AATGCAG	14	-	2	CATTCTG
gi|514486271|gb|KE346361.1|	1208534	1208548	AAACAGC	14	+	2	AACAGCA
gi|514486271|gb|KE346361.1|	1212275	1212289	AACCCC	14	-	2	TGGGGT
gi|514486271|gb|KE346361.1|	1212909	1212928	AAAAG	19	+	3	AAAAG
gi|514486271|gb|KE346361.1|	1217546	1217560	AGAGG	14	+	2	GAGGA
gi|514486271|gb|KE346361.1|	1217775	1217789	AAAACTC	14	-	2	TGAGTTT
gi|514486271|gb|KE346361.1|	1217866	1217880	ACTG	14	-	3	TCAG
gi|514486271|gb|KE346361.1|	1218120	1218135	ACGGCC	15	+	2	CACGGC
gi|514486271|gb|KE346361.1|	1218226	1218248	AAAAGC	22	+	3	AGCAAA
gi|514486271|gb|KE346361.1|	1218272	1218296	A	24	-	24	T
gi|514486271|gb|KE346361.1|	1220686	1220700	AACCATC	14	-	2	GTTGATG
gi|514486271|gb|KE346361.1|	1220906	1220925	ACTCGG	19	-	3	GTCCGA
gi|514486271|gb|KE346361.1|	1221078	1221094	ACGCGG	16	+	2	GACGCG
gi|514486271|gb|KE346361.1|	1221561	1221588	AGC	27	+	9	AGC
gi|514486271|gb|KE346361.1|	1222073	1222087	AAGACG	14	+	2	AGACGA
gi|514486271|gb|KE346361.1|	1223252	1223315	AGC	63	+	21	AGC
gi|514486271|gb|KE346361.1|	1223616	1223636	AAC	20	-	6	TTG
gi|514486271|gb|KE346361.1|	1223716	1223743	A	27	-	27	T
gi|514486271|gb|KE346361.1|	1224160	1224174	AGCATC	14	-	2	TGATGC
gi|514486271|gb|KE346361.1|	1224721	1224742	AAAAAAC	21	-	3	TTTTTTG
gi|514486271|gb|KE346361.1|	1226738	1226752	AAC	14	+	4	ACA
gi|514486271|gb|KE346361.1|	1226753	1226772	AAC	19	+	6	ACA
gi|514486271|gb|KE346361.1|	1228294	1228312	AAC	18	+	6	ACA
gi|514486271|gb|KE346361.1|	1228826	1228842	AAAC	16	+	4	AACA
gi|514486271|gb|KE346361.1|	1229488	1229503	AACG	15	+	3	CGAA
gi|514486271|gb|KE346361.1|	1229700	1229714	AAATG	14	-	2	TTTCA
gi|514486271|gb|KE346361.1|	1229780	1229799	AATG	19	+	4	TGAA
gi|514486271|gb|KE346361.1|	1229800	1229819	AATG	19	+	4	TGAA
gi|514486271|gb|KE346361.1|	1229906	1229930	AG	24	-	12	CT
gi|514486271|gb|KE346361.1|	1230229	1230248	ACG	19	+	6	CGA
gi|514486271|gb|KE346361.1|	1231620	1231636	ATGGCCC	16	-	2	TGGGCCA
gi|514486271|gb|KE346361.1|	1234520	1234536	AAGC	16	-	4	TTGC
gi|514486271|gb|KE346361.1|	1235462	1235478	ACTCTG	16	-	2	GAGTCA
gi|514486271|gb|KE346361.1|	1236796	1236814	AC	18	+	9	AC
gi|514486271|gb|KE346361.1|	1238731	1238746	ACGATG	15	-	2	GTCATC
gi|514486271|gb|KE346361.1|	1239263	1239281	ACTG	18	-	4	CAGT
gi|514486271|gb|KE346361.1|	1239281	1239305	ACTG	24	-	6	AGTC
gi|514486271|gb|KE346361.1|	1239527	1239543	AACAAT	16	+	2	TAACAA
gi|514486271|gb|KE346361.1|	1239542	1239556	AGCTC	14	-	2	CTGAG
gi|514486271|gb|KE346361.1|	1240697	1240716	ACC	19	-	6	GGT
gi|514486271|gb|KE346361.1|	1240736	1240750	AATGTG	14	+	2	TGAATG
gi|514486271|gb|KE346361.1|	1241065	1241086	ACG	21	-	7	CGT
gi|514486271|gb|KE346361.1|	1241952	1241967	A	15	-	15	T
gi|514486271|gb|KE346361.1|	1242270	1242285	AACG	15	+	3	GAAC
gi|514486271|gb|KE346361.1|	1243097	1243111	A	14	+	14	A
gi|514486271|gb|KE346361.1|	1243832	1243846	ACGCGCG	14	-	2	GTCGCGC
gi|514486271|gb|KE346361.1|	1244800	1244815	AAAC	15	+	3	AAAC
gi|514486271|gb|KE346361.1|	1245512	1245528	A	16	+	16	A
gi|514486271|gb|KE346361.1|	1245946	1245963	AG	17	+	8	GA
gi|514486271|gb|KE346361.1|	1246054	1246075	AGGCATC	21	-	3	CTGATGC
gi|514486271|gb|KE346361.1|	1246689	1246718	AGC	29	-	9	TGC
gi|514486271|gb|KE346361.1|	1248178	1248194	A	16	+	16	A
gi|514486271|gb|KE346361.1|	1249140	1249163	AGC	23	+	7	AGC
gi|514486271|gb|KE346361.1|	1250605	1250641	AC	36	+	18	CA
gi|514486271|gb|KE346361.1|	1251280	1251453	AG	173	-	86	TC
gi|514486271|gb|KE346361.1|	1251456	1251486	AG	30	-	15	TC
gi|514486271|gb|KE346361.1|	1251487	1251503	AG	16	-	8	CT
gi|514486271|gb|KE346361.1|	1252084	1252104	ATC	20	-	6	TGA
gi|514486271|gb|KE346361.1|	1252316	1252334	AGCCGC	18	-	3	TGCGGC
gi|514486271|gb|KE346361.1|	1252394	1252414	AAC	20	-	6	TTG
gi|514486271|gb|KE346361.1|	1253449	1253484	A	35	+	35	A
gi|514486271|gb|KE346361.1|	1254238	1254254	A	16	+	16	A
gi|514486271|gb|KE346361.1|	1256010	1256025	AAGGTGC	15	-	2	TGCACCT
gi|514486271|gb|KE346361.1|	1260047	1260061	A	14	+	14	A
gi|514486271|gb|KE346361.1|	1260863	1260878	A	15	-	15	T
gi|514486271|gb|KE346361.1|	1260880	1260895	A	15	-	15	T
gi|514486271|gb|KE346361.1|	1260985	1260999	AGAGG	14	-	2	CCTCT
gi|514486271|gb|KE346361.1|	1260993	1261013	ACTCCTC	20	+	2	CTCCTCA
gi|514486271|gb|KE346361.1|	1261143	1261158	ACGC	15	+	3	CACG
gi|514486271|gb|KE346361.1|	1261902	1261917	A	15	+	15	A
gi|514486271|gb|KE346361.1|	1266054	1266068	AAGCTC	14	-	2	TGAGCT
gi|514486271|gb|KE346361.1|	1266132	1266146	ATCCGC	14	-	2	TGCGGA
gi|514486271|gb|KE346361.1|	1267834	1267854	AGAGG	20	+	4	AGAGG
gi|514486271|gb|KE346361.1|	1268219	1268237	A	18	+	18	A
gi|514486271|gb|KE346361.1|	1268281	1268301	AAAAAT	20	+	3	AATAAA
gi|514486271|gb|KE346361.1|	1268681	1268696	AAAAT	15	+	3	AAAAT
gi|514486271|gb|KE346361.1|	1268733	1268748	AAAAAAC	15	-	2	TGTTTTT
gi|514486271|gb|KE346361.1|	1269288	1269303	A	15	-	15	T
gi|514486271|gb|KE346361.1|	1269470	1269486	AAAAAAT	16	+	2	AAATAAA
gi|514486271|gb|KE346361.1|	1269500	1269514	A	14	-	14	T
gi|514486271|gb|KE346361.1|	1270126	1270140	AAATCAC	14	-	2	TGTGATT
gi|514486271|gb|KE346361.1|	1270187	1270204	AG	17	-	8	CT
gi|514486271|gb|KE346361.1|	1270205	1270219	AG	14	-	7	CT
gi|514486271|gb|KE346361.1|	1270334	1270348	AAAAAG	14	-	2	CTTTTT
gi|514486271|gb|KE346361.1|	1270527	1270543	AACACC	16	+	2	AACACC
gi|514486271|gb|KE346361.1|	1271956	1271970	AGCAGCC	14	-	2	TGGCTGC
gi|514486271|gb|KE346361.1|	1272142	1272161	AAAAC	19	+	3	CAAAA
gi|514486271|gb|KE346361.1|	1272205	1272219	AAAAC	14	+	2	ACAAA
gi|514486271|gb|KE346361.1|	1272285	1272302	AAAC	17	+	4	ACAA
gi|514486271|gb|KE346361.1|	1273566	1273586	ACG	20	+	6	GAC
gi|514486271|gb|KE346361.1|	1274668	1274682	ACCGCC	14	+	2	CGCCAC
gi|514486271|gb|KE346361.1|	1275615	1275630	ACGAGG	15	+	2	GACGAG
gi|514486271|gb|KE346361.1|	1275713	1275731	ATC	18	-	6	TGA
gi|514486271|gb|KE346361.1|	1275976	1275992	A	16	+	16	A
gi|514486271|gb|KE346361.1|	1276014	1276032	AAC	18	-	6	TTG
gi|514486271|gb|KE346361.1|	1276033	1276047	AAGC	14	-	3	TTGC
gi|514486271|gb|KE346361.1|	1278043	1278067	AAAC	24	+	6	CAAA
gi|514486271|gb|KE346361.1|	1278060	1278074	AAAAAAC	14	+	2	AAACAAA
gi|514486271|gb|KE346361.1|	1278282	1278296	A	14	+	14	A
gi|514486271|gb|KE346361.1|	1278659	1278673	AGCTCG	14	+	2	GAGCTC
gi|514486271|gb|KE346361.1|	1281255	1281278	AACAGC	23	-	3	TGTTGC
gi|514486271|gb|KE346361.1|	1281273	1281287	AAC	14	-	4	TGT
gi|514486271|gb|KE346361.1|	1282708	1282725	AGC	17	+	5	CAG
gi|514486271|gb|KE346361.1|	1282849	1282868	AGC	19	+	6	CAG
gi|514486271|gb|KE346361.1|	1282941	1282957	ACTGGC	16	-	2	CCAGTG
gi|514486271|gb|KE346361.1|	1282956	1282976	CCG	20	+	6	GCC
gi|514486271|gb|KE346361.1|	1283082	1283096	AAC	14	-	4	GTT
gi|514486271|gb|KE346361.1|	1283127	1283143	CCG	16	+	5	GCC
gi|514486271|gb|KE346361.1|	1283284	1283303	AGCAGG	19	-	3	CTGCTC
gi|514486271|gb|KE346361.1|	1285618	1285632	AAAC	14	+	3	AAAC
gi|514486271|gb|KE346361.1|	1286089	1286105	AC	16	+	8	CA
gi|514486271|gb|KE346361.1|	1287232	1287246	AAAAG	14	+	2	AAAAG
gi|514486271|gb|KE346361.1|	1287537	1287552	AAAAACC	15	+	2	ACCAAAA
gi|514486271|gb|KE346361.1|	1287597	1287611	AGCGCC	14	+	2	CGCCAG
gi|514486271|gb|KE346361.1|	1288200	1288218	A	18	-	18	T
gi|514486271|gb|KE346361.1|	1288313	1288327	AAGAATG	14	+	2	TGAAGAA
gi|514486271|gb|KE346361.1|	1288428	1288448	ACAG	20	-	5	CTGT
gi|514486271|gb|KE346361.1|	1289617	1289632	AATGCAC	15	+	2	CACAATG
gi|514486271|gb|KE346361.1|	1289764	1289779	A	15	-	15	T
gi|514486271|gb|KE346361.1|	1290860	1290883	ACT	23	+	7	CTA
gi|514486271|gb|KE346361.1|	1292483	1292498	AGCGCC	15	+	2	CAGCGC
gi|514486271|gb|KE346361.1|	1292499	1292526	ACG	27	-	9	GTC
gi|514486271|gb|KE346361.1|	1293225	1293293	ACG	68	-	22	GTC
gi|514486271|gb|KE346361.1|	1293337	1293387	ACG	50	-	16	GTC
gi|514486271|gb|KE346361.1|	1293497	1293511	AGCCGC	14	+	2	GCAGCC
gi|514486271|gb|KE346361.1|	1294313	1294327	A	14	-	14	T
gi|514486271|gb|KE346361.1|	1294513	1294531	ACCAGT	18	+	3	ACCAGT
gi|514486271|gb|KE346361.1|	1295010	1295026	AGCCCG	16	+	2	CGAGCC
gi|514486271|gb|KE346361.1|	1295063	1295089	AACAGC	26	-	4	TGCTGT
gi|514486271|gb|KE346361.1|	1295425	1295440	AG	15	-	7	TC
gi|514486271|gb|KE346361.1|	1297393	1297416	AAAAC	23	+	4	AAAAC
gi|514486271|gb|KE346361.1|	1298237	1298251	A	14	+	14	A
gi|514486271|gb|KE346361.1|	1298283	1298301	A	18	+	18	A
gi|514486271|gb|KE346361.1|	1298407	1298424	ATC	17	-	5	GAT
gi|514486271|gb|KE346361.1|	1299075	1299089	AATGGT	14	+	2	GTAATG
gi|514486271|gb|KE346361.1|	1299141	1299160	AC	19	+	9	CA
gi|514486271|gb|KE346361.1|	1299409	1299429	ATC	20	+	6	CAT
gi|514486271|gb|KE346361.1|	1301039	1301065	A	26	-	26	T
gi|514486271|gb|KE346361.1|	1301209	1301224	AAAC	15	+	3	ACAA
gi|514486271|gb|KE346361.1|	1301767	1301781	AACCGAC	14	+	2	CAACCGA
gi|514486271|gb|KE346361.1|	1303430	1303444	ACG	14	+	4	GAC
gi|514486271|gb|KE346361.1|	1303635	1303649	ACTGAGC	14	-	2	GCTCAGT
gi|514486271|gb|KE346361.1|	1308047	1308062	AAAC	15	-	3	TTTG
gi|514486271|gb|KE346361.1|	1308360	1308380	A	20	-	20	T
gi|514486271|gb|KE346361.1|	1308521	1308537	ACTC	16	+	4	TCAC
gi|514486271|gb|KE346361.1|	1308694	1308711	ACTC	17	+	4	CACT
gi|514486271|gb|KE346361.1|	1308986	1309000	AAATCC	14	-	2	TGGATT
gi|514486271|gb|KE346361.1|	1309927	1309942	AAGACC	15	+	2	CAAGAC
gi|514486271|gb|KE346361.1|	1310153	1310167	ACGATG	14	-	2	TCGTCA
gi|514486271|gb|KE346361.1|	1310907	1310928	AGCGGG	21	-	3	CCCGCT
gi|514486271|gb|KE346361.1|	1311484	1311498	AC	14	+	7	CA
gi|514486271|gb|KE346361.1|	1311496	1311510	ATGC	14	+	3	CATG
gi|514486271|gb|KE346361.1|	1313240	1313256	AC	16	-	8	GT
gi|514486271|gb|KE346361.1|	1313550	1313567	AGCCTCG	17	+	2	AGCCTCG
gi|514486271|gb|KE346361.1|	1313756	1313778	ACAG	22	-	5	GTCT
gi|514486271|gb|KE346361.1|	1313779	1313793	ACAG	14	-	3	TGTC
gi|514486271|gb|KE346361.1|	1313795	1313809	AAACG	14	-	2	CGTTT
gi|514486271|gb|KE346361.1|	1314593	1314610	AGGGG	17	-	3	CCCCT
gi|514486271|gb|KE346361.1|	1315384	1315398	ACCATC	14	+	2	CATCAC
gi|514486271|gb|KE346361.1|	1315399	1315413	ACCATC	14	+	2	CATCAC
gi|514486271|gb|KE346361.1|	1315468	1315484	AGC	16	+	5	CAG
gi|514486271|gb|KE346361.1|	1315625	1315640	AACTCAG	15	+	2	AGAACTC
gi|514486271|gb|KE346361.1|	1317286	1317312	ACCCAG	26	-	4	TCTGGG
gi|514486271|gb|KE346361.1|	1317326	1317340	AGC	14	+	4	AGC
gi|514486271|gb|KE346361.1|	1317376	1317394	AGC	18	-	6	GCT
gi|514486271|gb|KE346361.1|	1317834	1317850	AGC	16	+	5	CAG
gi|514486271|gb|KE346361.1|	1319013	1319027	AAGTCTC	14	-	2	GAGACTT
gi|514486271|gb|KE346361.1|	1320257	1320274	AAAAAC	17	+	2	ACAAAA
gi|514486271|gb|KE346361.1|	1320689	1320713	A	24	+	24	A
gi|514486271|gb|KE346361.1|	1323211	1323239	A	28	+	28	A
gi|514486271|gb|KE346361.1|	1323236	1323250	AAAG	14	+	3	AAAG
gi|514486271|gb|KE346361.1|	1323428	1323460	A	32	-	32	T
gi|514486271|gb|KE346361.1|	1323722	1323737	ACAG	15	+	3	ACAG
gi|514486271|gb|KE346361.1|	1323812	1323826	AAAAT	14	-	2	TTTTA
gi|514486271|gb|KE346361.1|	1323975	1323998	AGCGGC	23	+	3	GCGGCA
gi|514486271|gb|KE346361.1|	1324782	1324813	ATCC	31	+	7	CCAT
gi|514486271|gb|KE346361.1|	1324941	1324959	AC	18	+	9	CA
gi|514486271|gb|KE346361.1|	1325263	1325285	A	22	-	22	T
gi|514486271|gb|KE346361.1|	1326712	1326726	A	14	-	14	T
gi|514486271|gb|KE346361.1|	1327819	1327834	AAAAC	15	-	3	GTTTT
gi|514486271|gb|KE346361.1|	1328580	1328815	AG	235	+	117	AG
gi|514486271|gb|KE346361.1|	1330214	1330228	AG	14	-	7	TC
gi|514486271|gb|KE346361.1|	1334754	1334769	ACGGCC	15	+	2	GGCCAC
gi|514486271|gb|KE346361.1|	1334821	1334836	CCG	15	-	5	GCG
gi|514486271|gb|KE346361.1|	1336459	1336473	ACTCG	14	+	2	TCGAC
gi|514486271|gb|KE346361.1|	1336718	1336733	AGCAGG	15	+	2	AGCAGG
gi|514486271|gb|KE346361.1|	1337534	1337555	AGC	21	-	7	CTG
gi|514486271|gb|KE346361.1|	1337994	1338009	AAC	15	+	5	CAA
gi|514486271|gb|KE346361.1|	1340416	1340430	ACTCAG	14	-	2	GAGTCT
gi|514486271|gb|KE346361.1|	1340519	1340539	ACCTCG	20	+	3	TCGACC
gi|514486271|gb|KE346361.1|	1340597	1340614	ACC	17	-	5	TGG
gi|514486271|gb|KE346361.1|	1340737	1340752	AAGTCC	15	+	2	CCAAGT
gi|514486271|gb|KE346361.1|	1340918	1340934	ACG	16	-	5	GTC
gi|514486271|gb|KE346361.1|	1341089	1341103	CCGCCGG	14	-	2	GCCGGCG
gi|514486271|gb|KE346361.1|	1344397	1344411	AATCATC	14	+	2	ATCATCA
gi|514486271|gb|KE346361.1|	1344563	1344577	AAACAGC	14	-	2	CTGTTTG
gi|514486271|gb|KE346361.1|	1346306	1346321	ACTC	15	-	3	GAGT
gi|514486271|gb|KE346361.1|	1346326	1346343	ACTC	17	-	4	GTGA
gi|514486271|gb|KE346361.1|	1346367	1346383	A	16	-	16	T
gi|514486271|gb|KE346361.1|	1347192	1347215	AAT	23	-	7	TTA
gi|514486271|gb|KE346361.1|	1347334	1347367	AG	33	-	16	TC
gi|514486271|gb|KE346361.1|	1347410	1347424	AAACAAC	14	-	2	GTTTGTT
gi|514486271|gb|KE346361.1|	1347447	1347473	ACCTG	26	+	5	CCTGA
gi|514486271|gb|KE346361.1|	1348067	1348093	AACAGC	26	+	4	GCAACA
gi|514486271|gb|KE346361.1|	1348229	1348243	CCG	14	-	4	GCG
gi|514486271|gb|KE346361.1|	1348328	1348348	AAC	20	+	6	ACA
gi|514486271|gb|KE346361.1|	1348525	1348548	A	23	-	23	T
gi|514486271|gb|KE346361.1|	1348856	1348872	AAAATC	16	-	2	TTTTGA
gi|514486271|gb|KE346361.1|	1350246	1350261	A	15	-	15	T
gi|514486271|gb|KE346361.1|	1350262	1350277	A	15	-	15	T
gi|514486271|gb|KE346361.1|	1350748	1350762	A	14	-	14	T
gi|514486271|gb|KE346361.1|	1351414	1351428	AAC	14	-	4	TTG
gi|514486271|gb|KE346361.1|	1355261	1355290	AAAC	29	+	7	AAAC
gi|514486271|gb|KE346361.1|	1355391	1355418	A	27	+	27	A
gi|514486271|gb|KE346361.1|	1355794	1355820	A	26	-	26	T
gi|514486271|gb|KE346361.1|	1355922	1355938	ACCCATC	16	+	2	CCCATCA
gi|514486271|gb|KE346361.1|	1356367	1356382	ACTC	15	+	3	CTCA
gi|514486271|gb|KE346361.1|	1356435	1356450	A	15	-	15	T
gi|514486271|gb|KE346361.1|	1356677	1356695	ACG	18	-	6	TCG
gi|514486271|gb|KE346361.1|	1357227	1357434	AG	207	+	103	GA
gi|514486271|gb|KE346361.1|	1361250	1361266	A	16	-	16	T
gi|514486271|gb|KE346361.1|	1363474	1363488	AAAAAC	14	+	2	AAAAAC
gi|514486271|gb|KE346361.1|	1364306	1364320	AAAAAAC	14	+	2	CAAAAAA
gi|514486271|gb|KE346361.1|	1364319	1364339	AAC	20	+	6	AAC
gi|514486271|gb|KE346361.1|	1364337	1364352	A	15	+	15	A
gi|514486271|gb|KE346361.1|	1364987	1365001	AAC	14	-	4	TGT
gi|514486271|gb|KE346361.1|	1365645	1365665	AG	20	+	10	AG
gi|514486271|gb|KE346361.1|	1365925	1365949	A	24	+	24	A
gi|514486271|gb|KE346361.1|	1365974	1366004	AG	30	+	15	AG
gi|514486271|gb|KE346361.1|	1366345	1366360	ATCCC	15	-	3	GGATG
gi|514486271|gb|KE346361.1|	1368414	1368440	A	26	+	26	A
gi|514486271|gb|KE346361.1|	1369771	1369785	AAAAAC	14	+	2	AACAAA
gi|514486271|gb|KE346361.1|	1369816	1369843	AAAAAC	27	+	4	AAAACA
gi|514486271|gb|KE346361.1|	1370181	1370195	AACCACC	14	-	2	TGGTGGT
gi|514486271|gb|KE346361.1|	1371693	1371715	AAGGAC	22	+	3	AAGGAC
gi|514486271|gb|KE346361.1|	1371996	1372020	AC	24	+	12	AC
gi|514486271|gb|KE346361.1|	1372157	1372171	ACG	14	+	4	GAC
gi|514486271|gb|KE346361.1|	1373185	1373205	A	20	-	20	T
gi|514486271|gb|KE346361.1|	1374419	1374444	AGGATG	25	+	4	TGAGGA
gi|514486271|gb|KE346361.1|	1374547	1374571	ATC	24	-	8	TGA
gi|514486271|gb|KE346361.1|	1378533	1378547	ACTGAG	14	+	2	GACTGA
gi|514486271|gb|KE346361.1|	1378736	1378756	AGC	20	-	6	CTG
gi|514486271|gb|KE346361.1|	1380404	1380418	AAAAACC	14	-	2	GGTTTTT
gi|514486271|gb|KE346361.1|	1380551	1380568	A	17	-	17	T
gi|514486271|gb|KE346361.1|	1381046	1381065	AG	19	-	9	TC
gi|514486271|gb|KE346361.1|	1383100	1383341	AG	241	+	120	AG
gi|514486271|gb|KE346361.1|	1383355	1383374	AAAAC	19	+	3	AAAAC
gi|514486271|gb|KE346361.1|	1387702	1387716	AAAAAAC	14	+	2	AACAAAA
gi|514486271|gb|KE346361.1|	1388802	1388816	AAC	14	+	4	AAC
gi|514486271|gb|KE346361.1|	1388811	1388831	AAAAAC	20	+	3	AACAAA
gi|514486271|gb|KE346361.1|	1388830	1388846	AAACAAC	16	+	2	AACAAAC
gi|514486271|gb|KE346361.1|	1388839	1388863	AAAC	24	+	6	CAAA
gi|514486271|gb|KE346361.1|	1388860	1388877	A	17	+	17	A
gi|514486271|gb|KE346361.1|	1389673	1389703	A	30	+	30	A
gi|514486271|gb|KE346361.1|	1390026	1390041	AAGGGGG	15	+	2	GGGGGAA
gi|514486271|gb|KE346361.1|	1390298	1390324	AACGCTC	26	+	3	GCTCAAC
gi|514486271|gb|KE346361.1|	1390490	1390509	ATC	19	+	6	ATC
gi|514486271|gb|KE346361.1|	1390871	1390885	AG	14	+	7	AG
gi|514486271|gb|KE346361.1|	1393635	1393664	AG	29	+	14	AG
gi|514486271|gb|KE346361.1|	1393795	1393809	ACGACGG	14	+	2	GACGACG
gi|514486271|gb|KE346361.1|	1393982	1394003	A	21	-	21	T
gi|514486271|gb|KE346361.1|	1396395	1396409	AGAGGCT	14	+	2	GAGGCTA
gi|514486271|gb|KE346361.1|	1402103	1402120	ATCATG	17	+	2	ATCATG
gi|514486271|gb|KE346361.1|	1402433	1402448	AACATC	15	+	2	TCAACA
gi|514486271|gb|KE346361.1|	1402499	1402525	A	26	-	26	T
gi|514486271|gb|KE346361.1|	1403478	1403492	CCCCCCG	14	+	2	GCCCCCC
gi|514486271|gb|KE346361.1|	1404523	1404540	AAC	17	-	5	TTG
gi|514486271|gb|KE346361.1|	1404535	1404549	AAAC	14	-	3	TTGT
gi|514486271|gb|KE346361.1|	1407018	1407033	AG	15	+	7	AG
gi|514486271|gb|KE346361.1|	1407322	1407351	A	29	+	29	A
gi|514486271|gb|KE346361.1|	1407894	1407910	AAC	16	+	5	CAA
gi|514486271|gb|KE346361.1|	1408559	1408573	ATC	14	-	4	TGA
gi|514486271|gb|KE346361.1|	1408803	1408820	AAGACAG	17	-	2	GTCTTCT
gi|514486271|gb|KE346361.1|	1409024	1409043	AGC	19	-	6	CTG
gi|514486271|gb|KE346361.1|	1409199	1409215	AG	16	-	8	CT
gi|514486271|gb|KE346361.1|	1409208	1409222	AAGAGAG	14	-	2	TCTCTCT
gi|514486271|gb|KE346361.1|	1409276	1409302	ATC	26	+	8	ATC
gi|514486271|gb|KE346361.1|	1409307	1409323	AGGGGC	16	-	2	CCCCTG
gi|514486271|gb|KE346361.1|	1411124	1411138	AAC	14	+	4	AAC
gi|514486271|gb|KE346361.1|	1414901	1414921	A	20	+	20	A
gi|514486271|gb|KE346361.1|	1415135	1415157	A	22	-	22	T
gi|514486271|gb|KE346361.1|	1415188	1415208	AGG	20	-	6	CTC
gi|514486271|gb|KE346361.1|	1415208	1415222	AG	14	-	7	TC
gi|514486271|gb|KE346361.1|	1415236	1415316	AG	80	-	40	TC
gi|514486271|gb|KE346361.1|	1419202	1419218	AGGATC	16	+	2	GATCAG
gi|514486271|gb|KE346361.1|	1421436	1421450	AGGCCCG	14	+	2	AGGCCCG
gi|514486271|gb|KE346361.1|	1422265	1422279	A	14	-	14	T
gi|514486271|gb|KE346361.1|	1422333	1422348	AGGGGGG	15	-	2	CCTCCCC
gi|514486271|gb|KE346361.1|	1422607	1422621	ACGATG	14	+	2	GATGAC
gi|514486271|gb|KE346361.1|	1423315	1423330	AC	15	-	7	TG
gi|514486271|gb|KE346361.1|	1425207	1425224	AAGC	17	-	4	TGCT
gi|514486271|gb|KE346361.1|	1427840	1427854	AGC	14	-	4	CTG
gi|514486271|gb|KE346361.1|	1427885	1427900	AACAGC	15	+	2	ACAGCA
gi|514486271|gb|KE346361.1|	1428050	1428064	AAATGCG	14	-	2	CGCATTT
gi|514486271|gb|KE346361.1|	1430896	1430913	AAC	17	-	5	TGT
gi|514486271|gb|KE346361.1|	1430980	1430994	AACAGC	14	-	2	TGCTGT
gi|514486271|gb|KE346361.1|	1432192	1432209	ATCGGC	17	+	2	GCATCG
gi|514486271|gb|KE346361.1|	1432204	1432225	AGCATC	21	+	3	GCATCA
gi|514486271|gb|KE346361.1|	1432577	1432594	A	17	-	17	T
gi|514486271|gb|KE346361.1|	1433470	1433604	AG	134	-	67	CT
gi|514486271|gb|KE346361.1|	1433639	1433654	AG	15	+	7	GA
gi|514486271|gb|KE346361.1|	1433654	1433668	AAG	14	+	4	GAA
gi|514486271|gb|KE346361.1|	1433675	1433690	AAGCGAG	15	+	2	AAGCGAG
gi|514486271|gb|KE346361.1|	1433712	1433733	A	21	+	21	A
gi|514486271|gb|KE346361.1|	1434226	1434244	AGCGGC	18	-	3	CTGCCG
gi|514486271|gb|KE346361.1|	1434516	1434530	AGAGCG	14	-	2	TCTCGC
gi|514486271|gb|KE346361.1|	1435105	1435125	A	20	-	20	T
gi|514486271|gb|KE346361.1|	1435127	1435142	AAAAAC	15	-	2	TTTGTT
gi|514486271|gb|KE346361.1|	1435137	1435168	A	31	-	31	T
gi|514486271|gb|KE346361.1|	1435865	1435880	AGCGATG	15	+	2	ATGAGCG
gi|514486271|gb|KE346361.1|	1438656	1438671	AGC	15	-	5	TGC
gi|514486271|gb|KE346361.1|	1438669	1438686	CCG	17	+	5	GCC
gi|514486271|gb|KE346361.1|	1439270	1439285	AC	15	+	7	AC
gi|514486271|gb|KE346361.1|	1439476	1439493	AAGGAC	17	-	2	CTTGTC
gi|514486271|gb|KE346361.1|	1440883	1440900	A	17	-	17	T
gi|514486271|gb|KE346361.1|	1441067	1441111	A	44	-	44	T
gi|514486271|gb|KE346361.1|	1441134	1441157	A	23	-	23	T
gi|514486271|gb|KE346361.1|	1441177	1441202	AAACGGG	25	-	3	CCCGTTT
gi|514486271|gb|KE346361.1|	1441418	1441432	AC	14	+	7	CA
gi|514486271|gb|KE346361.1|	1442024	1442039	AAAC	15	+	3	AACA
gi|514486271|gb|KE346361.1|	1443212	1443243	AAC	31	-	10	TTG
gi|514486271|gb|KE346361.1|	1444446	1444461	AAACAAC	15	-	2	TGTTTGT
gi|514486271|gb|KE346361.1|	1444854	1444868	CCG	14	-	4	CGG
gi|514486271|gb|KE346361.1|	1448372	1448386	AAAAC	14	-	2	TTTTG
gi|514486271|gb|KE346361.1|	1448706	1448729	A	23	-	23	T
gi|514486271|gb|KE346361.1|	1449215	1449231	AGATGC	16	-	2	CATCTG
gi|514486271|gb|KE346361.1|	1453659	1453676	A	17	+	17	A
gi|514486271|gb|KE346361.1|	1453692	1453707	AAAG	15	+	3	AAAG
gi|514486271|gb|KE346361.1|	1453800	1453834	AGC	34	-	11	GCT
gi|514486271|gb|KE346361.1|	1454436	1454450	AACACAC	14	+	2	ACACAAC
gi|514486271|gb|KE346361.1|	1454485	1454502	AAAAAC	17	+	2	AAAAAC
gi|514486271|gb|KE346361.1|	1454536	1454573	A	37	-	37	T
gi|514486271|gb|KE346361.1|	1454986	1455000	A	14	-	14	T
gi|514486271|gb|KE346361.1|	1455024	1455048	AAAAAT	24	-	4	ATTTTT
gi|514486271|gb|KE346361.1|	1455242	1455258	A	16	-	16	T
gi|514486271|gb|KE346361.1|	1455278	1455292	AACCATC	14	+	2	TCAACCA
gi|514486271|gb|KE346361.1|	1455460	1455477	AGC	17	+	5	GCA
gi|514486271|gb|KE346361.1|	1455478	1455496	ACCAGC	18	+	3	CCAGCA
gi|514486271|gb|KE346361.1|	1455500	1455514	ACCAGC	14	+	2	CACCAG
gi|514486271|gb|KE346361.1|	1455541	1455558	AGC	17	+	5	GCA
gi|514486271|gb|KE346361.1|	1455692	1455706	AGGCCG	14	+	2	CGAGGC
gi|514486271|gb|KE346361.1|	1456136	1456150	AGC	14	-	4	GCT
gi|514486271|gb|KE346361.1|	1456157	1456171	AGCCGC	14	-	2	GCGGCT
gi|514486271|gb|KE346361.1|	1456376	1456393	AGC	17	-	5	GCT
gi|514486271|gb|KE346361.1|	1456391	1456405	CCG	14	+	4	GCC
gi|514486271|gb|KE346361.1|	1459205	1459223	A	18	-	18	T
gi|514486271|gb|KE346361.1|	1459676	1459690	C	14	+	14	C
gi|514486271|gb|KE346361.1|	1459889	1459993	AAC	104	+	34	AAC
gi|514486271|gb|KE346361.1|	1461521	1461544	A	23	+	23	A
gi|514486271|gb|KE346361.1|	1462645	1462668	A	23	-	23	T
gi|514486271|gb|KE346361.1|	1462693	1462710	A	17	-	17	T
gi|514486271|gb|KE346361.1|	1462796	1462822	ATC	26	-	8	ATG
gi|514486271|gb|KE346361.1|	1462880	1462899	A	19	-	19	T
gi|514486271|gb|KE346361.1|	1462919	1462944	A	25	-	25	T
gi|514486271|gb|KE346361.1|	1462972	1462989	AG	17	-	8	TC
gi|514486271|gb|KE346361.1|	1462990	1463004	AG	14	-	7	TC
gi|514486271|gb|KE346361.1|	1463133	1463152	A	19	+	19	A
gi|514486271|gb|KE346361.1|	1463195	1463209	AGGGG	14	-	2	CCCTC
gi|514486271|gb|KE346361.1|	1463567	1463581	AAAAC	14	-	2	TTTTG
gi|514486271|gb|KE346361.1|	1463910	1463924	A	14	+	14	A
gi|514486271|gb|KE346361.1|	1463946	1463966	A	20	+	20	A
gi|514486271|gb|KE346361.1|	1466489	1466503	AGCTCG	14	+	2	GAGCTC
gi|514486271|gb|KE346361.1|	1469871	1469885	AATGCGC	14	+	2	TGCGCAA
gi|514486271|gb|KE346361.1|	1472404	1472418	AATGTC	14	+	2	GTCAAT
gi|514486271|gb|KE346361.1|	1478180	1478197	A	17	-	17	T
gi|514486271|gb|KE346361.1|	1478787	1478815	A	28	+	28	A
gi|514486271|gb|KE346361.1|	1478827	1478841	AAAGAG	14	+	2	GAGAAA
gi|514486271|gb|KE346361.1|	1478857	1478880	AAG	23	+	7	AAG
gi|514486271|gb|KE346361.1|	1478886	1478911	AAAG	25	+	6	AAGA
gi|514486271|gb|KE346361.1|	1479161	1479175	AAAATAC	14	+	2	CAAAATA
gi|514486271|gb|KE346361.1|	1480930	1480951	AAC	21	+	7	AAC
gi|514486271|gb|KE346361.1|	1481430	1481445	AAATCCC	15	-	2	GATTTGG
gi|514486271|gb|KE346361.1|	1481472	1481492	A	20	+	20	A
gi|514486271|gb|KE346361.1|	1482207	1482237	A	30	-	30	T
gi|514486271|gb|KE346361.1|	1482377	1482391	ACCCCC	14	+	2	CCACCC
gi|514486271|gb|KE346361.1|	1482429	1482464	A	35	+	35	A
gi|514486271|gb|KE346361.1|	1482856	1482870	AGC	14	-	4	CTG
gi|514486271|gb|KE346361.1|	1484803	1484820	AAG	17	+	5	AGA
gi|514486271|gb|KE346361.1|	1484821	1484836	AAGAGG	15	+	2	AGAGGA
gi|514486271|gb|KE346361.1|	1486910	1486924	ACCAGC	14	-	2	TGCTGG
gi|514486271|gb|KE346361.1|	1487212	1487238	ACAG	26	+	6	ACAG
gi|514486271|gb|KE346361.1|	1487300	1487323	AAC	23	+	7	ACA
gi|514486271|gb|KE346361.1|	1487324	1487339	AAC	15	+	5	ACA
gi|514486271|gb|KE346361.1|	1488532	1488547	ATC	15	-	5	ATG
gi|514486271|gb|KE346361.1|	1488765	1488784	A	19	-	19	T
gi|514486271|gb|KE346361.1|	1488972	1488998	A	26	-	26	T
gi|514486271|gb|KE346361.1|	1489084	1489099	AAAATTG	15	-	2	ATTTTCA
gi|514486271|gb|KE346361.1|	1489179	1489193	AAAGAAG	14	+	2	GAAGAAA
gi|514486271|gb|KE346361.1|	1489241	1489255	AGC	14	+	4	CAG
gi|514486271|gb|KE346361.1|	1489913	1489927	AACTTC	14	-	2	GAAGTT
gi|514486271|gb|KE346361.1|	1490241	1490257	AGC	16	-	5	CTG
gi|514486271|gb|KE346361.1|	1490632	1490649	AC	17	-	8	GT
gi|514486271|gb|KE346361.1|	1490771	1490790	AGATG	19	-	3	TCTCA
gi|514486271|gb|KE346361.1|	1491372	1491386	AGC	14	-	4	TGC
gi|514486271|gb|KE346361.1|	1491395	1491410	AGC	15	-	5	CTG
gi|514486271|gb|KE346361.1|	1491419	1491437	AGC	18	-	6	CTG
gi|514486271|gb|KE346361.1|	1491667	1491682	AAAAAC	15	-	2	TTTGTT
gi|514486271|gb|KE346361.1|	1491677	1491693	A	16	-	16	T
gi|514486271|gb|KE346361.1|	1491687	1491702	AAAAAAC	15	-	2	TTTTTTG
gi|514486271|gb|KE346361.1|	1495187	1495202	A	15	-	15	T
gi|514486271|gb|KE346361.1|	1495409	1495427	ACG	18	+	6	CGA
gi|514486271|gb|KE346361.1|	1495422	1495437	ACGATG	15	+	2	GACGAT
gi|514486271|gb|KE346361.1|	1495975	1495994	AAAACCC	19	-	2	TTTTGGG
gi|514486271|gb|KE346361.1|	1496934	1496948	AAATGG	14	-	2	CCATTT
gi|514486271|gb|KE346361.1|	1497243	1497257	AAAAAC	14	-	2	GTTTTT
gi|514486271|gb|KE346361.1|	1498700	1498714	AAGGCG	14	+	2	GAAGGC
gi|514486271|gb|KE346361.1|	1498783	1498814	AGC	31	-	10	CTG
gi|514486271|gb|KE346361.1|	1500662	1500677	AACACC	15	-	2	TGGTGT
gi|514486271|gb|KE346361.1|	1500944	1500962	AGC	18	+	6	CAG
gi|514486271|gb|KE346361.1|	1500963	1500983	AGC	20	+	6	AGC
gi|514486271|gb|KE346361.1|	1501196	1501210	ACG	14	+	4	GAC
gi|514486271|gb|KE346361.1|	1504113	1504133	AGCC	20	-	5	CTGG
gi|514486271|gb|KE346361.1|	1504294	1504308	AACCCT	14	-	2	GGGTTA
gi|514486271|gb|KE346361.1|	1505162	1505177	AAGCTC	15	-	2	TTGAGC
gi|514486271|gb|KE346361.1|	1505507	1505522	AGAGGCG	15	-	2	CGCCTCT
gi|514486271|gb|KE346361.1|	1508398	1508415	CCG	17	+	5	CCG
gi|514486271|gb|KE346361.1|	1509206	1509225	AG	19	-	9	CT
gi|514486271|gb|KE346361.1|	1509247	1509263	ACCG	16	-	4	GTCG
gi|514486271|gb|KE346361.1|	1509928	1509942	AAAAC	14	-	2	TTTTG
gi|514486271|gb|KE346361.1|	1511841	1511871	A	30	+	30	A
gi|514486271|gb|KE346361.1|	1512562	1512578	ACGCTCG	16	-	2	CGTCGAG
gi|514486271|gb|KE346361.1|	1512938	1512952	ACC	14	+	4	CCA
gi|514486271|gb|KE346361.1|	1513174	1513196	A	22	-	22	T
gi|514486271|gb|KE346361.1|	1513193	1513208	AAAC	15	-	3	TTTG
gi|514486271|gb|KE346361.1|	1514501	1514520	AGG	19	-	6	CTC
gi|514486271|gb|KE346361.1|	1515868	1515882	AATCCCG	14	+	2	AATCCCG
gi|514486271|gb|KE346361.1|	1519570	1519601	AGC	31	-	10	TGC
gi|514486271|gb|KE346361.1|	1521544	1521560	AAAAAC	16	+	2	AAACAA
gi|514486271|gb|KE346361.1|	1522130	1522144	AAGAGAC	14	+	2	AGAGACA
gi|514486271|gb|KE346361.1|	1522143	1522158	AG	15	+	7	AG
gi|514486271|gb|KE346361.1|	1522686	1522700	AAAACG	14	+	2	AAACGA
gi|514486271|gb|KE346361.1|	1522713	1522734	A	21	+	21	A
gi|514486271|gb|KE346361.1|	1523093	1523107	AGCATC	14	-	2	TGATGC
gi|514486271|gb|KE346361.1|	1523102	1523121	AGC	19	-	6	TGC
gi|514486271|gb|KE346361.1|	1525774	1525789	ACG	15	-	5	TCG
gi|514486271|gb|KE346361.1|	1525784	1525801	ACGCCG	17	-	2	CGTCGG
gi|514486271|gb|KE346361.1|	1525848	1525862	AGGCGG	14	+	2	CGGAGG
gi|514486271|gb|KE346361.1|	1525937	1525951	ACCC	14	-	3	GGTG
gi|514486271|gb|KE346361.1|	1526176	1526191	AG	15	-	7	TC
gi|514486271|gb|KE346361.1|	1526317	1526364	AGAGGC	47	-	7	TCTGCC
gi|514486271|gb|KE346361.1|	1526604	1526619	AAAGAAC	15	+	2	AAAGAAC
gi|514486271|gb|KE346361.1|	1526765	1526781	AATCTC	16	+	2	TCTCAA
gi|514486271|gb|KE346361.1|	1526777	1526796	AG	19	-	9	TC
gi|514486271|gb|KE346361.1|	1526975	1527004	ACAGAG	29	+	4	AGAGAC
gi|514486271|gb|KE346361.1|	1529546	1529567	ACG	21	-	7	GTC
gi|514486271|gb|KE346361.1|	1530205	1530225	ACACGC	20	+	3	CACGCA
gi|514486271|gb|KE346361.1|	1530720	1530740	ACGGAGG	20	-	2	GTCCTCC
gi|514486271|gb|KE346361.1|	1531086	1531106	AGAGCC	20	+	3	GCCAGA
gi|514486271|gb|KE346361.1|	1531124	1531156	AC	32	-	16	TG
gi|514486271|gb|KE346361.1|	1531326	1531340	ACTG	14	-	3	TCAG
gi|514486271|gb|KE346361.1|	1531486	1531508	AACAAG	22	+	3	CAAGAA
gi|514486271|gb|KE346361.1|	1532488	1532502	AGC	14	+	4	CAG
gi|514486271|gb|KE346361.1|	1533047	1533076	A	29	+	29	A
gi|514486271|gb|KE346361.1|	1533820	1533834	ACCGAGC	14	-	2	TCGGTGC
gi|514486271|gb|KE346361.1|	1534107	1534131	AAC	24	+	8	AAC
gi|514486271|gb|KE346361.1|	1535429	1535454	A	25	+	25	A
gi|514486271|gb|KE346361.1|	1535463	1535480	ACTGAG	17	+	2	ACTGAG
gi|514486271|gb|KE346361.1|	1535626	1535640	A	14	-	14	T
gi|514486271|gb|KE346361.1|	1535641	1535655	AAAAAAC	14	-	2	GTTTTTT
gi|514486271|gb|KE346361.1|	1536824	1536838	AGC	14	+	4	CAG
gi|514486271|gb|KE346361.1|	1536891	1536912	AAAAC	21	+	4	AACAA
gi|514486271|gb|KE346361.1|	1536909	1536931	AAAAC	22	+	4	AAACA
gi|514486271|gb|KE346361.1|	1536924	1536943	AAAC	19	+	4	AAAC
gi|514486271|gb|KE346361.1|	1540501	1540515	AATGAG	14	+	2	GAATGA
gi|514486271|gb|KE346361.1|	1544264	1544278	AAAAAAG	14	-	2	TTTTTCT
gi|514486271|gb|KE346361.1|	1544296	1544312	AAGAGGG	16	-	2	TCCCTCT
gi|514486271|gb|KE346361.1|	1544540	1544554	AGCTCCC	14	+	2	TCCCAGC
gi|514486271|gb|KE346361.1|	1550959	1550976	A	17	+	17	A
gi|514486271|gb|KE346361.1|	1554804	1554818	AGC	14	+	4	CAG
gi|514486271|gb|KE346361.1|	1554871	1554892	AAAAC	21	+	4	AACAA
gi|514486271|gb|KE346361.1|	1554889	1554911	AAAAC	22	+	4	AAACA
gi|514486271|gb|KE346361.1|	1554904	1554923	AAAC	19	+	4	AAAC
gi|514486271|gb|KE346361.1|	1558826	1558840	A	14	+	14	A
gi|514486271|gb|KE346361.1|	1558962	1559124	AC	162	+	81	CA
gi|514486271|gb|KE346361.1|	1559132	1559155	AC	23	+	11	AC
gi|514486271|gb|KE346361.1|	1559757	1559775	A	18	+	18	A
gi|514486271|gb|KE346361.1|	1559781	1559801	A	20	+	20	A
gi|514486271|gb|KE346361.1|	1563611	1563630	AAAAAG	19	+	3	AAAAGA
gi|514486271|gb|KE346361.1|	1563625	1563642	AAG	17	+	5	AAG
gi|514486271|gb|KE346361.1|	1563944	1563972	AACC	28	+	7	CCAA
gi|514486271|gb|KE346361.1|	1563971	1564046	AAAC	75	+	18	AAAC
gi|514486271|gb|KE346361.1|	1564072	1564086	AAAC	14	+	3	AAAC
gi|514486271|gb|KE346361.1|	1564105	1564132	AAAC	27	+	6	AAAC
gi|514486271|gb|KE346361.1|	1564955	1564986	AC	31	-	15	TG
gi|514486271|gb|KE346361.1|	1565231	1565252	ATCC	21	-	5	GATG
gi|514486271|gb|KE346361.1|	1565251	1565279	ATCC	28	-	7	GGAT
gi|514486271|gb|KE346361.1|	1565534	1565550	AGC	16	-	5	GCT
gi|514486271|gb|KE346361.1|	1565801	1565817	AACCTTC	16	-	2	TTGAAGG
gi|514486271|gb|KE346361.1|	1565849	1565863	AGCTGC	14	+	2	CAGCTG
gi|514486271|gb|KE346361.1|	1567064	1567078	AGC	14	-	4	GCT
gi|514486271|gb|KE346361.1|	1567830	1567844	AG	14	-	7	CT
gi|514486271|gb|KE346361.1|	1568043	1568057	AAGGCTC	14	-	2	TGAGCCT
gi|514486271|gb|KE346361.1|	1568178	1568193	AAACC	15	-	3	TTGGT
gi|514486271|gb|KE346361.1|	1568668	1568684	AATCCC	16	+	2	CCAATC
gi|514486271|gb|KE346361.1|	1568719	1568742	ACTGCG	23	+	3	CGACTG
gi|514486271|gb|KE346361.1|	1569077	1569091	ACATGGT	14	-	2	ACCATGT
gi|514486271|gb|KE346361.1|	1569635	1569659	AAC	24	-	8	TTG
gi|514486271|gb|KE346361.1|	1570322	1570343	A	21	+	21	A
gi|514486271|gb|KE346361.1|	1570719	1570734	AAATGC	15	-	2	TTTGCA
gi|514486271|gb|KE346361.1|	1573451	1573469	AAAAAAG	18	+	2	AAAAAAG
gi|514486271|gb|KE346361.1|	1573661	1573687	A	26	-	26	T
gi|514486271|gb|KE346361.1|	1573931	1573947	AATGCG	16	-	2	ATTCGC
gi|514486271|gb|KE346361.1|	1576117	1576133	AG	16	-	8	CT
gi|514486271|gb|KE346361.1|	1576279	1576293	AAAATGC	14	-	2	TTTTGCA
gi|514486271|gb|KE346361.1|	1576301	1576315	A	14	-	14	T
gi|514486271|gb|KE346361.1|	1576535	1576550	AAAAAG	15	-	2	TCTTTT
gi|514486271|gb|KE346361.1|	1576588	1576605	AATGGGG	17	-	2	TTCCCCA
gi|514486271|gb|KE346361.1|	1576806	1576824	ATCGC	18	+	3	CGCAT
gi|514486271|gb|KE346361.1|	1577109	1577129	AGC	20	+	6	CAG
gi|514486271|gb|KE346361.1|	1577437	1577453	AGCGGC	16	-	2	TGCCGC
gi|514486271|gb|KE346361.1|	1577505	1577520	ACGCCG	15	+	2	CCGACG
gi|514486271|gb|KE346361.1|	1577591	1577605	CCG	14	+	4	CGC
gi|514486271|gb|KE346361.1|	1577669	1577698	AGC	29	+	9	GCA
gi|514486271|gb|KE346361.1|	1577790	1577813	ACG	23	-	7	TCG
gi|514486271|gb|KE346361.1|	1577882	1577900	ACAGGG	18	+	3	GGGACA
gi|514486271|gb|KE346361.1|	1578246	1578275	AACAGC	29	+	4	CAGCAA
gi|514486271|gb|KE346361.1|	1578276	1578317	AACAGC	41	+	6	CAGCAA
gi|514486271|gb|KE346361.1|	1578444	1578463	AAGACG	19	+	3	GAAGAC
gi|514486271|gb|KE346361.1|	1578477	1578500	ACG	23	+	7	GAC
gi|514486271|gb|KE346361.1|	1579881	1579895	AAAAAC	14	-	2	TTTGTT
gi|514486271|gb|KE346361.1|	1580065	1580079	AGGATGG	14	+	2	GATGGAG
gi|514486271|gb|KE346361.1|	1580655	1580669	AAGCAGC	14	+	2	CAAGCAG
gi|514486271|gb|KE346361.1|	1580723	1580737	AGCCG	14	-	2	GCTCG
gi|514486271|gb|KE346361.1|	1582024	1582048	AAC	24	-	8	TGT
gi|514486271|gb|KE346361.1|	1582765	1582783	AAAAAT	18	-	3	TTTATT
gi|514486271|gb|KE346361.1|	1583228	1583242	AAAAAC	14	-	2	TTGTTT
gi|514486271|gb|KE346361.1|	1583452	1583467	AGCGGGG	15	-	2	CTCCCCG
gi|514486271|gb|KE346361.1|	1583800	1583822	A	22	+	22	A
gi|514486271|gb|KE346361.1|	1584146	1584161	AAAC	15	-	3	TTTG
gi|514486271|gb|KE346361.1|	1584546	1584560	ACGAGG	14	+	2	GAGGAC
gi|514486271|gb|KE346361.1|	1585996	1586013	ACCGAG	17	-	2	CTCGGT
gi|514486271|gb|KE346361.1|	1586125	1586151	ACG	26	+	8	CGA
gi|514486271|gb|KE346361.1|	1588086	1588108	AAAAC	22	-	4	TTGTT
gi|514486271|gb|KE346361.1|	1588655	1588672	AC	17	-	8	GT
gi|514486271|gb|KE346361.1|	1588762	1588776	AAGCTTC	14	+	2	AGCTTCA
gi|514486271|gb|KE346361.1|	1590181	1590196	AAAGCGG	15	+	2	AGCGGAA
gi|514486271|gb|KE346361.1|	1590336	1590352	A	16	+	16	A
gi|514486271|gb|KE346361.1|	1590376	1590505	AG	129	+	64	AG
gi|514486271|gb|KE346361.1|	1590646	1590660	AAAAC	14	+	2	AAAAC
gi|514486271|gb|KE346361.1|	1590930	1590957	A	27	-	27	T
gi|514486271|gb|KE346361.1|	1591778	1591797	ACCTCC	19	+	3	ACCTCC
gi|514486271|gb|KE346361.1|	1592877	1592895	A	18	-	18	T
gi|514486271|gb|KE346361.1|	1593446	1593460	AGCCGC	14	-	2	GCGGCT
gi|514486271|gb|KE346361.1|	1593689	1593705	AC	16	+	8	AC
gi|514486271|gb|KE346361.1|	1593737	1593754	ATCGC	17	+	3	CGCAT
gi|514486271|gb|KE346361.1|	1595488	1595505	AAAAAC	17	+	2	AAAAAC
gi|514486271|gb|KE346361.1|	1595500	1595515	A	15	+	15	A
gi|514486271|gb|KE346361.1|	1596435	1596457	AAAAAGC	22	+	3	AGCAAAA
gi|514486271|gb|KE346361.1|	1596451	1596467	AAAAAAC	16	+	2	CAAAAAA
gi|514486271|gb|KE346361.1|	1596881	1596902	A	21	-	21	T
gi|514486271|gb|KE346361.1|	1597305	1597320	AG	15	+	7	GA
gi|514486271|gb|KE346361.1|	1597692	1597712	AAAAAC	20	+	3	AAAACA
gi|514486271|gb|KE346361.1|	1598826	1598840	AGATC	14	-	2	TGATC
gi|514486271|gb|KE346361.1|	1598867	1598899	A	32	-	32	T
gi|514486271|gb|KE346361.1|	1599106	1599122	A	16	-	16	T
gi|514486271|gb|KE346361.1|	1599673	1599697	A	24	-	24	T
gi|514486271|gb|KE346361.1|	1603452	1603466	A	14	-	14	T
gi|514486271|gb|KE346361.1|	1603940	1603956	AAAC	16	-	4	TTTG
gi|514486271|gb|KE346361.1|	1609110	1609127	A	17	+	17	A
gi|514486271|gb|KE346361.1|	1611783	1611797	AGC	14	+	4	CAG
gi|514486271|gb|KE346361.1|	1613202	1613216	A	14	+	14	A
gi|514486271|gb|KE346361.1|	1614985	1615011	A	26	+	26	A
gi|514486271|gb|KE346361.1|	1615734	1615754	A	20	+	20	A
gi|514486271|gb|KE346361.1|	1616124	1616138	A	14	+	14	A
gi|514486271|gb|KE346361.1|	1617593	1617610	AAAAAAC	17	+	2	AAAAAAC
gi|514486271|gb|KE346361.1|	1619739	1619758	AG	19	+	9	AG
gi|514486271|gb|KE346361.1|	1620054	1620069	AAACC	15	+	3	CCAAA
gi|514486271|gb|KE346361.1|	1621705	1621722	ACG	17	+	5	CGA
gi|514486271|gb|KE346361.1|	1621895	1621912	AGC	17	-	5	CTG
gi|514486271|gb|KE346361.1|	1621907	1621930	ACTGCT	23	+	3	CTGCTA
gi|514486271|gb|KE346361.1|	1622236	1622253	ACT	17	-	5	AGT
gi|514486271|gb|KE346361.1|	1622533	1622552	AACTGG	19	-	3	TCCAGT
gi|514486271|gb|KE346361.1|	1622788	1622804	AAAG	16	+	4	AGAA
gi|514486271|gb|KE346361.1|	1622843	1622860	A	17	+	17	A
gi|514486271|gb|KE346361.1|	1622879	1622893	AAAAAG	14	+	2	AGAAAA
gi|514486271|gb|KE346361.1|	1623093	1623109	AGCTC	16	+	3	GCTCA
gi|514486271|gb|KE346361.1|	1623720	1623736	A	16	+	16	A
gi|514486271|gb|KE346361.1|	1623755	1623776	A	21	+	21	A
gi|514486271|gb|KE346361.1|	1623781	1623799	A	18	-	18	T
gi|514486271|gb|KE346361.1|	1624594	1624613	A	19	-	19	T
gi|514486271|gb|KE346361.1|	1631421	1631440	AGC	19	+	6	GCA
gi|514486271|gb|KE346361.1|	1632194	1632212	ACCCATC	18	-	2	GTGATGG
gi|514486271|gb|KE346361.1|	1632354	1632371	AAACG	17	+	3	AAACG
gi|514486271|gb|KE346361.1|	1632383	1632402	A	19	+	19	A
gi|514486271|gb|KE346361.1|	1632431	1632447	A	16	+	16	A
gi|514486271|gb|KE346361.1|	1632620	1632636	A	16	+	16	A
gi|514486271|gb|KE346361.1|	1632735	1632752	A	17	-	17	T
gi|514486271|gb|KE346361.1|	1633048	1633067	A	19	-	19	T
gi|514486271|gb|KE346361.1|	1633250	1633267	ACGAGG	17	-	2	TCGTCC
gi|514486271|gb|KE346361.1|	1633360	1633375	AGC	15	-	5	TGC
gi|514486271|gb|KE346361.1|	1636131	1636160	AGC	29	-	9	GCT
gi|514486271|gb|KE346361.1|	1637033	1637055	CCG	22	-	7	GCG
gi|514486271|gb|KE346361.1|	1637053	1637067	ACC	14	-	4	GGT
gi|514486271|gb|KE346361.1|	1637246	1637267	AAAC	21	+	5	ACAA
gi|514486271|gb|KE346361.1|	1641282	1641296	AAAC	14	+	3	AACA
gi|514486271|gb|KE346361.1|	1641289	1641306	AAAAAAC	17	+	2	AAACAAA
gi|514486271|gb|KE346361.1|	1642399	1642417	AGC	18	+	6	GCA
gi|514486271|gb|KE346361.1|	1642574	1642593	AC	19	+	9	AC
gi|514486271|gb|KE346361.1|	1643311	1643330	AG	19	+	9	GA
gi|514486271|gb|KE346361.1|	1644358	1644372	ATC	14	-	4	TGA
gi|514486271|gb|KE346361.1|	1644367	1644384	ACCATC	17	-	2	TGATGG
gi|514486271|gb|KE346361.1|	1644409	1644423	ACTCGG	14	-	2	TCCGAG
gi|514486271|gb|KE346361.1|	1645374	1645419	A	45	+	45	A
gi|514486271|gb|KE346361.1|	1645434	1645450	AAAAACC	16	-	2	TTTGGTT
gi|514486271|gb|KE346361.1|	1645810	1645840	AAT	30	+	10	AAT
gi|514486271|gb|KE346361.1|	1645929	1645949	AAAAAAC	20	-	2	TTTTTTG
gi|514486271|gb|KE346361.1|	1646030	1646054	AG	24	+	12	AG
gi|514486271|gb|KE346361.1|	1646192	1646207	ACTCTC	15	-	2	GAGAGT
gi|514486271|gb|KE346361.1|	1646294	1646313	ATC	19	+	6	CAT
gi|514486271|gb|KE346361.1|	1646438	1646456	AAGAGGG	18	-	2	TCTTCCC
gi|514486271|gb|KE346361.1|	1647097	1647111	ATCGGC	14	+	2	GCATCG
gi|514486271|gb|KE346361.1|	1647178	1647195	ACG	17	-	5	TCG
gi|514486271|gb|KE346361.1|	1648550	1648564	A	14	-	14	T
gi|514486271|gb|KE346361.1|	1649077	1649091	AAGGTG	14	-	2	CCTTCA
gi|514486271|gb|KE346361.1|	1649226	1649257	ACTC	31	+	7	TCAC
gi|514486271|gb|KE346361.1|	1650172	1650192	AAAC	20	-	5	TTTG
gi|514486271|gb|KE346361.1|	1652017	1652031	AAC	14	+	4	ACA
gi|514486271|gb|KE346361.1|	1652633	1652648	ACAGCT	15	-	2	AGCTGT
gi|514486271|gb|KE346361.1|	1652746	1652776	ACAGCC	30	-	5	GCTGTG
gi|514486271|gb|KE346361.1|	1652967	1652988	AC	21	-	10	TG
gi|514486271|gb|KE346361.1|	1653022	1653037	AC	15	+	7	CA
gi|514486271|gb|KE346361.1|	1653520	1653535	A	15	+	15	A
gi|514486271|gb|KE346361.1|	1654849	1654871	ACCAGC	22	+	3	AGCACC
gi|514486271|gb|KE346361.1|	1655090	1655109	AAAAAAT	19	+	2	TAAAAAA
gi|514486271|gb|KE346361.1|	1655169	1655193	AAAAT	24	+	4	AAAAT
gi|514486271|gb|KE346361.1|	1655596	1655610	AAATCC	14	-	2	TGGATT
gi|514486271|gb|KE346361.1|	1656835	1656857	A	22	+	22	A
gi|514486271|gb|KE346361.1|	1657510	1657529	ACACC	19	-	3	TGGTG
gi|514486271|gb|KE346361.1|	1659503	1659520	AACACC	17	-	2	GTTGGT
gi|514486271|gb|KE346361.1|	1659708	1659727	AAAC	19	+	4	AACA
gi|514486271|gb|KE346361.1|	1659935	1659952	A	17	-	17	T
gi|514486271|gb|KE346361.1|	1660814	1660832	A	18	-	18	T
gi|514486271|gb|KE346361.1|	1660831	1660849	AC	18	-	9	TG
gi|514486271|gb|KE346361.1|	1661078	1661097	AGC	19	-	6	TGC
gi|514486271|gb|KE346361.1|	1661154	1661169	ACG	15	+	5	GAC
gi|514486271|gb|KE346361.1|	1662462	1662477	ACG	15	-	5	TCG
gi|514486271|gb|KE346361.1|	1662573	1662593	ACG	20	-	6	TCG
gi|514486271|gb|KE346361.1|	1662654	1662668	ACG	14	+	4	GAC
gi|514486271|gb|KE346361.1|	1663233	1663251	AGC	18	-	6	GCT
gi|514486271|gb|KE346361.1|	1663946	1663960	A	14	-	14	T
gi|514486271|gb|KE346361.1|	1664635	1664652	A	17	+	17	A
gi|514486271|gb|KE346361.1|	1665025	1665042	A	17	-	17	T
gi|514486271|gb|KE346361.1|	1665046	1665089	AAG	43	-	14	TCT
gi|514486271|gb|KE346361.1|	1665302	1665316	ATC	14	+	4	CAT
gi|514486271|gb|KE346361.1|	1665412	1665434	AGC	22	+	7	CAG
gi|514486271|gb|KE346361.1|	1665914	1665928	AAGCGG	14	+	2	CGGAAG
gi|514486271|gb|KE346361.1|	1665945	1665962	AGCGGC	17	-	2	CGCTGC
gi|514486271|gb|KE346361.1|	1666098	1666113	AGC	15	-	5	TGC
gi|514486271|gb|KE346361.1|	1666502	1666516	AGC	14	-	4	CTG
gi|514486271|gb|KE346361.1|	1666789	1666807	AACAGC	18	+	3	CAGCAA
gi|514486271|gb|KE346361.1|	1666816	1666830	AGCTGC	14	+	2	CAGCTG
gi|514486271|gb|KE346361.1|	1667178	1667192	AAC	14	+	4	CAA
gi|514486271|gb|KE346361.1|	1667187	1667205	AACAGC	18	+	3	CAACAG
gi|514486271|gb|KE346361.1|	1668609	1668624	AAAC	15	-	3	TTGT
gi|514486271|gb|KE346361.1|	1669501	1669515	AAAAAAG	14	-	2	TTTTTTC
gi|514486271|gb|KE346361.1|	1669705	1669730	A	25	+	25	A
gi|514486271|gb|KE346361.1|	1669786	1669813	A	27	-	27	T
gi|514486271|gb|KE346361.1|	1670074	1670088	AAAAAG	14	-	2	TTTTTC
gi|514486271|gb|KE346361.1|	1671945	1671963	ACAGGG	18	-	3	CTGTCC
gi|514486271|gb|KE346361.1|	1672720	1672734	AG	14	+	7	GA
gi|514486271|gb|KE346361.1|	1673403	1673425	AACAGC	22	-	3	GCTGTT
gi|514486271|gb|KE346361.1|	1675429	1675444	AATCTCC	15	+	2	ATCTCCA
gi|514486271|gb|KE346361.1|	1677027	1677042	AAC	15	+	5	CAA
gi|514486271|gb|KE346361.1|	1679575	1679592	AGGCGCC	17	+	2	CGCCAGG
gi|514486271|gb|KE346361.1|	1680513	1680528	AGGGGC	15	+	2	GGCAGG
gi|514486271|gb|KE346361.1|	1681329	1681344	ACCGCCC	15	-	2	GCGGTGG
gi|514486271|gb|KE346361.1|	1681404	1681418	AGCGGC	14	+	2	GCAGCG
gi|514486271|gb|KE346361.1|	1681896	1681910	ATC	14	-	4	TGA
gi|514486271|gb|KE346361.1|	1682104	1682118	AAAAAAT	14	+	2	AAATAAA
gi|514486271|gb|KE346361.1|	1682115	1682129	AAAAAAT	14	+	2	AAATAAA
gi|514486271|gb|KE346361.1|	1683283	1683298	ACACTC	15	-	2	GTGTGA
gi|514486271|gb|KE346361.1|	1683373	1683388	AGCC	15	-	3	CTGG
gi|514486271|gb|KE346361.1|	1684480	1684499	AACAGC	19	-	3	GTTGCT
gi|514486271|gb|KE346361.1|	1686471	1686494	A	23	-	23	T
gi|514486271|gb|KE346361.1|	1686495	1686510	A	15	-	15	T
gi|514486271|gb|KE346361.1|	1686710	1686724	AAAATC	14	-	2	TTGATT
gi|514486271|gb|KE346361.1|	1686720	1686737	A	17	-	17	T
gi|514486271|gb|KE346361.1|	1687099	1687114	AG	15	-	7	CT
gi|514486271|gb|KE346361.1|	1687742	1687773	AG	31	-	15	TC
gi|514486271|gb|KE346361.1|	1687774	1687861	AG	87	-	43	TC
gi|514486271|gb|KE346361.1|	1690254	1690270	AAAAAC	16	-	2	TTTTTG
gi|514486271|gb|KE346361.1|	1690569	1690590	AG	21	-	10	TC
gi|514486271|gb|KE346361.1|	1691191	1691205	AAACAGC	14	-	2	TGCTGTT
gi|514486271|gb|KE346361.1|	1692463	1692484	ATC	21	-	7	TGA
gi|514486271|gb|KE346361.1|	1693043	1693064	AGC	21	-	7	GCT
gi|514486271|gb|KE346361.1|	1693531	1693545	AGAGCCG	14	-	2	GCTCTCG
gi|514486271|gb|KE346361.1|	1695380	1695394	ATC	14	-	4	GAT
gi|514486271|gb|KE346361.1|	1697074	1697088	A	14	-	14	T
gi|514486271|gb|KE346361.1|	1697100	1697114	A	14	-	14	T
gi|514486271|gb|KE346361.1|	1697143	1697163	AAGAC	20	-	4	TTGTC
gi|514486271|gb|KE346361.1|	1699121	1699146	CCG	25	+	8	CGC
gi|514486271|gb|KE346361.1|	1699912	1699929	AAAAAAC	17	+	2	AAACAAA
gi|514486271|gb|KE346361.1|	1701364	1701380	AATACT	16	-	2	ATTAGT
gi|514486271|gb|KE346361.1|	1701662	1701694	AGG	32	-	10	CCT
gi|514486271|gb|KE346361.1|	1701875	1701901	ACTGCT	26	+	4	CTACTG
gi|514486271|gb|KE346361.1|	1703155	1703170	AAAT	15	-	3	TTTA
gi|514486271|gb|KE346361.1|	1703334	1703350	AC	16	-	8	GT
gi|514486271|gb|KE346361.1|	1703349	1703404	AG	55	-	27	TC
gi|514486271|gb|KE346361.1|	1705633	1705649	AAAAAAT	16	-	2	TTTTTTA
gi|514486271|gb|KE346361.1|	1705650	1705664	AAAAAAT	14	-	2	TATTTTT
gi|514486271|gb|KE346361.1|	1705826	1705840	AAAAAAT	14	-	2	TATTTTT
gi|514486271|gb|KE346361.1|	1705850	1705873	A	23	-	23	T
gi|514486271|gb|KE346361.1|	1706113	1706131	AC	18	-	9	TG
gi|514486271|gb|KE346361.1|	1707199	1707221	AGC	22	+	7	GCA
gi|514486271|gb|KE346361.1|	1707439	1707453	AAGTCC	14	+	2	CCAAGT
gi|514486271|gb|KE346361.1|	1710917	1710932	ACCGCC	15	-	2	GGTGGC
gi|514486271|gb|KE346361.1|	1711203	1711217	ACGCTGC	14	+	2	TGCACGC
gi|514486271|gb|KE346361.1|	1711417	1711436	AAGG	19	+	4	GAAG
gi|514486271|gb|KE346361.1|	1711808	1711826	A	18	-	18	T
gi|514486271|gb|KE346361.1|	1711923	1711942	AG	19	-	9	CT
gi|514486271|gb|KE346361.1|	1712005	1712028	A	23	-	23	T
gi|514486271|gb|KE346361.1|	1712040	1712054	AAG	14	-	4	TCT
gi|514486271|gb|KE346361.1|	1712235	1712258	A	23	-	23	T
gi|514486271|gb|KE346361.1|	1712361	1712375	A	14	-	14	T
gi|514486271|gb|KE346361.1|	1713740	1713755	A	15	+	15	A
gi|514486271|gb|KE346361.1|	1714604	1714618	A	14	+	14	A
gi|514486271|gb|KE346361.1|	1714911	1714930	A	19	-	19	T
gi|514486271|gb|KE346361.1|	1715019	1715034	AAGTAC	15	-	2	CTTGTA
gi|514486271|gb|KE346361.1|	1715622	1715650	ATC	28	-	9	ATG
gi|514486271|gb|KE346361.1|	1716430	1716449	AGC	19	-	6	CTG
gi|514486271|gb|KE346361.1|	1717621	1717635	ACCACCC	14	-	2	GGGTGGT
gi|514486271|gb|KE346361.1|	1717696	1717713	AGC	17	+	5	AGC
gi|514486271|gb|KE346361.1|	1717773	1717787	ATCGCG	14	+	2	GCGATC
gi|514486271|gb|KE346361.1|	1719319	1719333	AGG	14	+	4	GAG
gi|514486271|gb|KE346361.1|	1719647	1719663	AATGCG	16	-	2	CATTCG
gi|514486271|gb|KE346361.1|	1720507	1720521	AAATGC	14	-	2	TTTGCA
gi|514486271|gb|KE346361.1|	1720604	1720619	AGATCC	15	+	2	CAGATC
gi|514486271|gb|KE346361.1|	1720614	1720628	AGCTCC	14	+	2	TCCAGC
gi|514486271|gb|KE346361.1|	1720733	1720747	AGC	14	+	4	CAG
gi|514486271|gb|KE346361.1|	1721900	1721914	AGC	14	-	4	TGC
gi|514486271|gb|KE346361.1|	1722448	1722463	ACG	15	+	5	CGA
gi|514486271|gb|KE346361.1|	1723135	1723152	ACCAGT	17	-	2	ACTGGT
gi|514486271|gb|KE346361.1|	1723183	1723198	AGCAGCC	15	-	2	GCTGCTG
gi|514486271|gb|KE346361.1|	1723289	1723303	ACC	14	-	4	GTG
gi|514486271|gb|KE346361.1|	1723572	1723590	AAGAAT	18	+	3	AAGAAT
gi|514486271|gb|KE346361.1|	1724049	1724063	AAAAAAC	14	+	2	AAACAAA
gi|514486271|gb|KE346361.1|	1724202	1724225	AACAAT	23	-	3	TTGTTA
gi|514486271|gb|KE346361.1|	1724530	1724544	ACACACC	14	+	2	CACACAC
gi|514486271|gb|KE346361.1|	1724537	1724553	AC	16	+	8	CA
gi|514486271|gb|KE346361.1|	1725276	1725291	CCCCG	15	+	3	CCCGC
gi|514486271|gb|KE346361.1|	1725705	1725724	AG	19	+	9	AG
gi|514486271|gb|KE346361.1|	1725904	1725918	AAATAC	14	+	2	AAATAC
gi|514486271|gb|KE346361.1|	1725944	1725974	A	30	-	30	T
gi|514486271|gb|KE346361.1|	1726670	1726689	ACG	19	-	6	CGT
gi|514486271|gb|KE346361.1|	1727002	1727016	ACGATG	14	-	2	CGTCAT
gi|514486271|gb|KE346361.1|	1727205	1727221	ACG	16	-	5	TCG
gi|514486271|gb|KE346361.1|	1727378	1727395	AAGCCC	17	-	2	CTTGGG
gi|514486271|gb|KE346361.1|	1727937	1727951	AAGGGC	14	-	2	CCCTTG
gi|514486271|gb|KE346361.1|	1732186	1732207	AG	21	+	10	GA
gi|514486271|gb|KE346361.1|	1732259	1732273	A	14	+	14	A
gi|514486271|gb|KE346361.1|	1732783	1732803	AGC	20	+	6	GCA
gi|514486271|gb|KE346361.1|	1734140	1734155	AAGGG	15	-	3	CCTTC
gi|514486271|gb|KE346361.1|	1734157	1734171	AAGGG	14	-	2	TTCCC
gi|514486271|gb|KE346361.1|	1736114	1736134	AAAGC	20	-	4	TTGCT
gi|514486271|gb|KE346361.1|	1736136	1736154	ACC	18	-	6	TGG
gi|514486271|gb|KE346361.1|	1737864	1737879	AAAAG	15	+	3	AAAAG
gi|514486271|gb|KE346361.1|	1739002	1739019	AG	17	+	8	AG
gi|514486271|gb|KE346361.1|	1739642	1739657	A	15	+	15	A
gi|514486271|gb|KE346361.1|	1739745	1739762	AAAC	17	+	4	ACAA
gi|514486271|gb|KE346361.1|	1739810	1739826	ACC	16	-	5	GGT
gi|514486271|gb|KE346361.1|	1740006	1740026	AGC	20	+	6	CAG
gi|514486271|gb|KE346361.1|	1740326	1740346	AGAGCC	20	+	3	GAGCCA
gi|514486271|gb|KE346361.1|	1740374	1740388	AACAGC	14	-	2	TGCTGT
gi|514486271|gb|KE346361.1|	1740750	1740772	AAAAAG	22	+	3	AAAGAA
gi|514486271|gb|KE346361.1|	1740809	1740826	A	17	+	17	A
gi|514486271|gb|KE346361.1|	1742526	1742540	AAAC	14	+	3	AACA
gi|514486271|gb|KE346361.1|	1743138	1743157	ACC	19	-	6	TGG
gi|514486271|gb|KE346361.1|	1743207	1743230	A	23	-	23	T
gi|514486271|gb|KE346361.1|	1743394	1743408	AAAAAAT	14	+	2	AAAATAA
gi|514486271|gb|KE346361.1|	1743403	1743420	AAT	17	+	5	AAT
gi|514486271|gb|KE346361.1|	1743429	1743446	AAAAAT	17	+	2	AAAAAT
gi|514486271|gb|KE346361.1|	1743918	1743932	AACCCT	14	+	2	CCTAAC
gi|514486271|gb|KE346361.1|	1744058	1744083	A	25	-	25	T
gi|514486271|gb|KE346361.1|	1744283	1744298	A	15	+	15	A
gi|514486271|gb|KE346361.1|	1744315	1744340	AAAAAG	25	+	4	AAAAAG
gi|514486271|gb|KE346361.1|	1744546	1744562	AAT	16	+	5	ATA
gi|514486271|gb|KE346361.1|	1744717	1744741	A	24	-	24	T
gi|514486271|gb|KE346361.1|	1745026	1745043	AATG	17	-	4	TCAT
gi|514486271|gb|KE346361.1|	1747340	1747354	AAC	14	-	4	TTG
gi|514486271|gb|KE346361.1|	1749027	1749041	AATGGGC	14	-	2	CCCATTG
gi|514486271|gb|KE346361.1|	1749616	1749630	AACGCG	14	-	2	TCGCGT
gi|514486271|gb|KE346361.1|	1751446	1751461	AGC	15	-	5	TGC
gi|514486271|gb|KE346361.1|	1751673	1751687	AGATATC	14	+	2	ATATCAG
gi|514486271|gb|KE346361.1|	1751832	1751847	AATGC	15	-	3	GCATT
gi|514486271|gb|KE346361.1|	1751853	1751873	AATGC	20	-	4	CATTG
gi|514486271|gb|KE346361.1|	1751940	1751954	ATCGGC	14	-	2	GCCGAT
gi|514486271|gb|KE346361.1|	1751949	1751972	AGCATC	23	-	3	GATGCT
gi|514486271|gb|KE346361.1|	1752143	1752204	AAGCAC	61	+	10	AGCACA
gi|514486271|gb|KE346361.1|	1752197	1752213	AAAGCAC	16	+	2	AGCACAA
gi|514486271|gb|KE346361.1|	1755300	1755317	ACCCC	17	-	3	GGTGG
gi|514486271|gb|KE346361.1|	1755329	1755343	ACACTCC	14	-	2	GTGGAGT
gi|514486271|gb|KE346361.1|	1755365	1755380	AACTG	15	+	3	AACTG
gi|514486271|gb|KE346361.1|	1756200	1756217	ACCAGC	17	+	2	CAGCAC
gi|514486271|gb|KE346361.1|	1764101	1764126	AGC	25	+	8	GCA
gi|514486271|gb|KE346361.1|	1764375	1764400	AGATGC	25	+	4	ATGCAG
gi|514486271|gb|KE346361.1|	1764398	1764416	ACG	18	+	6	GAC
gi|514486271|gb|KE346361.1|	1764428	1764443	ACG	15	+	5	GAC
gi|514486271|gb|KE346361.1|	1764954	1764968	AAG	14	+	4	AAG
gi|514486271|gb|KE346361.1|	1764966	1764981	A	15	+	15	A
gi|514486271|gb|KE346361.1|	1765076	1765092	AAAAAC	16	+	2	AAAACA
gi|514486271|gb|KE346361.1|	1765200	1765220	AAC	20	+	6	CAA
gi|514486271|gb|KE346361.1|	1765215	1765230	AACAGC	15	+	2	CAACAG
gi|514486271|gb|KE346361.1|	1765256	1765273	AAG	17	+	5	AAG
gi|514486271|gb|KE346361.1|	1768355	1768369	AAGAGG	14	-	2	TCTTCC
gi|514486271|gb|KE346361.1|	1768612	1768641	ACG	29	+	9	CGA
gi|514486271|gb|KE346361.1|	1769543	1769569	AGCAGG	26	+	4	GCAGGA
gi|514486271|gb|KE346361.1|	1769630	1769649	ACG	19	-	6	TCG
gi|514486271|gb|KE346361.1|	1769848	1769863	AGC	15	+	5	AGC
gi|514486271|gb|KE346361.1|	1770114	1770128	A	14	+	14	A
gi|514486271|gb|KE346361.1|	1770156	1770172	AAATCAT	16	-	2	TGATTTA
gi|514486271|gb|KE346361.1|	1771560	1771581	A	21	+	21	A
gi|514486271|gb|KE346361.1|	1773636	1773659	A	23	-	23	T
gi|514486271|gb|KE346361.1|	1773739	1773755	AACGGC	16	+	2	GCAACG
gi|514486271|gb|KE346361.1|	1773975	1773991	A	16	+	16	A
gi|514486271|gb|KE346361.1|	1776796	1776813	ACAGCC	17	-	2	GTGGCT
gi|514486271|gb|KE346361.1|	1777845	1777860	AGCCTGG	15	+	2	CCTGGAG
gi|514486271|gb|KE346361.1|	1780205	1780219	AAAAT	14	-	2	TTTTA
gi|514486271|gb|KE346361.1|	1780218	1780232	AAAAT	14	-	2	TTTTA
gi|514486271|gb|KE346361.1|	1780284	1780301	AAC	17	+	5	AAC
gi|514486271|gb|KE346361.1|	1780449	1780463	AAAAAT	14	-	2	TTTTAT
gi|514486271|gb|KE346361.1|	1780737	1780754	AAAAAAT	17	-	2	TTTTTTA
gi|514486271|gb|KE346361.1|	1781008	1781024	AAAAC	16	-	3	TTGTT
gi|514486271|gb|KE346361.1|	1781087	1781102	AAATCC	15	+	2	CCAAAT
gi|514486271|gb|KE346361.1|	1781513	1781530	AGGCCG	17	-	2	CCTCGG
gi|514486271|gb|KE346361.1|	1784409	1784424	A	15	-	15	T
gi|514486271|gb|KE346361.1|	1784916	1784945	AAAC	29	-	7	TGTT
gi|514486271|gb|KE346361.1|	1786564	1786584	AGC	20	-	6	GCT
gi|514486271|gb|KE346361.1|	1786594	1786616	AGC	22	-	7	GCT
gi|514486271|gb|KE346361.1|	1787239	1787255	AAC	16	-	5	TTG
gi|514486271|gb|KE346361.1|	1787598	1787612	AAAAC	14	-	2	TTTTG
gi|514486271|gb|KE346361.1|	1789243	1789258	AC	15	-	7	TG
gi|514486271|gb|KE346361.1|	1790468	1790489	AG	21	+	10	GA
gi|514486271|gb|KE346361.1|	1792336	1792350	AAACC	14	-	2	TTTGG
gi|514486271|gb|KE346361.1|	1792617	1792641	A	24	+	24	A
gi|514486271|gb|KE346361.1|	1793015	1793029	ACAGCAG	14	+	2	ACAGCAG
gi|514486271|gb|KE346361.1|	1822616	1822655	AC	39	-	19	TG
gi|514486271|gb|KE346361.1|	1824719	1824736	AAC	17	-	5	GTT
gi|514486271|gb|KE346361.1|	1824907	1824946	AC	39	-	19	TG
gi|514486271|gb|KE346361.1|	1834347	1834363	AAGATG	16	+	2	GATGAA
gi|514486271|gb|KE346361.1|	1835909	1835923	AAAAAAT	14	-	2	TTTATTT
gi|514486271|gb|KE346361.1|	1838367	1838385	ACG	18	+	6	CGA
gi|514486271|gb|KE346361.1|	1839031	1839046	AGGGGG	15	+	2	GGGGAG
gi|514486271|gb|KE346361.1|	1839082	1839097	AAGGGGG	15	+	2	AGGGGGA
gi|514486271|gb|KE346361.1|	1839795	1839812	AAGTCC	17	+	2	TCCAAG
gi|514486271|gb|KE346361.1|	1841160	1841174	ACCACT	14	-	2	GTGGTA
gi|514486271|gb|KE346361.1|	1841459	1841476	ACGATC	17	-	2	CGTGAT
gi|514486271|gb|KE346361.1|	1841483	1841498	AGAGCG	15	+	2	GAGCGA
gi|514486271|gb|KE346361.1|	1841557	1841585	AGC	28	-	9	TGC
gi|514486271|gb|KE346361.1|	1841636	1841653	ACGCTC	17	-	2	CGTGAG
gi|514486271|gb|KE346361.1|	1842293	1842307	AATGGG	14	-	2	TTCCCA
gi|514486271|gb|KE346361.1|	1843816	1843832	AATCAG	16	+	2	AATCAG
gi|514486271|gb|KE346361.1|	1843858	1843877	AACAGC	19	+	3	CAGCAA
gi|514486271|gb|KE346361.1|	1844265	1844288	AAC	23	+	7	CAA
gi|514486271|gb|KE346361.1|	1845987	1846024	AG	37	+	18	AG
gi|514486271|gb|KE346361.1|	1846615	1846630	AAGGGGG	15	-	2	CCCTTCC
gi|514486271|gb|KE346361.1|	1847359	1847373	AAGGGG	14	-	2	TTCCCC
gi|514486271|gb|KE346361.1|	1849259	1849277	A	18	-	18	T
gi|514486271|gb|KE346361.1|	1849356	1849371	AG	15	-	7	TC
gi|514486271|gb|KE346361.1|	1849679	1849697	A	18	+	18	A
gi|514486271|gb|KE346361.1|	1852075	1852091	ACG	16	-	5	CGT
gi|514486271|gb|KE346361.1|	1853740	1853772	AC	32	+	16	CA
gi|514486271|gb|KE346361.1|	1854777	1854798	A	21	+	21	A
gi|514486271|gb|KE346361.1|	1855029	1855043	AAAGAGC	14	-	2	TGCTCTT
gi|514486271|gb|KE346361.1|	1855759	1855786	AGC	27	+	9	CAG
gi|514486271|gb|KE346361.1|	1856659	1856675	AGCTCC	16	+	2	GCTCCA
gi|514486271|gb|KE346361.1|	1856791	1856816	AGC	25	+	8	CAG
gi|514486271|gb|KE346361.1|	1857112	1857127	AACACC	15	-	2	TGGTGT
gi|514486271|gb|KE346361.1|	1857480	1857498	ACCAGC	18	+	3	GCACCA
gi|514486271|gb|KE346361.1|	1857718	1857737	AGCAGG	19	-	3	CTCCTG
gi|514486271|gb|KE346361.1|	1857823	1857838	AGC	15	-	5	GCT
gi|514486271|gb|KE346361.1|	1858024	1858043	A	19	+	19	A
gi|514486271|gb|KE346361.1|	1858447	1858462	AAAAG	15	-	3	TTTTC
gi|514486271|gb|KE346361.1|	1858595	1858617	ACCGAG	22	+	3	GACCGA
gi|514486271|gb|KE346361.1|	1859157	1859181	ATC	24	-	8	TGA
gi|514486271|gb|KE346361.1|	1859341	1859358	ACCGAG	17	+	2	GACCGA
gi|514486271|gb|KE346361.1|	1859353	1859376	ACCGCG	23	+	3	GACCGC
gi|514486271|gb|KE346361.1|	1859530	1859550	AAGCCG	20	+	3	CGAAGC
gi|514486271|gb|KE346361.1|	1859554	1859577	AGCCGC	23	+	3	CGCAGC
gi|514486271|gb|KE346361.1|	1860351	1860365	AG	14	-	7	TC
gi|514486271|gb|KE346361.1|	1861298	1861317	A	19	-	19	T
gi|514486271|gb|KE346361.1|	1862096	1862110	A	14	+	14	A
gi|514486271|gb|KE346361.1|	1862750	1862767	AAAAAG	17	+	2	AAAAAG
gi|514486271|gb|KE346361.1|	1863308	1863324	AAAAATC	16	-	2	TTTTGAT
gi|514486271|gb|KE346361.1|	1864124	1864138	AC	14	-	7	TG
gi|514486271|gb|KE346361.1|	1864375	1864394	A	19	-	19	T
gi|514486271|gb|KE346361.1|	1865345	1865388	ACC	43	-	14	GGT
gi|514486271|gb|KE346361.1|	1865789	1865808	AGGG	19	-	4	CCCT
gi|514486271|gb|KE346361.1|	1866256	1866271	A	15	-	15	T
gi|514486271|gb|KE346361.1|	1867356	1867442	AC	86	-	43	GT
gi|514486271|gb|KE346361.1|	1867639	1867653	AGCTGC	14	+	2	GCTGCA
gi|514486271|gb|KE346361.1|	1868418	1868432	AAAC	14	+	3	CAAA
gi|514486271|gb|KE346361.1|	1870321	1870338	AGCGC	17	-	3	GCTGC
gi|514486271|gb|KE346361.1|	1873017	1873031	AGC	14	+	4	AGC
gi|514486271|gb|KE346361.1|	1875818	1875889	AAAC	71	+	17	AAAC
gi|514486271|gb|KE346361.1|	1875886	1875901	A	15	+	15	A
gi|514486271|gb|KE346361.1|	1876279	1876293	AAAGTC	14	-	2	ACTTTG
gi|514486271|gb|KE346361.1|	1879266	1879282	AAACAAC	16	+	2	AAACAAC
gi|514486271|gb|KE346361.1|	1879901	1879917	AAC	16	+	5	ACA
gi|514486271|gb|KE346361.1|	1880531	1880552	AATG	21	+	5	GAAT
gi|514486271|gb|KE346361.1|	1880936	1880956	A	20	-	20	T
gi|514486271|gb|KE346361.1|	1881091	1881111	A	20	+	20	A
gi|514486271|gb|KE346361.1|	1881315	1881332	A	17	+	17	A
gi|514486271|gb|KE346361.1|	1881544	1881561	AAAAAG	17	+	2	AAAAAG
gi|514486271|gb|KE346361.1|	1882025	1882044	AAAAAT	19	-	3	TATTTT
gi|514486271|gb|KE346361.1|	1882126	1882140	AC	14	-	7	TG
gi|514486271|gb|KE346361.1|	1882415	1882429	AGCGGCG	14	-	2	CGCCGCT
gi|514486271|gb|KE346361.1|	1883810	1883828	A	18	-	18	T
gi|514486271|gb|KE346361.1|	1884071	1884089	A	18	-	18	T
gi|514486271|gb|KE346361.1|	1884511	1884530	AAAAAAC	19	-	2	TTTTTTG
gi|514486271|gb|KE346361.1|	1884624	1884638	AGGATGC	14	-	2	CATCCTG
gi|514486271|gb|KE346361.1|	1884710	1884728	A	18	-	18	T
gi|514486271|gb|KE346361.1|	1884979	1885001	A	22	-	22	T
gi|514486271|gb|KE346361.1|	1885010	1885024	AAAAAAG	14	-	2	TTTCTTT
gi|514486271|gb|KE346361.1|	1888118	1888132	AGAGGG	14	-	2	CTCTCC
gi|514486271|gb|KE346361.1|	1888434	1888449	AACGAC	15	+	2	AACGAC
gi|514486271|gb|KE346361.1|	1888444	1888459	AAC	15	+	5	ACA
gi|514486271|gb|KE346361.1|	1890008	1890023	AC	15	+	7	CA
gi|514486271|gb|KE346361.1|	1890067	1890082	AAAAAC	15	+	2	AAAACA
gi|514486271|gb|KE346361.1|	1890087	1890105	AAAAAAC	18	+	2	AAAAAAC
gi|514486271|gb|KE346361.1|	1890288	1890303	AG	15	+	7	AG
gi|514486271|gb|KE346361.1|	1890406	1890425	AG	19	+	9	AG
gi|514486271|gb|KE346361.1|	1890446	1890469	AG	23	+	11	GA
gi|514486271|gb|KE346361.1|	1890566	1890580	A	14	+	14	A
gi|514486271|gb|KE346361.1|	1890804	1890829	A	25	-	25	T
gi|514486271|gb|KE346361.1|	1891137	1891152	AACAC	15	-	3	TGTTG
gi|514486271|gb|KE346361.1|	1891836	1891854	AAAAAAG	18	+	2	AAAAAGA
gi|514486271|gb|KE346361.1|	1891873	1891890	A	17	+	17	A
gi|514486271|gb|KE346361.1|	1892079	1892093	AAAC	14	+	3	CAAA
gi|514486271|gb|KE346361.1|	1892760	1892784	AAG	24	+	8	GAA
gi|514486271|gb|KE346361.1|	1893443	1893460	AACAGC	17	-	2	TGTTGC
gi|514486271|gb|KE346361.1|	1894675	1894711	AGC	36	-	12	CTG
gi|514486271|gb|KE346361.1|	1894737	1894756	AAC	19	-	6	GTT
gi|514486271|gb|KE346361.1|	1894757	1894771	AAC	14	-	4	TGT
gi|514486271|gb|KE346361.1|	1894769	1894786	AGC	17	-	5	TGC
gi|514486271|gb|KE346361.1|	1895641	1895665	A	24	+	24	A
gi|514486271|gb|KE346361.1|	1895690	1895708	AAAAAT	18	+	3	AAAAAT
gi|514486271|gb|KE346361.1|	1895878	1895892	AAAAAAT	14	+	2	TAAAAAA
gi|514486271|gb|KE346361.1|	1895993	1896015	A	22	+	22	A
gi|514486271|gb|KE346361.1|	1896125	1896139	AAACACC	14	-	2	GTGTTTG
gi|514486271|gb|KE346361.1|	1896545	1896571	A	26	-	26	T
gi|514486271|gb|KE346361.1|	1896723	1896737	AAAAAAG	14	+	2	GAAAAAA
gi|514486271|gb|KE346361.1|	1896751	1896765	A	14	-	14	T
gi|514486271|gb|KE346361.1|	1896973	1897028	A	55	-	55	T
gi|514486271|gb|KE346361.1|	1897315	1897335	AGG	20	+	6	GAG
gi|514486271|gb|KE346361.1|	1897330	1897344	AAGAGG	14	+	2	GAGGAA
gi|514486271|gb|KE346361.1|	1897456	1897471	AAAATGC	15	-	2	TTTGCAT
gi|514486271|gb|KE346361.1|	1897465	1897479	AATGCAC	14	-	2	TGCATTG
gi|514486271|gb|KE346361.1|	1898081	1898130	AGC	49	+	16	GCA
gi|514486271|gb|KE346361.1|	1898680	1898697	ACAG	17	+	4	CAGA
gi|514486271|gb|KE346361.1|	1899336	1899354	AGC	18	+	6	AGC
gi|514486271|gb|KE346361.1|	1899733	1899755	A	22	+	22	A
gi|514486271|gb|KE346361.1|	1900208	1900235	A	27	+	27	A
gi|514486271|gb|KE346361.1|	1900595	1900609	AGGAGGG	14	+	2	GGAGGGA
gi|514486271|gb|KE346361.1|	1901331	1901347	ACTGGAT	16	-	2	ATCCAGT
gi|514486271|gb|KE346361.1|	1901776	1901790	AATGC	14	+	2	CAATG
gi|514486271|gb|KE346361.1|	1902583	1902597	AGAGGC	14	+	2	GGCAGA
gi|514486271|gb|KE346361.1|	1903088	1903105	AAGGAC	17	-	2	TCCTTG
gi|514486271|gb|KE346361.1|	1903111	1903135	AAGGAG	24	-	4	CTCCTT
gi|514486271|gb|KE346361.1|	1903398	1903428	AG	30	+	15	AG
gi|514486271|gb|KE346361.1|	1903743	1903757	A	14	+	14	A
gi|514486271|gb|KE346361.1|	1903937	1903951	AAACGAC	14	+	2	AACGACA
gi|514486271|gb|KE346361.1|	1904723	1904742	AGC	19	-	6	GCT
gi|514486271|gb|KE346361.1|	1907498	1907514	AGC	16	-	5	GCT
gi|514486271|gb|KE346361.1|	1907509	1907523	AACAGC	14	-	2	TGCTGT
gi|514486271|gb|KE346361.1|	1907893	1907907	AG	14	+	7	AG
gi|514486271|gb|KE346361.1|	1908482	1908507	AAAGAAG	25	+	3	GAAAGAA
gi|514486271|gb|KE346361.1|	1909236	1909253	A	17	+	17	A
gi|514486271|gb|KE346361.1|	1909248	1909263	AAAAAC	15	+	2	AAAAAC
gi|514486271|gb|KE346361.1|	1909649	1909663	AAAACTC	14	+	2	CAAAACT
gi|514486271|gb|KE346361.1|	1911941	1911955	AAAAAAC	14	-	2	TTTTTTG
gi|514486271|gb|KE346361.1|	1913515	1913549	ATC	34	-	11	ATG
gi|514486271|gb|KE346361.1|	1914202	1914219	AC	17	-	8	TG
gi|514486271|gb|KE346361.1|	1915762	1915776	AAGG	14	-	3	TTCC
gi|514486271|gb|KE346361.1|	1916822	1916836	ACTCTGG	14	+	2	GACTCTG
gi|514486271|gb|KE346361.1|	1917541	1917556	AAAAACC	15	+	2	CCAAAAA
gi|514486271|gb|KE346361.1|	1918252	1918268	AAAACC	16	-	2	TTGGTT
gi|514486271|gb|KE346361.1|	1918895	1918909	AACATC	14	-	2	TGATGT
gi|514486271|gb|KE346361.1|	1919394	1919409	A	15	+	15	A
gi|514486271|gb|KE346361.1|	1920157	1920171	AATGGAC	14	-	2	CCATTGT
gi|514486271|gb|KE346361.1|	1920600	1920615	AAAGAAG	15	-	2	TTCTTCT
gi|514486271|gb|KE346361.1|	1921832	1921848	AAAC	16	+	4	AAAC
gi|514486271|gb|KE346361.1|	1921851	1921865	AAAAC	14	+	2	AAAAC
gi|514486271|gb|KE346361.1|	1922401	1922417	AAAAACC	16	+	2	ACCAAAA
gi|514486271|gb|KE346361.1|	1925583	1925600	AAACCTG	17	+	2	AAACCTG
gi|514486271|gb|KE346361.1|	1926445	1926460	AGATCGG	15	-	2	ATCTCCG
gi|514486271|gb|KE346361.1|	1927424	1927440	AAGAGAG	16	+	2	AGAGAGA
gi|514486271|gb|KE346361.1|	1927676	1927697	A	21	-	21	T
gi|514486271|gb|KE346361.1|	1929310	1929331	A	21	-	21	T
gi|514486271|gb|KE346361.1|	1931291	1931305	A	14	-	14	T
gi|514486271|gb|KE346361.1|	1932698	1932712	AAGCCAG	14	-	2	CTGGCTT
gi|514486271|gb|KE346361.1|	1934519	1934533	AACGGC	14	+	2	CAACGG
gi|514486271|gb|KE346361.1|	1938890	1938908	A	18	+	18	A
gi|514486271|gb|KE346361.1|	1938910	1938927	A	17	+	17	A
gi|514486271|gb|KE346361.1|	1938933	1938947	AAAC	14	+	3	AACA
gi|514486271|gb|KE346361.1|	1940035	1940049	ACTCGG	14	-	2	GTCCGA
gi|514486271|gb|KE346361.1|	1940235	1940250	AAAAAT	15	+	2	AAATAA
gi|514486271|gb|KE346361.1|	1940287	1940306	A	19	-	19	T
gi|514486271|gb|KE346361.1|	1940326	1940350	AG	24	-	12	TC
gi|514486271|gb|KE346361.1|	1940360	1940375	AAAGAG	15	-	2	TCTTTC
gi|514486271|gb|KE346361.1|	1940921	1940935	AGC	14	-	4	CTG
gi|514486271|gb|KE346361.1|	1941028	1941046	AAAGAAT	18	+	2	AGAATAA
gi|514486271|gb|KE346361.1|	1941053	1941068	AAAAAAG	15	+	2	AAAAAAG
gi|514486271|gb|KE346361.1|	1944844	1944904	AGC	60	+	20	CAG
gi|514486271|gb|KE346361.1|	1944950	1944965	AGCAGG	15	+	2	CAGGAG
gi|514486271|gb|KE346361.1|	1944960	1944985	AGC	25	+	8	AGC
gi|514486271|gb|KE346361.1|	1944983	1944997	AAC	14	+	4	CAA
gi|514486271|gb|KE346361.1|	1948141	1948155	AGC	14	-	4	CTG
gi|514486271|gb|KE346361.1|	1949744	1949758	AGC	14	+	4	GCA
gi|514486271|gb|KE346361.1|	1949869	1949889	AGCGGC	20	-	3	CGCTGC
gi|514486271|gb|KE346361.1|	1950468	1950522	AAAAGC	54	+	9	AAGCAA
gi|514486271|gb|KE346361.1|	1950715	1950730	AAGCAG	15	-	2	CTGCTT
gi|514486271|gb|KE346361.1|	1952761	1952778	AAAAAAC	17	-	2	TTTTTGT
gi|514486271|gb|KE346361.1|	1953743	1953764	ACCAGC	21	-	3	TGGTGC
gi|514486271|gb|KE346361.1|	1956843	1956857	AAAG	14	+	3	AAAG
gi|514486271|gb|KE346361.1|	1957267	1957281	AGGGGCG	14	-	2	CCTCGCC
gi|514486271|gb|KE346361.1|	1957506	1957521	AAAAAC	15	-	2	TTTGTT
gi|514486271|gb|KE346361.1|	1957593	1957610	ACGC	17	+	4	CACG
gi|514486271|gb|KE346361.1|	1957703	1957725	AG	22	-	11	TC
gi|514486271|gb|KE346361.1|	1958062	1958082	A	20	-	20	T
gi|514486271|gb|KE346361.1|	1958216	1958235	A	19	-	19	T
gi|514486271|gb|KE346361.1|	1959033	1959051	A	18	+	18	A
gi|514486271|gb|KE346361.1|	1959465	1959479	A	14	-	14	T
gi|514486271|gb|KE346361.1|	1960020	1960047	AGAGGG	27	-	4	TCTCCC
gi|514486271|gb|KE346361.1|	1960767	1960781	AACAGC	14	+	2	CAACAG
gi|514486271|gb|KE346361.1|	1960785	1960799	AGC	14	+	4	CAG
gi|514486271|gb|KE346361.1|	1960878	1960892	AGCGGC	14	-	2	GCCGCT
gi|514486271|gb|KE346361.1|	1961288	1961303	AGC	15	+	5	GCA
gi|514486271|gb|KE346361.1|	1961849	1961863	ACG	14	-	4	CGT
gi|514486271|gb|KE346361.1|	1962611	1962625	AAAAAAC	14	+	2	AAAAAAC
gi|514486271|gb|KE346361.1|	1962787	1962801	AAC	14	+	4	AAC
gi|514486271|gb|KE346361.1|	1963023	1963040	AAC	17	-	5	TTG
gi|514486271|gb|KE346361.1|	1966420	1966434	AAAC	14	-	3	TTGT
gi|514486271|gb|KE346361.1|	1966448	1966463	AAAC	15	-	3	TTGT
gi|514486271|gb|KE346361.1|	1970204	1970239	AG	35	-	17	TC
gi|514486271|gb|KE346361.1|	1970240	1970423	AG	183	-	91	TC
gi|514486271|gb|KE346361.1|	1970467	1970481	ACGCCG	14	-	2	CGGCGT
gi|514486271|gb|KE346361.1|	1970499	1970515	AGC	16	+	5	AGC
gi|514486271|gb|KE346361.1|	1970728	1970745	AGC	17	+	5	AGC
gi|514486271|gb|KE346361.1|	1971452	1971473	ACC	21	-	7	TGG
gi|514486271|gb|KE346361.1|	1972009	1972024	AAAC	15	-	3	TTTG
gi|514486271|gb|KE346361.1|	1972305	1972319	ACG	14	-	4	TCG
gi|514486271|gb|KE346361.1|	1973501	1973534	AG	33	-	16	CT
gi|514486271|gb|KE346361.1|	1973756	1973772	AGC	16	-	5	GCT
gi|514486271|gb|KE346361.1|	1975313	1975329	ACC	16	+	5	CCA
gi|514486271|gb|KE346361.1|	1975924	1975979	AGC	55	+	18	AGC
gi|514486271|gb|KE346361.1|	1975993	1976007	CCGGCG	14	+	2	CCGGCG
gi|514486271|gb|KE346361.1|	1976297	1976314	ACCGCC	17	+	2	CCACCG
gi|514486271|gb|KE346361.1|	1976309	1976327	ACC	18	+	6	CCA
gi|514486271|gb|KE346361.1|	1977599	1977614	AGC	15	+	5	GCA
gi|514486271|gb|KE346361.1|	1979335	1979355	ATC	20	-	6	TGA
gi|514486271|gb|KE346361.1|	1980397	1980415	A	18	+	18	A
gi|514486271|gb|KE346361.1|	1980623	1980642	A	19	-	19	T
gi|514486271|gb|KE346361.1|	1980852	1980868	A	16	-	16	T
gi|514486271|gb|KE346361.1|	1981240	1981254	AAAG	14	+	3	GAAA
gi|514486271|gb|KE346361.1|	1982594	1982613	ACGCG	19	+	3	CGACG
gi|514486271|gb|KE346361.1|	1983434	1983452	A	18	+	18	A
gi|514486271|gb|KE346361.1|	1984224	1984240	AAG	16	-	5	CTT
gi|514486271|gb|KE346361.1|	1984573	1984593	A	20	-	20	T
gi|514486271|gb|KE346361.1|	1986134	1986151	AAAAG	17	-	3	TTCTT
gi|514486271|gb|KE346361.1|	1986162	1986178	AAAAG	16	-	3	TTCTT
gi|514486271|gb|KE346361.1|	1986281	1986295	AAAAT	14	-	2	TTTTA
gi|514486271|gb|KE346361.1|	1986312	1986329	AAT	17	-	5	TTA
gi|514486271|gb|KE346361.1|	1986629	1986647	A	18	-	18	T
gi|514486271|gb|KE346361.1|	1987098	1987121	ACAGAG	23	-	3	TCTCTG
gi|514486271|gb|KE346361.1|	1987951	1987968	AAG	17	-	5	TCT
gi|514486271|gb|KE346361.1|	1989398	1989422	AGC	24	+	8	GCA
gi|514486271|gb|KE346361.1|	1990795	1990813	A	18	+	18	A
gi|514486271|gb|KE346361.1|	1990875	1990889	ACCC	14	-	3	TGGG
gi|514486271|gb|KE346361.1|	1990987	1991003	AGCATC	16	+	2	AGCATC
gi|514486271|gb|KE346361.1|	1991074	1991201	AC	127	+	63	CA
gi|514486271|gb|KE346361.1|	1992142	1992156	AACAGC	14	+	2	CAGCAA
gi|514486271|gb|KE346361.1|	1993242	1993256	AAAAAG	14	-	2	TTTTTC
gi|514486271|gb|KE346361.1|	1993408	1993427	AAAAG	19	-	3	TTTTC
gi|514486271|gb|KE346361.1|	1993612	1993635	AAAAAG	23	-	3	TTTTTC
gi|514486271|gb|KE346361.1|	1994319	1994343	A	24	+	24	A
gi|514486271|gb|KE346361.1|	1994375	1994390	AAAAAGC	15	-	2	TGCTTTT
gi|514486271|gb|KE346361.1|	1994426	1994440	AAG	14	-	4	TTC
gi|514486271|gb|KE346361.1|	1994585	1994606	A	21	-	21	T
gi|514486271|gb|KE346361.1|	1995475	1995489	AAAAAAC	14	+	2	CAAAAAA
gi|514486271|gb|KE346361.1|	1995723	1995744	A	21	+	21	A
gi|514486271|gb|KE346361.1|	1996729	1996743	AAAAAGC	14	+	2	AGCAAAA
gi|514486271|gb|KE346361.1|	1996757	1996776	A	19	-	19	T
gi|514486271|gb|KE346361.1|	1997258	1997272	ACAGAG	14	-	2	TCTCTG
gi|514486271|gb|KE346361.1|	1997696	1997710	ACG	14	-	4	TCG
gi|514486271|gb|KE346361.1|	1998880	1998909	ACTGAG	29	+	4	AGACTG
gi|514486271|gb|KE346361.1|	1999237	1999254	AAAATG	17	-	2	TTTTCA
gi|514486271|gb|KE346361.1|	1999348	1999366	AAG	18	-	6	CTT
gi|514486271|gb|KE346361.1|	1999444	1999459	AACCCC	15	+	2	CAACCC
gi|514486271|gb|KE346361.1|	1999548	1999573	A	25	-	25	T
gi|514486271|gb|KE346361.1|	1999578	1999594	A	16	-	16	T
gi|514486271|gb|KE346361.1|	1999643	1999667	AAG	24	-	8	CTT
gi|514486271|gb|KE346361.1|	1999788	1999817	A	29	+	29	A
gi|514486271|gb|KE346361.1|	1999991	2000007	AC	16	-	8	TG
gi|514486271|gb|KE346361.1|	2001688	2001710	A	22	+	22	A
gi|514486271|gb|KE346361.1|	2002225	2002240	A	15	-	15	T
gi|514486271|gb|KE346361.1|	2002615	2002630	AACCCT	15	-	2	TTAGGG
gi|514486271|gb|KE346361.1|	2002977	2002996	A	19	-	19	T
gi|514486271|gb|KE346361.1|	2003139	2003154	A	15	+	15	A
gi|514486271|gb|KE346361.1|	2003311	2003331	A	20	+	20	A
gi|514486271|gb|KE346361.1|	2004451	2004472	AAAAAAC	21	-	3	TTTTTTG
gi|514486271|gb|KE346361.1|	2004511	2004527	AAG	16	-	5	TCT
gi|514486271|gb|KE346361.1|	2004739	2004753	A	14	-	14	T
gi|514486271|gb|KE346361.1|	2004755	2004771	A	16	-	16	T
gi|514486271|gb|KE346361.1|	2005107	2005121	AAACTCC	14	+	2	TCCAAAC
gi|514486271|gb|KE346361.1|	2008836	2008852	AAC	16	+	5	CAA
gi|514486271|gb|KE346361.1|	2008853	2008878	A	25	+	25	A
gi|514486271|gb|KE346361.1|	2008933	2008947	AGGGGGG	14	+	2	GGAGGGG
gi|514486271|gb|KE346361.1|	2009068	2009108	A	40	+	40	A
gi|514486271|gb|KE346361.1|	2009136	2009159	AAAAAT	23	+	3	AAAAAT
gi|514486271|gb|KE346361.1|	2009160	2009182	AAAAAT	22	+	3	AAAAAT
gi|514486271|gb|KE346361.1|	2009341	2009355	A	14	+	14	A
gi|514486271|gb|KE346361.1|	2009518	2009533	AAGGGC	15	-	2	GCCCTT
gi|514486271|gb|KE346361.1|	2009569	2009586	A	17	-	17	T
gi|514486271|gb|KE346361.1|	2009886	2009901	AATGAC	15	+	2	ATGACA
gi|514486271|gb|KE346361.1|	2011023	2011040	AAAAAT	17	-	2	TTTTTA
gi|514486271|gb|KE346361.1|	2011291	2011305	AGGGGC	14	+	2	GGGGCA
gi|514486271|gb|KE346361.1|	2011423	2011445	A	22	+	22	A
gi|514486271|gb|KE346361.1|	2011471	2011485	AAAAAT	14	-	2	TTATTT
gi|514486271|gb|KE346361.1|	2013105	2013120	A	15	-	15	T
gi|514486271|gb|KE346361.1|	2013873	2013899	A	26	-	26	T
gi|514486271|gb|KE346361.1|	2014596	2014613	AAC	17	-	5	TTG
gi|514486271|gb|KE346361.1|	2017351	2017368	AGC	17	-	5	TGC
gi|514486271|gb|KE346361.1|	2019934	2019949	ACG	15	+	5	CGA
gi|514486271|gb|KE346361.1|	2021081	2021097	AAAAC	16	-	3	TTTTG
gi|514486271|gb|KE346361.1|	2021617	2021635	AAAACAC	18	-	2	TTGTGTT
gi|514486271|gb|KE346361.1|	2021896	2021910	AAAAAAT	14	+	2	AAAATAA
gi|514486271|gb|KE346361.1|	2022473	2022496	AGC	23	+	7	AGC
gi|514486271|gb|KE346361.1|	2022763	2022792	AACAGC	29	-	4	TGCTGT
gi|514486271|gb|KE346361.1|	2022790	2022806	AGCATC	16	-	2	TGCTGA
gi|514486271|gb|KE346361.1|	2023359	2023373	AGC	14	-	4	TGC
gi|514486271|gb|KE346361.1|	2023626	2023640	AAGCAG	14	+	2	GCAGAA
gi|514486271|gb|KE346361.1|	2023946	2023962	ACCAGT	16	-	2	TGGTAC
gi|514486271|gb|KE346361.1|	2024002	2024019	CCG	17	+	5	CGC
gi|514486271|gb|KE346361.1|	2024336	2024353	A	17	+	17	A
gi|514486271|gb|KE346361.1|	2024515	2024529	AC	14	+	7	AC
gi|514486271|gb|KE346361.1|	2025235	2025252	AC	17	-	8	GT
gi|514486271|gb|KE346361.1|	2025563	2025577	AACAGC	14	-	2	TGTTGC
gi|514486271|gb|KE346361.1|	2025673	2025689	ACATCC	16	+	2	CACATC
gi|514486271|gb|KE346361.1|	2026054	2026082	A	28	-	28	T
gi|514486271|gb|KE346361.1|	2026285	2026299	AAAAT	14	-	2	TTTTA
gi|514486271|gb|KE346361.1|	2026292	2026306	AAAAAAT	14	-	2	TTATTTT
gi|514486271|gb|KE346361.1|	2026302	2026323	AAAAAT	21	-	3	TTTTAT
gi|514486271|gb|KE346361.1|	2026316	2026338	AAAAT	22	-	4	TTATT
gi|514486271|gb|KE346361.1|	2026423	2026445	A	22	+	22	A
gi|514486271|gb|KE346361.1|	2026482	2026497	ACAGAG	15	-	2	CTGTCT
gi|514486271|gb|KE346361.1|	2026558	2026574	AG	16	-	8	TC
gi|514486271|gb|KE346361.1|	2026632	2026652	A	20	+	20	A
gi|514486271|gb|KE346361.1|	2026810	2026824	AAAACG	14	+	2	AACGAA
gi|514486271|gb|KE346361.1|	2027068	2027092	A	24	-	24	T
gi|514486271|gb|KE346361.1|	2027340	2027356	AATG	16	-	4	ATTC
gi|514486271|gb|KE346361.1|	2027733	2027747	AGGCGG	14	-	2	CCTCCG
gi|514486271|gb|KE346361.1|	2029616	2029633	ACTCTC	17	-	2	GAGAGT
gi|514486271|gb|KE346361.1|	2029641	2029656	ACTCTC	15	-	2	GAGTGA
gi|514486271|gb|KE346361.1|	2029928	2029947	AAG	19	+	6	AGA
gi|514486271|gb|KE346361.1|	2032122	2032136	AGC	14	-	4	TGC
gi|514486271|gb|KE346361.1|	2032242	2032256	A	14	+	14	A
gi|514486271|gb|KE346361.1|	2032260	2032274	A	14	+	14	A
gi|514486271|gb|KE346361.1|	2032571	2032585	AATG	14	-	3	CATT
gi|514486271|gb|KE346361.1|	2033116	2033134	A	18	-	18	T
gi|514486271|gb|KE346361.1|	2034152	2034166	AAGACC	14	-	2	CTTGGT
gi|514486271|gb|KE346361.1|	2034715	2034729	AAAAGG	14	-	2	TTTTCC
gi|514486271|gb|KE346361.1|	2034868	2034882	A	14	-	14	T
gi|514486271|gb|KE346361.1|	2034983	2034998	AGC	15	+	5	CAG
gi|514486271|gb|KE346361.1|	2035020	2035047	AGC	27	+	9	AGC
gi|514486271|gb|KE346361.1|	2036150	2036166	AGC	16	+	5	CAG
gi|514486271|gb|KE346361.1|	2037099	2037116	ATC	17	+	5	TCA
gi|514486271|gb|KE346361.1|	2038584	2038598	AAC	14	-	4	TGT
gi|514486271|gb|KE346361.1|	2039464	2039482	AATCTC	18	-	3	GATTGA
gi|514486271|gb|KE346361.1|	2039481	2039495	A	14	+	14	A
gi|514486271|gb|KE346361.1|	2039505	2039520	AAAAAAC	15	+	2	CAAAAAA
gi|514486271|gb|KE346361.1|	2041369	2041385	AAAAGC	16	+	2	CAAAAG
gi|514486271|gb|KE346361.1|	2041386	2041403	AAAAGC	17	+	2	CAAAAG
gi|514486271|gb|KE346361.1|	2041398	2041426	AAAACC	28	+	4	CAAAAC
gi|514486271|gb|KE346361.1|	2041424	2041439	AACAACC	15	+	2	AACCAAC
gi|514486271|gb|KE346361.1|	2043417	2043432	AAG	15	+	5	AAG
gi|514486271|gb|KE346361.1|	2043452	2043466	ACATCT	14	+	2	CATCTA
gi|514486271|gb|KE346361.1|	2045009	2045049	AG	40	+	20	AG
gi|514486271|gb|KE346361.1|	2046572	2046586	AAACATC	14	+	2	TCAAACA
gi|514486271|gb|KE346361.1|	2053346	2053361	AGC	15	-	5	TGC
gi|514486271|gb|KE346361.1|	2053379	2053394	AGC	15	-	5	TGC
gi|514486271|gb|KE346361.1|	2053820	2053835	AACGCGC	15	-	2	GCGCGTT
gi|514486271|gb|KE346361.1|	2054216	2054242	A	26	+	26	A
gi|514486271|gb|KE346361.1|	2054372	2054395	AAAC	23	+	5	AAAC
gi|514486271|gb|KE346361.1|	2054388	2054408	AAAAAAC	20	+	2	AAACAAA
gi|514486271|gb|KE346361.1|	2055278	2055293	A	15	+	15	A
gi|514486271|gb|KE346361.1|	2055496	2055513	AC	17	+	8	CA
gi|514486271|gb|KE346361.1|	2056026	2056045	AAC	19	-	6	GTT
gi|514486271|gb|KE346361.1|	2056105	2056119	ACCAGAG	14	+	2	CCAGAGA
gi|514486271|gb|KE346361.1|	2057118	2057145	A	27	+	27	A
gi|514486271|gb|KE346361.1|	2057420	2057435	AATGGC	15	+	2	CAATGG
gi|514486271|gb|KE346361.1|	2057979	2057993	AACTC	14	-	2	GTTGA
gi|514486271|gb|KE346361.1|	2058277	2058291	AGCG	14	+	3	CGAG
gi|514486271|gb|KE346361.1|	2058454	2058472	AAGAAGG	18	+	2	GGAAGAA
gi|514486271|gb|KE346361.1|	2058475	2058492	AAG	17	+	5	GAA
gi|514486271|gb|KE346361.1|	2059116	2059133	AC	17	+	8	AC
gi|514486271|gb|KE346361.1|	2060446	2060460	CCCG	14	-	3	GGCG
gi|514486271|gb|KE346361.1|	2060506	2060521	AAGGCAG	15	-	2	CCTTCTG
gi|514486271|gb|KE346361.1|	2060796	2060823	AAACG	27	-	5	TCGTT
gi|514486271|gb|KE346361.1|	2060826	2060843	AAACG	17	-	3	TCGTT
gi|514486271|gb|KE346361.1|	2062403	2062428	AAAC	25	-	6	TTGT
gi|514486271|gb|KE346361.1|	2062740	2062755	A	15	-	15	T
gi|514486271|gb|KE346361.1|	2063805	2063819	AGCGCG	14	+	2	AGCGCG
gi|514486271|gb|KE346361.1|	2064215	2064229	A	14	-	14	T
gi|514486271|gb|KE346361.1|	2064815	2064834	CCG	19	+	6	GCC
gi|514486271|gb|KE346361.1|	2065046	2065063	AGCCGG	17	-	2	GCTCCG
gi|514486271|gb|KE346361.1|	2065119	2065137	ACCACG	18	-	3	GGTCGT
gi|514486271|gb|KE346361.1|	2065138	2065152	ACCACG	14	-	2	GTCGTG
gi|514486271|gb|KE346361.1|	2065218	2065233	AGCATC	15	-	2	CTGATG
gi|514486271|gb|KE346361.1|	2065318	2065363	ATC	45	-	15	TGA
gi|514486271|gb|KE346361.1|	2065493	2065511	AAGAGAG	18	+	2	GAGAAGA
gi|514486271|gb|KE346361.1|	2065520	2065541	AAGAGAG	21	+	3	AGAGAGA
gi|514486271|gb|KE346361.1|	2065534	2065551	AG	17	+	8	AG
gi|514486271|gb|KE346361.1|	2065674	2065688	AG	14	+	7	GA
gi|514486271|gb|KE346361.1|	2065827	2065841	AACATC	14	-	2	TGATGT
gi|514486271|gb|KE346361.1|	2065836	2065855	AAC	19	-	6	TGT
gi|514486271|gb|KE346361.1|	2066180	2066194	AATTCCC	14	+	2	TCCCAAT
gi|514486271|gb|KE346361.1|	2066558	2066576	ACTGAG	18	-	3	CTCAGT
gi|514486271|gb|KE346361.1|	2067714	2067732	ACG	18	+	6	CGA
gi|514486271|gb|KE346361.1|	2067808	2067825	ACG	17	+	5	GAC
gi|514486271|gb|KE346361.1|	2069065	2069088	A	23	-	23	T
gi|514486271|gb|KE346361.1|	2069655	2069674	A	19	-	19	T
gi|514486271|gb|KE346361.1|	2069675	2069693	A	18	-	18	T
gi|514486271|gb|KE346361.1|	2070730	2070745	ACCGCC	15	-	2	GCGGTG
gi|514486271|gb|KE346361.1|	2070752	2070793	AAC	41	+	13	CAA
gi|514486271|gb|KE346361.1|	2071537	2071552	AGCGGC	15	-	2	GCCGCT
gi|514486271|gb|KE346361.1|	2071609	2071624	AG	15	-	7	CT
gi|514486271|gb|KE346361.1|	2071677	2071695	AAAAAAT	18	-	2	TTTTATT
gi|514486271|gb|KE346361.1|	2071864	2071879	A	15	+	15	A
gi|514486271|gb|KE346361.1|	2072120	2072135	A	15	-	15	T
gi|514486271|gb|KE346361.1|	2072156	2072172	AAAG	16	-	4	CTTT
gi|514486271|gb|KE346361.1|	2072356	2072370	A	14	-	14	T
gi|514486271|gb|KE346361.1|	2072692	2072707	AGCGGC	15	-	2	CGCTGC
gi|514486271|gb|KE346361.1|	2073390	2073405	ACGGGC	15	-	2	GTGCCC
gi|514486271|gb|KE346361.1|	2074424	2074448	A	24	-	24	T
gi|514486271|gb|KE346361.1|	2074445	2074472	AAAC	27	-	6	TTTG
gi|514486271|gb|KE346361.1|	2081677	2081691	AAAAG	14	-	2	TTTCT
gi|514486271|gb|KE346361.1|	2082105	2082122	AAACAGC	17	-	2	TTTGCTG
gi|514486271|gb|KE346361.1|	2082162	2082176	AAGGTGG	14	-	2	CCTTCCA
gi|514486271|gb|KE346361.1|	2082520	2082537	A	17	-	17	T
gi|514486271|gb|KE346361.1|	2082601	2082618	ACACCC	17	+	2	CACACC
gi|514486271|gb|KE346361.1|	2082862	2082876	A	14	+	14	A
gi|514486271|gb|KE346361.1|	2083065	2083079	AAAAAAC	14	-	2	TTTTGTT
gi|514486271|gb|KE346361.1|	2083556	2083582	A	26	+	26	A
gi|514486271|gb|KE346361.1|	2085005	2085022	AGC	17	-	5	TGC
gi|514486271|gb|KE346361.1|	2085042	2085056	ACC	14	-	4	GGT
gi|514486271|gb|KE346361.1|	2086104	2086131	A	27	+	27	A
gi|514486271|gb|KE346361.1|	2086917	2086931	ACGACGG	14	-	2	CGTCGTC
gi|514486271|gb|KE346361.1|	2087341	2087367	A	26	+	26	A
gi|514486271|gb|KE346361.1|	2087401	2087419	A	18	-	18	T
gi|514486271|gb|KE346361.1|	2087490	2087513	AC	23	-	11	GT
gi|514486271|gb|KE346361.1|	2087545	2087559	AAC	14	-	4	TTG
gi|514486271|gb|KE346361.1|	2088496	2088511	AAAAAAC	15	-	2	TTTTTTG
gi|514486271|gb|KE346361.1|	2090447	2090471	ATC	24	+	8	TCA
gi|514486271|gb|KE346361.1|	2093643	2093658	AAAAAAC	15	-	2	TTTTTTG
gi|514486271|gb|KE346361.1|	2095594	2095618	ATC	24	+	8	TCA
gi|514486271|gb|KE346361.1|	2096860	2096879	AGC	19	-	6	CTG
gi|514486271|gb|KE346361.1|	2098316	2098335	AAC	19	+	6	CAA
gi|514486271|gb|KE346361.1|	2098593	2098622	ATC	29	+	9	TCA
gi|514486271|gb|KE346361.1|	2098632	2098646	ATC	14	-	4	ATG
gi|514486271|gb|KE346361.1|	2100118	2100132	AGCGCG	14	-	2	TCGCGC
gi|514486271|gb|KE346361.1|	2101351	2101367	ACG	16	-	5	GTC
gi|514486271|gb|KE346361.1|	2101531	2101559	AAAAGCC	28	+	4	CAAAAGC
gi|514486271|gb|KE346361.1|	2101552	2101569	AAAAGC	17	+	2	CAAAAG
gi|514486271|gb|KE346361.1|	2105403	2105418	ACAG	15	+	3	AGAC
gi|514486271|gb|KE346361.1|	2105634	2105661	A	27	-	27	T
gi|514486271|gb|KE346361.1|	2105657	2105673	AAAACC	16	-	2	TTTTGG
gi|514486271|gb|KE346361.1|	2105750	2105765	ACC	15	-	5	GGT
gi|514486271|gb|KE346361.1|	2106224	2106240	AAG	16	-	5	TTC
gi|514486271|gb|KE346361.1|	2107196	2107219	AG	23	-	11	CT
gi|514486271|gb|KE346361.1|	2108894	2108910	AAC	16	-	5	TTG
gi|514486271|gb|KE346361.1|	2109243	2109267	A	24	-	24	T
gi|514486271|gb|KE346361.1|	2109842	2109912	AAC	70	+	23	CAA
gi|514486271|gb|KE346361.1|	2114567	2114584	AAAACT	17	-	2	GTTTTA
gi|514486271|gb|KE346361.1|	2117349	2117363	AGC	14	-	4	TGC
gi|514486271|gb|KE346361.1|	2117361	2117378	AAC	17	-	5	TGT
gi|514486271|gb|KE346361.1|	2117376	2117411	AGC	35	-	11	TGC
gi|514486271|gb|KE346361.1|	2117838	2117852	AACAGC	14	-	2	TGTTGC
gi|514486271|gb|KE346361.1|	2117925	2117942	AACAGC	17	-	2	TGTTGC
gi|514486271|gb|KE346361.1|	2117952	2117966	AGC	14	-	4	TGC
gi|514486271|gb|KE346361.1|	2118480	2118494	ATC	14	-	4	GAT
gi|514486271|gb|KE346361.1|	2118719	2118738	AAGGAC	19	+	3	GGACAA
gi|514486271|gb|KE346361.1|	2118824	2118849	ACG	25	+	8	CGA
gi|514486271|gb|KE346361.1|	2118999	2119013	AAAAACC	14	+	2	AAAAACC
gi|514486271|gb|KE346361.1|	2119569	2119584	AAG	15	+	5	GAA
gi|514486271|gb|KE346361.1|	2119915	2119929	AACCGC	14	+	2	CAACCG
gi|514486271|gb|KE346361.1|	2120117	2120145	AAAAAT	28	+	4	AAAATA
gi|514486271|gb|KE346361.1|	2120176	2120198	A	22	-	22	T
gi|514486271|gb|KE346361.1|	2120379	2120395	AC	16	+	8	CA
gi|514486271|gb|KE346361.1|	2120394	2120415	A	21	+	21	A
gi|514486271|gb|KE346361.1|	2120581	2120600	A	19	-	19	T
gi|514486271|gb|KE346361.1|	2120797	2120818	AAAAT	21	+	4	AAAAT
gi|514486271|gb|KE346361.1|	2120840	2120854	A	14	+	14	A
gi|514486271|gb|KE346361.1|	2121065	2121082	ACACACT	17	+	2	ACACACT
gi|514486271|gb|KE346361.1|	2127663	2127677	AGCAGG	14	+	2	AGGAGC
gi|514486271|gb|KE346361.1|	2127721	2127752	AGC	31	+	10	GCA
gi|514486271|gb|KE346361.1|	2128317	2128344	AAAAACC	27	-	3	TTGGTTT
gi|514486271|gb|KE346361.1|	2128356	2128375	A	19	-	19	T
gi|514486271|gb|KE346361.1|	2128369	2128387	AAAAAAG	18	-	2	TTTTTTC
gi|514486271|gb|KE346361.1|	2128495	2128510	AGAGAT	15	+	2	AGATAG
gi|514486271|gb|KE346361.1|	2128834	2128849	AAAC	15	-	3	TTTG
gi|514486271|gb|KE346361.1|	2131014	2131029	AGC	15	+	5	GCA
gi|514486271|gb|KE346361.1|	2131075	2131099	ACGAGCC	24	-	3	GGCTCGT
gi|514486271|gb|KE346361.1|	2131455	2131471	AAAAAAG	16	-	2	TTCTTTT
gi|514486271|gb|KE346361.1|	2131858	2131876	ATC	18	+	6	TCA
gi|514486271|gb|KE346361.1|	2133340	2133413	AGG	73	+	24	AGG
gi|514486271|gb|KE346361.1|	2133418	2133464	AGG	46	+	15	AGG
gi|514486271|gb|KE346361.1|	2135328	2135342	ACCTCC	14	-	2	GGAGGT
gi|514486271|gb|KE346361.1|	2137143	2137157	AAC	14	-	4	TGT
gi|514486271|gb|KE346361.1|	2137161	2137181	AAC	20	-	6	TGT
gi|514486271|gb|KE346361.1|	2139915	2139940	A	25	+	25	A
gi|514486271|gb|KE346361.1|	2140839	2140858	AGCGGC	19	-	3	CCGCTG
gi|514486271|gb|KE346361.1|	2141707	2141722	AAAGAG	15	+	2	GAAAGA
gi|514486271|gb|KE346361.1|	2143873	2143899	AGG	26	+	8	GAG
gi|514486271|gb|KE346361.1|	2147201	2147217	AAAAAC	16	-	2	TTTTTG
gi|514486271|gb|KE346361.1|	2148684	2148701	AGG	17	-	5	CCT
gi|514486271|gb|KE346361.1|	2148790	2148804	ATCATG	14	+	2	ATGATC
gi|514486271|gb|KE346361.1|	2149246	2149269	ACCG	23	-	5	GGTC
gi|514486271|gb|KE346361.1|	2149578	2149595	AG	17	+	8	AG
gi|514486271|gb|KE346361.1|	2150088	2150103	ATCGCC	15	+	2	TCGCCA
gi|514486271|gb|KE346361.1|	2150369	2150399	A	30	+	30	A
gi|514486271|gb|KE346361.1|	2150647	2150664	AGCATC	17	-	2	TGATGC
gi|514486271|gb|KE346361.1|	2154469	2154483	AACG	14	+	3	CGAA
gi|514486271|gb|KE346361.1|	2156560	2156577	AGC	17	-	5	TGC
gi|514486271|gb|KE346361.1|	2156584	2156598	AGC	14	-	4	TGC
gi|514486271|gb|KE346361.1|	2157394	2157408	CCG	14	-	4	GCG
gi|514486271|gb|KE346361.1|	2158975	2158989	AGCCGC	14	+	2	GCCGCA
gi|514486271|gb|KE346361.1|	2159634	2159649	AGCGGC	15	-	2	GCCGCT
gi|514486271|gb|KE346361.1|	2160655	2160670	AAC	15	-	5	TGT
gi|514486271|gb|KE346361.1|	2160671	2160687	AACAGC	16	-	2	GTTGCT
gi|514486271|gb|KE346361.1|	2163295	2163312	AAC	17	+	5	CAA
gi|514486271|gb|KE346361.1|	2163584	2163605	A	21	+	21	A
gi|514486271|gb|KE346361.1|	2163796	2163814	A	18	+	18	A
gi|514486271|gb|KE346361.1|	2163827	2163841	A	14	-	14	T
gi|514486271|gb|KE346361.1|	2164194	2164209	AAAAAT	15	+	2	AAAATA
gi|514486271|gb|KE346361.1|	2164202	2164219	AAAAT	17	+	3	AATAA
gi|514486271|gb|KE346361.1|	2164275	2164311	AG	36	+	18	GA
gi|514486271|gb|KE346361.1|	2164551	2164565	AACGCAG	14	+	2	ACGCAGA
gi|514486271|gb|KE346361.1|	2166112	2166131	A	19	-	19	T
gi|514486271|gb|KE346361.1|	2167571	2167585	AACAGC	14	-	2	TGTTGC
gi|514486271|gb|KE346361.1|	2169446	2169461	AAC	15	-	5	TTG
gi|514486271|gb|KE346361.1|	2170563	2170579	AAAAAAT	16	-	2	TTTATTT
gi|514486271|gb|KE346361.1|	2170574	2170593	AAAAAAT	19	-	2	TTTTTAT
gi|514486271|gb|KE346361.1|	2170699	2170725	ACTC	26	+	6	TCAC
gi|514486271|gb|KE346361.1|	2170726	2170757	ACTC	31	+	7	CTCA
gi|514486271|gb|KE346361.1|	2170758	2170777	ACTC	19	+	4	CTCA
gi|514486271|gb|KE346361.1|	2170770	2170785	ACTCTC	15	+	2	CTCACT
gi|514486271|gb|KE346361.1|	2171253	2171269	AG	16	+	8	GA
gi|514486271|gb|KE346361.1|	2171554	2171569	A	15	-	15	T
gi|514486271|gb|KE346361.1|	2171571	2171586	AAAC	15	-	3	TTGT
gi|514486271|gb|KE346361.1|	2174494	2174509	ACGCTG	15	-	2	AGCGTC
gi|514486271|gb|KE346361.1|	2174793	2174807	AACGCCG	14	+	2	CGCCGAA
gi|514486271|gb|KE346361.1|	2175364	2175385	ATCGC	21	-	4	TGCGA
gi|514486271|gb|KE346361.1|	2176209	2176227	A	18	+	18	A
gi|514486271|gb|KE346361.1|	2179511	2179536	AAC	25	-	8	GTT
gi|514486271|gb|KE346361.1|	2179614	2179631	ACTCTG	17	-	2	GTCAGA
gi|514486271|gb|KE346361.1|	2181857	2181871	ACCAGCG	14	-	2	TCGCTGG
gi|514486271|gb|KE346361.1|	2182891	2182909	AGC	18	+	6	GCA
gi|514486271|gb|KE346361.1|	2183549	2183563	AGGGG	14	-	2	CTCCC
gi|514486271|gb|KE346361.1|	2183599	2183614	CCG	15	-	5	GGC
gi|514486271|gb|KE346361.1|	2183719	2183739	AGC	20	+	6	AGC
gi|514486271|gb|KE346361.1|	2186209	2186223	AATGCTC	14	-	2	AGCATTG
gi|514486271|gb|KE346361.1|	2186470	2186487	AGAGGG	17	+	2	GAGAGG
gi|514486271|gb|KE346361.1|	2186650	2186666	AGC	16	+	5	AGC
gi|514486271|gb|KE346361.1|	2186733	2186762	ACC	29	+	9	ACC
gi|514486271|gb|KE346361.1|	2187589	2187604	ATCGGC	15	+	2	GCATCG
gi|514486271|gb|KE346361.1|	2188292	2188314	AAATTCC	22	-	3	AATTTGG
gi|514486271|gb|KE346361.1|	2188683	2188697	AAC	14	-	4	TTG
gi|514486271|gb|KE346361.1|	2190264	2190279	ACGGC	15	+	3	CACGG
gi|514486271|gb|KE346361.1|	2191634	2191653	A	19	+	19	A
gi|514486271|gb|KE346361.1|	2191687	2191717	AAAC	30	+	7	AAAC
gi|514486271|gb|KE346361.1|	2194483	2194498	AAGGAG	15	+	2	AAGGAG
gi|514486271|gb|KE346361.1|	2194551	2194566	ACACC	15	+	3	CCACA
gi|514486271|gb|KE346361.1|	2194888	2194908	AAC	20	-	6	TGT
gi|514486271|gb|KE346361.1|	2194988	2195023	A	35	+	35	A
gi|514486271|gb|KE346361.1|	2195060	2195097	A	37	-	37	T
gi|514486271|gb|KE346361.1|	2195269	2195283	AAAAAAT	14	+	2	AAAAAAT
gi|514486271|gb|KE346361.1|	2195560	2195576	ACACAT	16	+	2	CACATA
gi|514486271|gb|KE346361.1|	2195929	2195949	A	20	-	20	T
gi|514486271|gb|KE346361.1|	2198776	2198832	A	56	+	56	A
gi|514486271|gb|KE346361.1|	2202601	2202615	AAGCGCG	14	-	2	TCGCGCT
gi|514486271|gb|KE346361.1|	2204186	2204200	AAAAC	14	+	2	AAAAC
gi|514486271|gb|KE346361.1|	2204834	2204856	A	22	+	22	A
gi|514486271|gb|KE346361.1|	2205105	2205131	A	26	-	26	T
gi|514486271|gb|KE346361.1|	2205205	2205241	AC	36	+	18	CA
gi|514486271|gb|KE346361.1|	2205334	2205348	A	14	-	14	T
gi|514486271|gb|KE346361.1|	2205784	2205805	A	21	+	21	A
gi|514486271|gb|KE346361.1|	2208057	2208071	AAAAAC	14	+	2	AACAAA
gi|514486271|gb|KE346361.1|	2209472	2209518	AGC	46	+	15	CAG
gi|514486271|gb|KE346361.1|	2210196	2210210	ATC	14	-	4	TGA
gi|514486271|gb|KE346361.1|	2211575	2211592	A	17	+	17	A
gi|514486271|gb|KE346361.1|	2211605	2211619	AAAAC	14	+	2	AAAAC
gi|514486271|gb|KE346361.1|	2211714	2211728	AGATCGG	14	-	2	CCGATCT
gi|514486271|gb|KE346361.1|	2212080	2212123	AAG	43	+	14	AAG
gi|514486271|gb|KE346361.1|	2212146	2212163	A	17	-	17	T
gi|514486271|gb|KE346361.1|	2212172	2212196	A	24	-	24	T
gi|514486271|gb|KE346361.1|	2212232	2212247	AG	15	-	7	TC
gi|514486271|gb|KE346361.1|	2212314	2212333	ACC	19	+	6	CAC
gi|514486271|gb|KE346361.1|	2217042	2217177	AC	135	-	67	GT
gi|514486271|gb|KE346361.1|	2217429	2217456	AGC	27	-	9	CTG
gi|514486271|gb|KE346361.1|	2218064	2218079	A	15	-	15	T
gi|514486271|gb|KE346361.1|	2218093	2218108	AAAAAAC	15	-	2	TTGTTTT
gi|514486271|gb|KE346361.1|	2218216	2218232	AC	16	+	8	CA
gi|514486271|gb|KE346361.1|	2218403	2218428	ACGAG	25	+	5	CGAGA
gi|514486271|gb|KE346361.1|	2218829	2218845	AGC	16	+	5	CAG
gi|514486271|gb|KE346361.1|	2219015	2219030	A	15	-	15	T
gi|514486271|gb|KE346361.1|	2219058	2219078	A	20	-	20	T
gi|514486271|gb|KE346361.1|	2219192	2219216	ATC	24	+	8	TCA
gi|514486271|gb|KE346361.1|	2220622	2220636	ACGAGG	14	-	2	TCCTCG
gi|514486271|gb|KE346361.1|	2222049	2222065	AAAAAG	16	-	2	TTTTTC
gi|514486271|gb|KE346361.1|	2225363	2225378	ACCAGCC	15	+	2	ACCAGCC
gi|514486271|gb|KE346361.1|	2227466	2227481	AC	15	+	7	CA
gi|514486271|gb|KE346361.1|	2228380	2228403	A	23	+	23	A
gi|514486271|gb|KE346361.1|	2229659	2229675	AAAAC	16	+	3	AAACA
gi|514486271|gb|KE346361.1|	2229792	2229806	ACCAGCC	14	+	2	CCAGCCA
gi|514486271|gb|KE346361.1|	2230438	2230456	A	18	+	18	A
gi|514486271|gb|KE346361.1|	2231800	2231815	ACCCCC	15	-	2	GTGGGG
gi|514486271|gb|KE346361.1|	2232266	2232288	AGCATG	22	-	3	TGCTCA
gi|514486271|gb|KE346361.1|	2232300	2232314	CCG	14	-	4	GGC
gi|514486271|gb|KE346361.1|	2232654	2232668	ACTC	14	-	3	GAGT
gi|514486271|gb|KE346361.1|	2232953	2232969	AGAGGG	16	+	2	GAGAGG
gi|514486271|gb|KE346361.1|	2233014	2233028	AGC	14	+	4	AGC
gi|514486271|gb|KE346361.1|	2233301	2233319	AGGGGG	18	+	3	GGAGGG
gi|514486271|gb|KE346361.1|	2234228	2234242	A	14	-	14	T
gi|514486271|gb|KE346361.1|	2234359	2234374	AAAGAC	15	-	2	TGTCTT
gi|514486271|gb|KE346361.1|	2235535	2235558	A	23	-	23	T
gi|514486271|gb|KE346361.1|	2235854	2235868	AGAGAT	14	+	2	AGAGAT
gi|514486271|gb|KE346361.1|	2236124	2236138	ACTC	14	-	3	GAGT
gi|514486271|gb|KE346361.1|	2236199	2236213	AAAAAT	14	-	2	TTTTAT
gi|514486271|gb|KE346361.1|	2236634	2236656	AAAGTTC	22	-	3	GAACTTT
gi|514486271|gb|KE346361.1|	2236846	2236860	AAAAAAC	14	-	2	TTTTTTG
gi|514486271|gb|KE346361.1|	2237308	2237323	ACCTCC	15	+	2	CTCCAC
gi|514486271|gb|KE346361.1|	2237394	2237411	AAC	17	+	5	CAA
gi|514486271|gb|KE346361.1|	2237528	2237543	ACT	15	+	5	ACT
gi|514486271|gb|KE346361.1|	2237538	2237552	ACTGCT	14	+	2	CTACTG
gi|514486271|gb|KE346361.1|	2239295	2239311	A	16	-	16	T
gi|514486271|gb|KE346361.1|	2241436	2241450	AGC	14	+	4	GCA
gi|514486271|gb|KE346361.1|	2241451	2241471	ACG	20	+	6	GAC
gi|514486271|gb|KE346361.1|	2241679	2241693	AAC	14	+	4	CAA
gi|514486271|gb|KE346361.1|	2243068	2243083	AAAC	15	-	3	TTTG
gi|514486271|gb|KE346361.1|	2244754	2244770	AAC	16	+	5	AAC
gi|514486271|gb|KE346361.1|	2244777	2244791	AAC	14	+	4	CAA
gi|514486271|gb|KE346361.1|	2245469	2245484	AAAAAAC	15	+	2	AAACAAA
gi|514486271|gb|KE346361.1|	2245477	2245493	AAAAC	16	+	3	AACAA
gi|514486271|gb|KE346361.1|	2245486	2245501	AAAC	15	+	3	AAAC
gi|514486271|gb|KE346361.1|	2245498	2245514	A	16	+	16	A
gi|514486271|gb|KE346361.1|	2247033	2247051	CCG	18	+	6	GCC
gi|514486271|gb|KE346361.1|	2247059	2247076	AGCAGG	17	-	2	CTCCTG
gi|514486271|gb|KE346361.1|	2247478	2247497	ACCGCG	19	+	3	CGACCG
gi|514486271|gb|KE346361.1|	2249436	2249460	A	24	+	24	A
gi|514486271|gb|KE346361.1|	2250244	2250258	AAC	14	-	4	TTG
gi|514486271|gb|KE346361.1|	2251185	2251203	ACG	18	-	6	GTC
gi|514486271|gb|KE346361.1|	2251283	2251299	AGC	16	-	5	GCT
gi|514486271|gb|KE346361.1|	2251468	2251488	ACCTGC	20	+	3	GCACCT
gi|514486271|gb|KE346361.1|	2252834	2252850	AAC	16	-	5	GTT
gi|514486271|gb|KE346361.1|	2254125	2254139	ACGAGG	14	+	2	GAGGAC
gi|514486271|gb|KE346361.1|	2254330	2254344	AAACAGC	14	+	2	ACAGCAA
gi|514486271|gb|KE346361.1|	2254597	2254611	AAC	14	-	4	TGT
gi|514486271|gb|KE346361.1|	2255727	2255748	ACTCTC	21	+	3	CTCACT
gi|514486271|gb|KE346361.1|	2257449	2257468	AGC	19	+	6	GCA
gi|514486271|gb|KE346361.1|	2257592	2257611	AGC	19	+	6	AGC
gi|514486271|gb|KE346361.1|	2258146	2258164	AACGG	18	+	3	AACGG
gi|514486271|gb|KE346361.1|	2258515	2258531	AG	16	-	8	TC
gi|514486271|gb|KE346361.1|	2258612	2258637	A	25	-	25	T
gi|514486271|gb|KE346361.1|	2258670	2258691	AAAAATC	21	-	3	ATTTTTG
gi|514486271|gb|KE346361.1|	2258843	2258864	A	21	+	21	A
gi|514486271|gb|KE346361.1|	2258877	2258913	A	36	+	36	A
gi|514486271|gb|KE346361.1|	2259267	2259304	AG	37	-	18	TC
gi|514486271|gb|KE346361.1|	2261438	2261452	AGC	14	+	4	AGC
gi|514486271|gb|KE346361.1|	2264139	2264153	ACTG	14	+	3	ACTG
gi|514486271|gb|KE346361.1|	2264366	2264392	A	26	-	26	T
gi|514486271|gb|KE346361.1|	2265147	2265166	AAC	19	-	6	GTT
gi|514486271|gb|KE346361.1|	2265161	2265211	AACAGC	50	-	8	TGTTGC
gi|514486271|gb|KE346361.1|	2265206	2265220	AGC	14	-	4	TGC
gi|514486271|gb|KE346361.1|	2266510	2266524	AAAACC	14	+	2	AACCAA
gi|514486271|gb|KE346361.1|	2266517	2266531	AAAAACC	14	+	2	ACCAAAA
gi|514486271|gb|KE346361.1|	2268088	2268103	AAC	15	+	5	ACA
gi|514486271|gb|KE346361.1|	2268104	2268118	AAAAACC	14	+	2	AAACCAA
gi|514486271|gb|KE346361.1|	2268127	2268141	AAAAAAC	14	+	2	ACAAAAA
gi|514486271|gb|KE346361.1|	2268725	2268739	ACTACTC	14	-	2	AGTGAGT
gi|514486271|gb|KE346361.1|	2269220	2269237	A	17	+	17	A
gi|514486271|gb|KE346361.1|	2269267	2269282	A	15	-	15	T
gi|514486271|gb|KE346361.1|	2271198	2271225	A	27	-	27	T
gi|514486271|gb|KE346361.1|	2271703	2271720	ATCC	17	-	4	TGGA
gi|514486271|gb|KE346361.1|	2272015	2272031	ATCGGC	16	+	2	TCGGCA
gi|514486271|gb|KE346361.1|	2272416	2272433	A	17	+	17	A
gi|514486271|gb|KE346361.1|	2273638	2273655	AAAAC	17	-	3	TTTGT
gi|514486271|gb|KE346361.1|	2273648	2273663	AAAC	15	-	3	TTTG
gi|514486271|gb|KE346361.1|	2274477	2274500	A	23	+	23	A
gi|514486271|gb|KE346361.1|	2274518	2274575	A	57	-	57	T
gi|514486271|gb|KE346361.1|	2274785	2274800	CCG	15	+	5	GCC
gi|514486271|gb|KE346361.1|	2274986	2275003	AAC	17	-	5	TTG
gi|514486271|gb|KE346361.1|	2276148	2276162	AACGCCG	14	-	2	TTCGGCG
gi|514486271|gb|KE346361.1|	2276446	2276461	ACGCTG	15	+	2	GCTGAC
gi|514486271|gb|KE346361.1|	2279591	2279607	AAAAAC	16	+	2	AAAAAC
gi|514486271|gb|KE346361.1|	2279703	2279718	AC	15	+	7	CA
gi|514486271|gb|KE346361.1|	2280089	2280105	AG	16	-	8	TC
gi|514486271|gb|KE346361.1|	2280106	2280122	AG	16	-	8	CT
gi|514486271|gb|KE346361.1|	2280283	2280298	AAAC	15	-	3	TTGT
gi|514486271|gb|KE346361.1|	2280545	2280560	AAG	15	+	5	AAG
gi|514486271|gb|KE346361.1|	2281772	2281789	A	17	+	17	A
gi|514486271|gb|KE346361.1|	2283299	2283333	AAAC	34	+	8	AAAC
gi|514486271|gb|KE346361.1|	2285890	2285904	AACGC	14	-	2	GCGTT
gi|514486271|gb|KE346361.1|	2287672	2287687	AGGGGGG	15	-	2	CCCCTCC
gi|514486271|gb|KE346361.1|	2287723	2287737	AAATC	14	-	2	GATTT
gi|514486271|gb|KE346361.1|	2287799	2287818	A	19	-	19	T
gi|514486271|gb|KE346361.1|	2288028	2288047	ACTCTC	19	+	3	CTCACT
gi|514486271|gb|KE346361.1|	2288127	2288148	ACTGCC	21	-	3	GGCAGT
gi|514486271|gb|KE346361.1|	2288366	2288383	CCG	17	-	5	CGG
gi|514486271|gb|KE346361.1|	2289123	2289149	AGC	26	+	8	CAG
gi|514486271|gb|KE346361.1|	2289150	2289164	AACAGC	14	+	2	CAGCAA
gi|514486271|gb|KE346361.1|	2289955	2289969	AC	14	-	7	TG
gi|514486271|gb|KE346361.1|	2290985	2291000	AAACAAC	15	-	2	TGTTGTT
gi|514486271|gb|KE346361.1|	2291333	2291442	AC	109	+	54	AC
gi|514486271|gb|KE346361.1|	2292597	2292617	ATC	20	-	6	ATG
gi|514486271|gb|KE346361.1|	2292816	2292833	AGC	17	-	5	CTG
gi|514486271|gb|KE346361.1|	2292828	2292849	AGCAGG	21	-	3	CTGCTC
gi|514486271|gb|KE346361.1|	2293271	2293312	ACTC	41	+	10	CTCA
gi|514486271|gb|KE346361.1|	2293391	2293406	AAAATAC	15	-	2	GTATTTT
gi|514486271|gb|KE346361.1|	2295222	2295236	ACCTCG	14	-	2	GTCGAG
gi|514486271|gb|KE346361.1|	2295530	2295547	AAAAAC	17	-	2	TTTTTG
gi|514486271|gb|KE346361.1|	2295610	2295626	AACAGC	16	-	2	GTTGCT
gi|514486271|gb|KE346361.1|	2297056	2297070	AAAAAC	14	+	2	AAACAA
gi|514486271|gb|KE346361.1|	2297171	2297185	AG	14	+	7	AG
gi|514486271|gb|KE346361.1|	2297186	2297200	AG	14	+	7	GA
gi|514486271|gb|KE346361.1|	2297705	2297728	A	23	+	23	A
gi|514486271|gb|KE346361.1|	2297725	2297741	AAAGC	16	+	3	AAAGC
gi|514486271|gb|KE346361.1|	2297995	2298016	AAGG	21	+	5	GGAA
gi|514486271|gb|KE346361.1|	2299141	2299155	ACGTCCC	14	+	2	CGTCCCA
gi|514486271|gb|KE346361.1|	2299181	2299201	ATC	20	-	6	TGA
gi|514486271|gb|KE346361.1|	2299253	2299267	AGC	14	-	4	TGC
gi|514486271|gb|KE346361.1|	2299485	2299505	AGC	20	-	6	TGC
gi|514486271|gb|KE346361.1|	2299516	2299541	ATC	25	-	8	GAT
gi|514486271|gb|KE346361.1|	2300778	2300823	ATC	45	+	15	ATC
gi|514486271|gb|KE346361.1|	2301052	2301076	AG	24	+	12	GA
gi|514486271|gb|KE346361.1|	2301464	2301484	AGCCCC	20	+	3	CCCCAG
gi|514486271|gb|KE346361.1|	2301940	2301958	ACCAGC	18	-	3	TGGTGC
gi|514486271|gb|KE346361.1|	2302176	2302190	ACCGCT	14	-	2	GCGGTA
gi|514486271|gb|KE346361.1|	2302494	2302512	ACG	18	+	6	ACG
gi|514486271|gb|KE346361.1|	2302916	2302933	AGG	17	+	5	GGA
gi|514486271|gb|KE346361.1|	2304964	2304981	AAGTGC	17	+	2	AGTGCA
gi|514486271|gb|KE346361.1|	2305180	2305194	AC	14	+	7	CA
gi|514486271|gb|KE346361.1|	2305890	2305907	AAG	17	-	5	TTC
gi|514486271|gb|KE346361.1|	2306117	2306141	AGC	24	-	8	CTG
gi|514486271|gb|KE346361.1|	2306399	2306421	A	22	+	22	A
gi|514486271|gb|KE346361.1|	2306633	2306648	AAAAC	15	-	3	TTGTT
gi|514486271|gb|KE346361.1|	2306715	2306748	A	33	-	33	T
gi|514486271|gb|KE346361.1|	2306956	2306970	AAAAG	14	-	2	TTTTC
gi|514486271|gb|KE346361.1|	2307022	2307036	AAGAAGG	14	-	2	CTTCTTC
gi|514486271|gb|KE346361.1|	2307405	2307428	A	23	-	23	T
gi|514486271|gb|KE346361.1|	2307541	2307556	AGCGC	15	-	3	CGCTG
gi|514486271|gb|KE346361.1|	2307702	2307717	ACTGCG	15	+	2	CTGCGA
gi|514486271|gb|KE346361.1|	2309249	2309263	AACAGC	14	-	2	TGTTGC
gi|514486271|gb|KE346361.1|	2309323	2309348	A	25	-	25	T
gi|514486271|gb|KE346361.1|	2309346	2309366	AAC	20	-	6	TTG
gi|514486271|gb|KE346361.1|	2309668	2309690	A	22	+	22	A
gi|514486271|gb|KE346361.1|	2310702	2310717	AACAGTC	15	+	2	AGTCAAC
gi|514486271|gb|KE346361.1|	2310726	2310766	A	40	+	40	A
gi|514486271|gb|KE346361.1|	2314028	2314043	ACCCCC	15	-	2	TGGGGG
gi|514486271|gb|KE346361.1|	2314885	2314900	A	15	-	15	T
gi|514486271|gb|KE346361.1|	2315098	2315112	AAAAT	14	+	2	AAAAT
gi|514486271|gb|KE346361.1|	2315105	2315121	AAAAAAT	16	+	2	AATAAAA
gi|514486271|gb|KE346361.1|	2315300	2315333	A	33	+	33	A
gi|514486271|gb|KE346361.1|	2315340	2315358	AAC	18	+	6	CAA
gi|514486271|gb|KE346361.1|	2315356	2315371	AAAAAG	15	+	2	AAAGAA
gi|514486271|gb|KE346361.1|	2315516	2315538	A	22	+	22	A
gi|514486271|gb|KE346361.1|	2315560	2315579	A	19	+	19	A
gi|514486271|gb|KE346361.1|	2315820	2315838	AAAAAGG	18	+	2	AAAAGGA
gi|514486271|gb|KE346361.1|	2319278	2319304	A	26	+	26	A
gi|514486271|gb|KE346361.1|	2322991	2323008	ACCCCC	17	-	2	GGTGGG
gi|514486271|gb|KE346361.1|	2323036	2323051	ATC	15	-	5	GAT
gi|514486271|gb|KE346361.1|	2325832	2325846	AAGAGGC	14	-	2	CTTGCCT
gi|514486271|gb|KE346361.1|	2328284	2328500	AAC	216	-	72	TTG
gi|514486271|gb|KE346361.1|	2330647	2330670	ACC	23	+	7	ACC
gi|514486271|gb|KE346361.1|	2331054	2331068	AAAGGGG	14	+	2	AAGGGGA
gi|514486271|gb|KE346361.1|	2331310	2331324	AAGGGGG	14	+	2	GGGGGAA
gi|514486271|gb|KE346361.1|	2332036	2332053	ACTG	17	+	4	GACT
gi|514486271|gb|KE346361.1|	2333917	2333947	ATC	30	-	10	TGA
gi|514486271|gb|KE346361.1|	2334346	2334363	CCG	17	-	5	GGC
gi|514486271|gb|KE346361.1|	2335603	2335617	ACATCC	14	+	2	TCCACA
gi|514486271|gb|KE346361.1|	2338245	2338259	A	14	+	14	A
gi|514486271|gb|KE346361.1|	2341087	2341102	AGGGATG	15	+	2	GGATGAG
gi|514486271|gb|KE346361.1|	2341298	2341319	AAAC	21	+	5	ACAA
gi|514486271|gb|KE346361.1|	2341318	2341334	AAAAAT	16	+	2	AAAAAT
gi|514486271|gb|KE346361.1|	2341425	2341443	AAAAAAT	18	+	2	AAAAATA
gi|514486271|gb|KE346361.1|	2341436	2341455	AAAAAT	19	+	3	ATAAAA
gi|514486271|gb|KE346361.1|	2341524	2341544	AACGAC	20	+	3	ACGACA
gi|514486271|gb|KE346361.1|	2341669	2341683	A	14	-	14	T
gi|514486271|gb|KE346361.1|	2341816	2341830	AATGGC	14	-	2	TGCCAT
gi|514486271|gb|KE346361.1|	2341922	2341938	ATCCGC	16	-	2	GATGCG
gi|514486271|gb|KE346361.1|	2342054	2342076	A	22	+	22	A
gi|514486271|gb|KE346361.1|	2342314	2342328	A	14	+	14	A
gi|514486271|gb|KE346361.1|	2342641	2342658	A	17	-	17	T
gi|514486271|gb|KE346361.1|	2343151	2343170	A	19	-	19	T
gi|514486271|gb|KE346361.1|	2343188	2343210	AACGGC	22	-	3	CGTTGC
gi|514486271|gb|KE346361.1|	2345091	2345105	ATC	14	+	4	CAT
gi|514486271|gb|KE346361.1|	2345266	2345297	A	31	+	31	A
gi|514486271|gb|KE346361.1|	2345491	2345505	AGG	14	-	4	CTC
gi|514486271|gb|KE346361.1|	2345654	2345673	AAAAG	19	-	3	TTTTC
gi|514486271|gb|KE346361.1|	2345669	2345701	A	32	-	32	T
gi|514486271|gb|KE346361.1|	2347803	2347821	AGC	18	-	6	TGC
gi|514486271|gb|KE346361.1|	2347955	2347974	ACC	19	+	6	CCA
gi|514486271|gb|KE346361.1|	2348218	2348241	AAC	23	+	7	CAA
gi|514486271|gb|KE346361.1|	2349052	2349068	A	16	-	16	T
gi|514486271|gb|KE346361.1|	2350631	2350652	A	21	+	21	A
gi|514486271|gb|KE346361.1|	2352054	2352081	AGC	27	+	9	GCA
gi|514486271|gb|KE346361.1|	2352213	2352242	ACG	29	+	9	GAC
gi|514486271|gb|KE346361.1|	2352387	2352404	ACAGT	17	-	3	TGTAC
gi|514486271|gb|KE346361.1|	2354221	2354243	AGC	22	+	7	CAG
gi|514486271|gb|KE346361.1|	2356455	2356477	AGC	22	+	7	GCA
gi|514486271|gb|KE346361.1|	2356479	2356496	ACGCAG	17	+	2	GCAGAC
gi|514486271|gb|KE346361.1|	2356558	2356573	AAAC	15	-	3	TTTG
gi|514486271|gb|KE346361.1|	2357700	2357716	AACATC	16	+	2	CAACAT
gi|514486271|gb|KE346361.1|	2360520	2360534	AAC	14	-	4	GTT
gi|514486271|gb|KE346361.1|	2360684	2360719	AGC	35	-	11	GCT
gi|514486271|gb|KE346361.1|	2360762	2360778	A	16	-	16	T
gi|514486271|gb|KE346361.1|	2361967	2361983	AGGCGG	16	-	2	CCGCCT
gi|514486271|gb|KE346361.1|	2362604	2362619	AAACAAC	15	-	2	TTGTTGT
gi|514486271|gb|KE346361.1|	2363038	2363055	AAAC	17	+	4	ACAA
gi|514486271|gb|KE346361.1|	2364642	2364657	AAGGGAG	15	+	2	GGAGAAG
gi|514486271|gb|KE346361.1|	2368960	2368975	AGC	15	+	5	GCA
gi|514486271|gb|KE346361.1|	2369109	2369123	AGCAGG	14	+	2	AGGAGC
gi|514486271|gb|KE346361.1|	2369290	2369305	AACC	15	-	3	TTGG
gi|514486271|gb|KE346361.1|	2370829	2370845	A	16	-	16	T
gi|514486271|gb|KE346361.1|	2371882	2371899	AG	17	+	8	AG
gi|514486271|gb|KE346361.1|	2372651	2372670	A	19	-	19	T
gi|514486271|gb|KE346361.1|	2374087	2374137	AC	50	-	25	TG
gi|514486271|gb|KE346361.1|	2375145	2375182	A	37	+	37	A
gi|514486271|gb|KE346361.1|	2376750	2376764	AAATCC	14	+	2	CCAAAT
gi|514486271|gb|KE346361.1|	2376765	2376789	A	24	+	24	A
gi|514486271|gb|KE346361.1|	2376815	2376840	A	25	+	25	A
gi|514486271|gb|KE346361.1|	2377029	2377043	AAAGGGG	14	-	2	TCCCCTT
gi|514486271|gb|KE346361.1|	2377085	2377100	ACCCC	15	-	3	TGGGG
gi|514486271|gb|KE346361.1|	2377174	2377189	A	15	-	15	T
gi|514486271|gb|KE346361.1|	2377203	2377229	A	26	-	26	T
gi|514486271|gb|KE346361.1|	2377800	2377815	AGCC	15	+	3	CCAG
gi|514486271|gb|KE346361.1|	2378103	2378130	AAC	27	+	9	AAC
gi|514486271|gb|KE346361.1|	2378958	2378973	AAAC	15	+	3	AAAC
gi|514486271|gb|KE346361.1|	2378977	2378992	AAAAAC	15	+	2	AAAAAC
gi|514486271|gb|KE346361.1|	2378998	2379013	AAAC	15	+	3	AAAC
gi|514486271|gb|KE346361.1|	2379108	2379122	AAAAAAC	14	-	2	TGTTTTT
gi|514486271|gb|KE346361.1|	2381328	2381345	ACACGC	17	+	2	CACACG
gi|514486271|gb|KE346361.1|	2381350	2381364	AAAAAAC	14	+	2	AACAAAA
gi|514486271|gb|KE346361.1|	2384827	2384842	AG	15	+	7	GA
gi|514486271|gb|KE346361.1|	2387445	2387462	AAAAAAG	17	-	2	TTTTTTC
gi|514486271|gb|KE346361.1|	2387473	2387500	A	27	-	27	T
gi|514486271|gb|KE346361.1|	2387570	2387585	AGCG	15	+	3	GAGC
gi|514486271|gb|KE346361.1|	2387626	2387653	AG	27	+	13	GA
gi|514486271|gb|KE346361.1|	2387654	2387671	AG	17	+	8	GA
gi|514486271|gb|KE346361.1|	2387905	2387921	ACTCC	16	+	3	CTCCA
gi|514486271|gb|KE346361.1|	2388048	2388072	A	24	+	24	A
gi|514486271|gb|KE346361.1|	2388229	2388243	AAAGAAG	14	-	2	TCTTCTT
gi|514486271|gb|KE346361.1|	2388375	2388393	AGC	18	-	6	CTG
gi|514486271|gb|KE346361.1|	2405127	2405154	AAAAAC	27	-	4	TTTTGT
gi|514486271|gb|KE346361.1|	2405288	2405328	A	40	-	40	T
gi|514486271|gb|KE346361.1|	2407868	2407884	AAACGTC	16	-	2	CGTTTGA
gi|514486271|gb|KE346361.1|	2408091	2408115	AC	24	+	12	AC
gi|514486271|gb|KE346361.1|	2408168	2408192	A	24	+	24	A
gi|514486271|gb|KE346361.1|	2408611	2408625	ACTGCC	14	+	2	GCCACT
gi|514486271|gb|KE346361.1|	2408624	2408639	ACTGCC	15	+	2	CTGCCA
gi|514486271|gb|KE346361.1|	2408761	2408780	ACT	19	+	6	ACT
gi|514486271|gb|KE346361.1|	2409439	2409456	A	17	+	17	A
gi|514486271|gb|KE346361.1|	2409646	2409675	AGC	29	-	9	CTG
gi|514486271|gb|KE346361.1|	2410013	2410027	AACATTC	14	-	2	TTGAATG
gi|514486271|gb|KE346361.1|	2410136	2410150	AAATAAG	14	-	2	TTATTTC
gi|514486271|gb|KE346361.1|	2410565	2410581	AAAAGC	16	+	2	AAGCAA
gi|514486271|gb|KE346361.1|	2411393	2411415	AAGG	22	+	5	AAGG
gi|514486271|gb|KE346361.1|	2412009	2412030	ACC	21	-	7	GGT
gi|514486271|gb|KE346361.1|	2412029	2412043	AAGATC	14	-	2	TCTTGA
gi|514486271|gb|KE346361.1|	2412613	2412639	A	26	-	26	T
gi|514486271|gb|KE346361.1|	2412929	2412949	AACACG	20	-	3	TTCGTG
gi|514486271|gb|KE346361.1|	2413263	2413277	AAC	14	+	4	AAC
gi|514486271|gb|KE346361.1|	2413503	2413521	A	18	+	18	A
gi|514486271|gb|KE346361.1|	2413555	2413570	AAAAAT	15	-	2	TTTTTA
gi|514486271|gb|KE346361.1|	2413724	2413747	A	23	+	23	A
gi|514486271|gb|KE346361.1|	2413821	2413837	AAACAAC	16	+	2	AAACAAC
gi|514486271|gb|KE346361.1|	2414422	2414436	AAAACAC	14	-	2	GTTTTGT
gi|514486271|gb|KE346361.1|	2414452	2414472	A	20	-	20	T
gi|514486271|gb|KE346361.1|	2415936	2415950	AACACAG	14	-	2	CTGTGTT
gi|514486271|gb|KE346361.1|	2416004	2416018	A	14	+	14	A
gi|514486271|gb|KE346361.1|	2416042	2416058	AAGAGG	16	-	2	TCCTCT
gi|514486271|gb|KE346361.1|	2419046	2419063	AC	17	-	8	GT
gi|514486271|gb|KE346361.1|	2419366	2419381	ACTGGC	15	+	2	TGGCAC
gi|514486271|gb|KE346361.1|	2419493	2419523	A	30	-	30	T
gi|514486271|gb|KE346361.1|	2419691	2419709	AAT	18	-	6	ATT
gi|514486271|gb|KE346361.1|	2419916	2419934	A	18	+	18	A
gi|514486271|gb|KE346361.1|	2419975	2419990	AAAACC	15	-	2	TTTGGT
gi|514486271|gb|KE346361.1|	2420487	2420501	AGC	14	+	4	GCA
gi|514486271|gb|KE346361.1|	2420506	2420520	AACAGC	14	+	2	CAGCAA
gi|514486271|gb|KE346361.1|	2422336	2422350	AAG	14	+	4	AAG
gi|514486271|gb|KE346361.1|	2422963	2422977	AACATTG	14	-	2	CAATGTT
gi|514486271|gb|KE346361.1|	2423681	2423701	AAGG	20	-	5	CTTC
gi|514486271|gb|KE346361.1|	2424131	2424145	AAGATAC	14	+	2	ACAAGAT
gi|514486271|gb|KE346361.1|	2424294	2424508	AG	214	+	107	AG
gi|514486271|gb|KE346361.1|	2424808	2424823	AACATG	15	-	2	TTCATG
gi|514486271|gb|KE346361.1|	2424828	2424842	AAAAGC	14	-	2	TTGCTT
gi|514486271|gb|KE346361.1|	2424846	2424861	AAAAAGC	15	-	2	TTGCTTT
gi|514486271|gb|KE346361.1|	2425151	2425175	A	24	-	24	T
gi|514486271|gb|KE346361.1|	2425806	2425824	A	18	-	18	T
gi|514486271|gb|KE346361.1|	2426504	2426520	AGGG	16	-	4	CCCT
gi|514486271|gb|KE346361.1|	2427935	2427949	AAAAGG	14	-	2	TTTCCT
gi|514486271|gb|KE346361.1|	2429470	2429491	AGC	21	+	7	CAG
gi|514486271|gb|KE346361.1|	2429747	2429768	AAAC	21	+	5	ACAA
gi|514486271|gb|KE346361.1|	2429988	2430005	ATCATG	17	+	2	ATCATG
gi|514486271|gb|KE346361.1|	2430146	2430160	AGC	14	+	4	GCA
gi|514486271|gb|KE346361.1|	2431776	2431792	AACAGC	16	-	2	GTTGCT
gi|514486271|gb|KE346361.1|	2431799	2431813	AACAGC	14	-	2	TGCTGT
gi|514486271|gb|KE346361.1|	2433606	2433631	ACTC	25	-	6	GTGA
gi|514486271|gb|KE346361.1|	2433932	2433949	AACACC	17	+	2	CACCAA
gi|514486271|gb|KE346361.1|	2435576	2435596	ATC	20	+	6	CAT
gi|514486271|gb|KE346361.1|	2435850	2435865	AAAGCC	15	+	2	CCAAAG
gi|514486271|gb|KE346361.1|	2435917	2435964	AGC	47	+	15	CAG
gi|514486271|gb|KE346361.1|	2439429	2439446	AAGCTC	17	-	2	GAGCTT
gi|514486271|gb|KE346361.1|	2442150	2442165	AACATC	15	-	2	TGATGT
gi|514486271|gb|KE346361.1|	2443627	2443648	AATCGC	21	-	3	GCGATT
gi|514486271|gb|KE346361.1|	2448141	2448158	AGCATC	17	+	2	CAGCAT
gi|514486271|gb|KE346361.1|	2448153	2448181	AGC	28	+	9	CAG
gi|514486271|gb|KE346361.1|	2448458	2448472	AGCGCCC	14	-	2	GCGCTGG
gi|514486271|gb|KE346361.1|	2448831	2448845	ACGGCGG	14	+	2	GGACGGC
gi|514486271|gb|KE346361.1|	2451307	2451323	AACGAC	16	-	2	GTCGTT
gi|514486271|gb|KE346361.1|	2451964	2451987	ACCCCC	23	-	3	GGTGGG
gi|514486271|gb|KE346361.1|	2451992	2452006	AGC	14	+	4	GCA
gi|514486271|gb|KE346361.1|	2452134	2452153	AAC	19	-	6	GTT
gi|514486271|gb|KE346361.1|	2452148	2452165	AACAGC	17	-	2	TGTTGC
gi|514486271|gb|KE346361.1|	2455929	2455946	A	17	+	17	A
gi|514486271|gb|KE346361.1|	2455947	2455962	A	15	+	15	A
gi|514486271|gb|KE346361.1|	2456038	2456055	AATG	17	+	4	AATG
gi|514486271|gb|KE346361.1|	2456056	2456076	AATG	20	+	5	TGAA
gi|514486271|gb|KE346361.1|	2456424	2456444	AGC	20	+	6	GCA
gi|514486271|gb|KE346361.1|	2456789	2456813	ATC	24	-	8	TGA
gi|514486271|gb|KE346361.1|	2458910	2458931	A	21	+	21	A
gi|514486271|gb|KE346361.1|	2462900	2462914	AACCCCC	14	+	2	AACCCCC
gi|514486271|gb|KE346361.1|	2462989	2463043	A	54	-	54	T
gi|514486271|gb|KE346361.1|	2463073	2463093	AGG	20	-	6	TCC
gi|514486271|gb|KE346361.1|	2463223	2463241	A	18	+	18	A
gi|514486271|gb|KE346361.1|	2463439	2463454	A	15	+	15	A
gi|514486271|gb|KE346361.1|	2463496	2463510	AAAAG	14	+	2	AAAAG
gi|514486271|gb|KE346361.1|	2464532	2464549	AC	17	-	8	TG
gi|514486271|gb|KE346361.1|	2465383	2465400	AAGCAGC	17	+	2	CAGCAAG
gi|514486271|gb|KE346361.1|	2465769	2465783	AAGAGAG	14	-	2	TCTCTCT
gi|514486271|gb|KE346361.1|	2466087	2466102	AAAGCAG	15	-	2	TTTCTGC
gi|514486271|gb|KE346361.1|	2466347	2466363	AAAATC	16	-	2	TGATTT
gi|514486271|gb|KE346361.1|	2468508	2468522	AAAACGT	14	+	2	AAAACGT
gi|514486271|gb|KE346361.1|	2469324	2469341	AACAGC	17	-	2	GTTGCT
gi|514486271|gb|KE346361.1|	2470066	2470083	AAAGGGG	17	+	2	GGGGAAA
gi|514486271|gb|KE346361.1|	2470579	2470601	AACG	22	-	5	TCGT
gi|514486271|gb|KE346361.1|	2471225	2471240	AG	15	-	7	TC
gi|514486271|gb|KE346361.1|	2471238	2471253	AAAGGGG	15	-	2	CTTTCCC
gi|514486271|gb|KE346361.1|	2473255	2473274	AAGCC	19	-	3	GCTTG
gi|514486271|gb|KE346361.1|	2473362	2473376	AAAAC	14	-	2	TTTTG
gi|514486271|gb|KE346361.1|	2473473	2473488	AAC	15	+	5	CAA
gi|514486271|gb|KE346361.1|	2474453	2474467	AAGTGC	14	+	2	AGTGCA
gi|514486271|gb|KE346361.1|	2474479	2474493	ACCGCC	14	-	2	GGCGGT
gi|514486271|gb|KE346361.1|	2477426	2477442	AAAAAAC	16	-	2	TTTTGTT
gi|514486271|gb|KE346361.1|	2477435	2477452	AAAAC	17	-	3	TTGTT
gi|514486271|gb|KE346361.1|	2477451	2477465	AAAAC	14	-	2	TTTTG
gi|514486271|gb|KE346361.1|	2477458	2477472	AAAAAAC	14	-	2	TTGTTTT
gi|514486271|gb|KE346361.1|	2477935	2477951	AAAC	16	-	4	TTTG
gi|514486271|gb|KE346361.1|	2478051	2478079	ACAGGT	28	-	4	TGTACC
gi|514486271|gb|KE346361.1|	2479000	2479029	AAAC	29	-	7	TGTT
gi|514486271|gb|KE346361.1|	2479787	2479804	AGCCCC	17	-	2	GGGGCT
gi|514486271|gb|KE346361.1|	2479929	2479946	AAAAGC	17	+	2	CAAAAG
gi|514486271|gb|KE346361.1|	2480036	2480052	AAAAAAC	16	+	2	AAAAACA
gi|514486271|gb|KE346361.1|	2480053	2480067	A	14	+	14	A
gi|514486271|gb|KE346361.1|	2480063	2480077	AAAACAG	14	+	2	AAAACAG
gi|514486271|gb|KE346361.1|	2481538	2481553	ACGAGG	15	-	2	TCCTCG
gi|514486271|gb|KE346361.1|	2482192	2482209	A	17	+	17	A
gi|514486271|gb|KE346361.1|	2482505	2482523	AAACAAG	18	+	2	ACAAGAA
gi|514486271|gb|KE346361.1|	2484218	2484232	ACGATCG	14	-	2	TCGTCGA
gi|514486271|gb|KE346361.1|	2484848	2484865	AAC	17	+	5	CAA
gi|514486271|gb|KE346361.1|	2485104	2485118	AGC	14	-	4	TGC
gi|514486271|gb|KE346361.1|	2485122	2485139	AGC	17	-	5	TGC
gi|514486271|gb|KE346361.1|	2486459	2486473	ACGGCG	14	+	2	CGGCGA
gi|514486271|gb|KE346361.1|	2486658	2486674	AAC	16	-	5	GTT
gi|514486271|gb|KE346361.1|	2486676	2486696	CCG	20	+	6	GCC
gi|514486271|gb|KE346361.1|	2487233	2487253	AAC	20	-	6	GTT
gi|514486271|gb|KE346361.1|	2487411	2487425	ACATGG	14	+	2	GACATG
gi|514486271|gb|KE346361.1|	2487441	2487457	AGCTGC	16	+	2	GCTGCA
gi|514486271|gb|KE346361.1|	2487826	2487845	AGC	19	+	6	CAG
gi|514486271|gb|KE346361.1|	2487986	2488001	ACCAGC	15	+	2	AGCACC
gi|514486271|gb|KE346361.1|	2488016	2488037	AGC	21	+	7	AGC
gi|514486271|gb|KE346361.1|	2488224	2488241	AGC	17	-	5	CTG
gi|514486271|gb|KE346361.1|	2488348	2488370	AGC	22	-	7	GCT
gi|514486271|gb|KE346361.1|	2488563	2488578	AACACC	15	+	2	CCAACA
gi|514486271|gb|KE346361.1|	2488692	2488708	AAAGTC	16	+	2	AAAGTC
gi|514486271|gb|KE346361.1|	2491861	2491876	ACATC	15	-	3	TGATG
gi|514486271|gb|KE346361.1|	2492101	2492129	A	28	+	28	A
gi|514486271|gb|KE346361.1|	2492526	2492543	A	17	+	17	A
gi|514486271|gb|KE346361.1|	2492573	2492600	AACATCC	27	-	3	TTGGATG
gi|514486271|gb|KE346361.1|	2495863	2495884	AC	21	-	10	TG
gi|514486271|gb|KE346361.1|	2496964	2496978	A	14	-	14	T
gi|514486271|gb|KE346361.1|	2496982	2496998	A	16	-	16	T
gi|514486271|gb|KE346361.1|	2497601	2497617	ACGTCC	16	+	2	CACGTC
gi|514486271|gb|KE346361.1|	2497799	2497827	AAAC	28	-	7	GTTT
gi|514486271|gb|KE346361.1|	2497824	2497840	AAAAAC	16	-	2	TTTTGT
gi|514486271|gb|KE346361.1|	2497835	2497856	A	21	-	21	T
gi|514486271|gb|KE346361.1|	2497853	2497868	AAAC	15	-	3	TTTG
gi|514486271|gb|KE346361.1|	2498478	2498542	A	64	-	64	T
gi|514486271|gb|KE346361.1|	2498539	2498562	AAAC	23	-	5	TTTG
gi|514486271|gb|KE346361.1|	2498753	2498768	AGC	15	-	5	TGC
gi|514486271|gb|KE346361.1|	2500080	2500158	AC	78	+	39	CA
gi|514486271|gb|KE346361.1|	2501529	2501549	A	20	+	20	A
gi|514486271|gb|KE346361.1|	2501699	2501720	AG	21	-	10	CT
gi|514486271|gb|KE346361.1|	2504685	2504700	AACCGC	15	-	2	TGCGGT
gi|514486271|gb|KE346361.1|	2506120	2506142	A	22	-	22	T
gi|514486271|gb|KE346361.1|	2507092	2507115	AAAAAAG	23	-	3	TTTTTTC
gi|514486271|gb|KE346361.1|	2507293	2507309	CCG	16	+	5	CGC
gi|514486271|gb|KE346361.1|	2507440	2507458	A	18	-	18	T
gi|514486271|gb|KE346361.1|	2508236	2508256	AG	20	-	10	CT
gi|514486271|gb|KE346361.1|	2508259	2508308	AG	49	-	24	TC
gi|514486271|gb|KE346361.1|	2508309	2508366	AG	57	-	28	TC
gi|514486271|gb|KE346361.1|	2508367	2508499	AG	132	-	66	TC
gi|514486271|gb|KE346361.1|	2508496	2508552	AGG	56	-	18	CTC
gi|514486271|gb|KE346361.1|	2511700	2511714	AACGCTC	14	+	2	CGCTCAA
gi|514486271|gb|KE346361.1|	2511898	2511912	AAG	14	+	4	AGA
gi|514486271|gb|KE346361.1|	2512726	2512740	AAGAAGC	14	-	2	TCTTGCT
gi|514486271|gb|KE346361.1|	2512974	2512989	AAGC	15	+	3	AGCA
gi|514486271|gb|KE346361.1|	2515109	2515126	ACTGCT	17	-	2	AGTAGC
gi|514486271|gb|KE346361.1|	2515121	2515136	ACT	15	-	5	AGT
gi|514486271|gb|KE346361.1|	2515420	2515444	A	24	+	24	A
gi|514486271|gb|KE346361.1|	2515762	2515778	A	16	+	16	A
gi|514486271|gb|KE346361.1|	2516160	2516195	A	35	+	35	A
gi|514486271|gb|KE346361.1|	2516395	2516409	AAAAAAC	14	+	2	AAAAAAC
gi|514486271|gb|KE346361.1|	2516677	2516694	AGAGCG	17	+	2	GAGAGC
gi|514486271|gb|KE346361.1|	2516974	2516989	AAAC	15	-	3	TTTG
gi|514486271|gb|KE346361.1|	2517005	2517020	AC	15	-	7	TG
gi|514486271|gb|KE346361.1|	2517263	2517277	AAAAAC	14	-	2	TTTTGT
gi|514486271|gb|KE346361.1|	2518968	2518988	A	20	+	20	A
gi|514486271|gb|KE346361.1|	2519209	2519229	AAAATCG	20	+	2	AAAATCG
gi|514486271|gb|KE346361.1|	2520016	2520041	AAC	25	-	8	GTT
gi|514486271|gb|KE346361.1|	2520405	2520437	A	32	+	32	A
gi|514486271|gb|KE346361.1|	2521019	2521033	A	14	-	14	T
gi|514486271|gb|KE346361.1|	2521291	2521305	AAAAAAC	14	-	2	TTTTTTG
gi|514486271|gb|KE346361.1|	2521622	2521637	A	15	+	15	A
gi|514486271|gb|KE346361.1|	2522315	2522329	AAC	14	+	4	AAC
gi|514486271|gb|KE346361.1|	2524308	2524324	A	16	-	16	T
gi|514486271|gb|KE346361.1|	2524319	2524333	AAAAAG	14	-	2	TTTTTC
gi|514486271|gb|KE346361.1|	2524548	2524563	AG	15	-	7	TC
gi|514486271|gb|KE346361.1|	2524643	2524679	AG	36	-	18	CT
gi|514486271|gb|KE346361.1|	2525672	2525688	AG	16	-	8	TC
gi|514486271|gb|KE346361.1|	2526780	2526797	ACTGCT	17	-	2	AGCAGT
gi|514486271|gb|KE346361.1|	2526804	2526821	AGCAGG	17	+	2	AGCAGG
gi|514486271|gb|KE346361.1|	2527235	2527499	AC	264	+	132	AC
gi|514486271|gb|KE346361.1|	2527601	2527619	AC	18	+	9	CA
gi|514486271|gb|KE346361.1|	2528440	2528525	ACAG	85	+	21	CAGA
gi|514486271|gb|KE346361.1|	2530956	2530970	AAGCAC	14	-	2	TGTGCT
gi|514486271|gb|KE346361.1|	2531916	2531931	AAAGGAG	15	-	2	TTTCTCC
gi|514486271|gb|KE346361.1|	2532615	2532629	AAAGGCG	14	-	2	GCCTTTC
gi|514486271|gb|KE346361.1|	2534021	2534046	ACG	25	+	8	CGA
gi|514486271|gb|KE346361.1|	2535037	2535071	A	34	-	34	T
gi|514486271|gb|KE346361.1|	2535991	2536006	AGGAGGC	15	-	2	TGCCTCC
gi|514486271|gb|KE346361.1|	2539730	2539751	AAAAAAC	21	+	3	AAAAACA
gi|514486271|gb|KE346361.1|	2541922	2541938	A	16	-	16	T
gi|514486271|gb|KE346361.1|	2541954	2541968	AAAAAG	14	-	2	TCTTTT
gi|514486271|gb|KE346361.1|	2542084	2542103	A	19	+	19	A
gi|514486271|gb|KE346361.1|	2542139	2542166	A	27	+	27	A
gi|514486271|gb|KE346361.1|	2543398	2543413	A	15	-	15	T
gi|514486271|gb|KE346361.1|	2547845	2547863	AAAC	18	-	4	TGTT
gi|514486271|gb|KE346361.1|	2548266	2548287	ACCACG	21	+	3	CACGAC
gi|514486271|gb|KE346361.1|	2548341	2548358	AGC	17	+	5	CAG
gi|514486271|gb|KE346361.1|	2548497	2548513	AACCCC	16	+	2	CAACCC
gi|514486271|gb|KE346361.1|	2548605	2548619	AG	14	-	7	TC
gi|514486271|gb|KE346361.1|	2548784	2548808	AGAGGG	24	-	4	TCCCTC
gi|514486271|gb|KE346361.1|	2548884	2548899	A	15	+	15	A
gi|514486271|gb|KE346361.1|	2549899	2549914	AG	15	-	7	TC
gi|514486271|gb|KE346361.1|	2550701	2550715	ACGAGAG	14	-	2	TCTCTCG
gi|514486271|gb|KE346361.1|	2550777	2550792	AAAC	15	-	3	TTGT
gi|514486271|gb|KE346361.1|	2550864	2550880	A	16	-	16	T
gi|514486271|gb|KE346361.1|	2553295	2553311	AAC	16	+	5	ACA
gi|514486271|gb|KE346361.1|	2554721	2554743	A	22	+	22	A
gi|514486271|gb|KE346361.1|	2556072	2556096	AAAC	24	+	6	CAAA
gi|514486271|gb|KE346361.1|	2556907	2556924	ACCTGC	17	-	2	GCAGGT
gi|514486271|gb|KE346361.1|	2557671	2557688	ACCATG	17	+	2	CATGAC
gi|514486271|gb|KE346361.1|	2557735	2557749	AATTCAC	14	+	2	ATTCACA
gi|514486271|gb|KE346361.1|	2558236	2558250	ACGCCAG	14	-	2	TCTGGCG
gi|514486271|gb|KE346361.1|	2559159	2559173	ACGCTG	14	-	2	CGTCAG
gi|514486271|gb|KE346361.1|	2559876	2559892	ACG	16	+	5	ACG
gi|514486271|gb|KE346361.1|	2559887	2559901	ACGAGG	14	+	2	GACGAG
gi|514486271|gb|KE346361.1|	2559911	2559925	AAGACG	14	+	2	GACGAA
gi|514486271|gb|KE346361.1|	2559949	2559969	ACG	20	+	6	CGA
gi|514486271|gb|KE346361.1|	2564179	2564194	AAGCAG	15	-	2	GCTTCT
gi|514486271|gb|KE346361.1|	2566265	2566285	AGC	20	-	6	CTG
gi|514486271|gb|KE346361.1|	2567081	2567099	AAAAAAC	18	+	2	AAAAAAC
gi|514486271|gb|KE346361.1|	2568789	2568812	ACC	23	-	7	GTG
gi|514486271|gb|KE346361.1|	2569378	2569394	AAGCG	16	-	3	TCGCT
gi|514486271|gb|KE346361.1|	2569502	2569520	AATCAG	18	-	3	TGATTC
gi|514486271|gb|KE346361.1|	2569928	2569946	AGAGGG	18	+	3	GAGGGA
gi|514486271|gb|KE346361.1|	2570053	2570079	AAGAGG	26	+	4	AGAGGA
gi|514486271|gb|KE346361.1|	2570598	2570612	AAC	14	+	4	CAA
gi|514486271|gb|KE346361.1|	2570862	2570877	AGC	15	+	5	CAG
gi|514486271|gb|KE346361.1|	2571807	2571822	A	15	+	15	A
gi|514486271|gb|KE346361.1|	2571895	2571909	ACGAGT	14	+	2	AGTACG
gi|514486271|gb|KE346361.1|	2572922	2572936	AAAAAC	14	-	2	TGTTTT
gi|514486271|gb|KE346361.1|	2573593	2573609	AC	16	+	8	CA
gi|514486271|gb|KE346361.1|	2573665	2573681	AGCATC	16	+	2	AGCATC
gi|514486271|gb|KE346361.1|	2573797	2573821	AGC	24	+	8	CAG
gi|514486271|gb|KE346361.1|	2573858	2573873	AGC	15	+	5	GCA
gi|514486271|gb|KE346361.1|	2573881	2573896	ACAGTC	15	-	2	CTGTGA
gi|514486271|gb|KE346361.1|	2574002	2574022	ACTGCC	20	+	3	TGCCAC
gi|514486271|gb|KE346361.1|	2574517	2574536	AGC	19	-	6	CTG
gi|514486271|gb|KE346361.1|	2574534	2574549	CCG	15	-	5	GCG
gi|514486271|gb|KE346361.1|	2575243	2575260	AACGACC	17	-	2	GTCGTTG
gi|514486271|gb|KE346361.1|	2575753	2575769	A	16	-	16	T
gi|514486271|gb|KE346361.1|	2575768	2575789	AC	21	-	10	TG
gi|514486271|gb|KE346361.1|	2575798	2575813	AAAC	15	-	3	GTTT
gi|514486271|gb|KE346361.1|	2578003	2578017	AGC	14	-	4	GCT
gi|514486271|gb|KE346361.1|	2578054	2578071	AAATGC	17	+	2	GCAAAT
gi|514486271|gb|KE346361.1|	2579416	2579430	ACGGGGC	14	-	2	TGCCCCG
gi|514486271|gb|KE346361.1|	2579723	2579737	AACGACC	14	-	2	TTGGTCG
gi|514486271|gb|KE346361.1|	2582750	2582773	AAGACG	23	-	3	TCGTCT
gi|514486271|gb|KE346361.1|	2583083	2583103	ACGAGG	20	-	3	TCGTCC
gi|514486271|gb|KE346361.1|	2583130	2583148	ACGATG	18	-	3	ATCGTC
gi|514486271|gb|KE346361.1|	2583264	2583280	AGCTGC	16	+	2	CAGCTG
gi|514486271|gb|KE346361.1|	2583523	2583538	AG	15	+	7	GA
gi|514486271|gb|KE346361.1|	2583989	2584004	AACCCC	15	-	2	GGGGTT
gi|514486271|gb|KE346361.1|	2584066	2584082	AAAGCC	16	+	2	CCAAAG
gi|514486271|gb|KE346361.1|	2584190	2584208	AACAAG	18	+	3	ACAAGA
gi|514486271|gb|KE346361.1|	2584203	2584218	AAGAGC	15	+	2	CAAGAG
gi|514486271|gb|KE346361.1|	2584239	2584256	ACTGGC	17	-	2	TGCCAG
gi|514486271|gb|KE346361.1|	2584592	2584607	ATC	15	-	5	GAT
gi|514486271|gb|KE346361.1|	2585556	2585570	AAAC	14	+	3	CAAA
gi|514486271|gb|KE346361.1|	2587647	2587677	ACG	30	-	10	CGT
gi|514486271|gb|KE346361.1|	2588609	2588629	ACG	20	-	6	TCG
gi|514486271|gb|KE346361.1|	2588723	2588742	ACG	19	-	6	TCG
gi|514486271|gb|KE346361.1|	2589003	2589019	ATCGC	16	+	3	ATCGC
gi|514486271|gb|KE346361.1|	2590846	2590860	AAAAGC	14	-	2	TGCTTT
gi|514486271|gb|KE346361.1|	2591205	2591219	AAAACAC	14	+	2	CAAAACA
gi|514486271|gb|KE346361.1|	2594348	2594370	ATC	22	-	7	GAT
gi|514486271|gb|KE346361.1|	2600383	2600398	AAGCAGC	15	+	2	AGCAGCA
gi|514486271|gb|KE346361.1|	2600834	2600851	CCG	17	+	5	CCG
gi|514486271|gb|KE346361.1|	2600999	2601016	AGCCGC	17	-	2	CTGCGG
gi|514486271|gb|KE346361.1|	2601015	2601038	ACAGTC	23	-	3	GACTGT
gi|514486271|gb|KE346361.1|	2604840	2604855	ACGGAG	15	+	2	GAGACG
gi|514486271|gb|KE346361.1|	2605329	2605344	AACGGAC	15	-	2	GTCCGTT
gi|514486271|gb|KE346361.1|	2605525	2605539	AAACAAC	14	+	2	ACAAACA
gi|514486271|gb|KE346361.1|	2605779	2605793	AAGCGGC	14	-	2	GCTTGCC
gi|514486271|gb|KE346361.1|	2607849	2607876	AG	27	+	13	AG
gi|514486271|gb|KE346361.1|	2608010	2608025	AGAGCG	15	+	2	GAGCGA
gi|514486271|gb|KE346361.1|	2608260	2608277	AAAAAG	17	+	2	AAAAAG
gi|514486271|gb|KE346361.1|	2608308	2608322	AAAAATC	14	+	2	TCAAAAA
gi|514486271|gb|KE346361.1|	2608328	2608348	AAT	20	+	6	AAT
gi|514486271|gb|KE346361.1|	2608350	2608367	AAAAAT	17	+	2	AAAAAT
gi|514486271|gb|KE346361.1|	2608445	2608459	AGCGAGG	14	+	2	GAGGAGC
gi|514486271|gb|KE346361.1|	2608475	2608502	AG	27	+	13	AG
gi|514486271|gb|KE346361.1|	2609493	2609520	ACG	27	-	9	GTC
gi|514486271|gb|KE346361.1|	2611654	2611670	AGATGC	16	+	2	GCAGAT
gi|514486271|gb|KE346361.1|	2614467	2614485	AAAC	18	+	4	AAAC
gi|514486271|gb|KE346361.1|	2614856	2614870	AAAGAAC	14	+	2	AGAACAA
gi|514486271|gb|KE346361.1|	2618161	2618175	AAACACC	14	+	2	ACCAAAC
gi|514486271|gb|KE346361.1|	2618181	2618195	AAAACC	14	+	2	AAACCA
gi|514486271|gb|KE346361.1|	2618612	2618626	AGGGGGG	14	-	2	TCCCCCC
gi|514486271|gb|KE346361.1|	2618792	2618808	ATCCGC	16	-	2	GATGCG
gi|514486271|gb|KE346361.1|	2618837	2618852	AGAGCC	15	+	2	CCAGAG
gi|514486271|gb|KE346361.1|	2618853	2618869	AGAGCC	16	+	2	AGCCAG
gi|514486271|gb|KE346361.1|	2618876	2618897	AGCCTG	21	+	3	GAGCCT
gi|514486271|gb|KE346361.1|	2619305	2619321	AGGATG	16	-	2	ATCCTC
gi|514486271|gb|KE346361.1|	2619485	2619510	AAC	25	+	8	CAA
gi|514486271|gb|KE346361.1|	2619597	2619611	ACC	14	-	4	GGT
gi|514486271|gb|KE346361.1|	2619841	2619857	AACAAT	16	+	2	ATAACA
gi|514486271|gb|KE346361.1|	2620430	2620445	AC	15	-	7	TG
gi|514486271|gb|KE346361.1|	2623766	2623781	AAAAAAG	15	-	2	TCTTTTT
gi|514486271|gb|KE346361.1|	2623962	2623977	A	15	+	15	A
gi|514486271|gb|KE346361.1|	2624186	2624208	A	22	-	22	T
gi|514486271|gb|KE346361.1|	2624251	2624266	AAAAAAG	15	+	2	AAAAAGA
gi|514486271|gb|KE346361.1|	2626041	2626060	AGC	19	-	6	TGC
gi|514486271|gb|KE346361.1|	2626443	2626464	ACGAGAG	21	-	3	TCGTCTC
gi|514486271|gb|KE346361.1|	2635852	2635875	AG	23	+	11	GA
gi|514486271|gb|KE346361.1|	2636530	2636544	AAATTTC	14	+	2	TTTCAAA
gi|514486271|gb|KE346361.1|	2636824	2636846	AGC	22	+	7	GCA
gi|514486271|gb|KE346361.1|	2636896	2636910	ATC	14	+	4	TCA
gi|514486271|gb|KE346361.1|	2637923	2637937	ACCGCCG	14	+	2	GCCGACC
gi|514486271|gb|KE346361.1|	2639310	2639329	ACG	19	+	6	GAC
gi|514486271|gb|KE346361.1|	2639690	2639709	AG	19	+	9	AG
gi|514486271|gb|KE346361.1|	2639702	2639716	AAGAGAG	14	+	2	AGAGAGA
gi|514486271|gb|KE346361.1|	2639709	2639723	AG	14	+	7	AG
gi|514486271|gb|KE346361.1|	2639899	2639922	AAT	23	-	7	TTA
gi|514486271|gb|KE346361.1|	2640230	2640256	ACG	26	-	8	GTC
gi|514486271|gb|KE346361.1|	2640342	2640358	ACAGAG	16	-	2	GTCTCT
gi|514486271|gb|KE346361.1|	2640507	2640535	A	28	+	28	A
gi|514486271|gb|KE346361.1|	2640728	2640742	AACG	14	-	3	TCGT
gi|514486271|gb|KE346361.1|	2642064	2642093	AGG	29	-	9	TCC
gi|514486271|gb|KE346361.1|	2642094	2642111	ATC	17	+	5	TCA
gi|514486271|gb|KE346361.1|	2642582	2642604	AGC	22	+	7	CAG
gi|514486271|gb|KE346361.1|	2644929	2645103	AAAC	174	+	43	AAAC
gi|514486271|gb|KE346361.1|	2645739	2645755	A	16	-	16	T
gi|514486271|gb|KE346361.1|	2645912	2645936	AAC	24	+	8	AAC
gi|514486271|gb|KE346361.1|	2647331	2647368	AGAGCC	37	+	6	AGCCAG
gi|514486271|gb|KE346361.1|	2649072	2649092	AAAAAC	20	+	3	AAAAAC
gi|514486271|gb|KE346361.1|	2652707	2652760	AG	53	-	26	TC
gi|514486271|gb|KE346361.1|	2652918	2652933	ATCC	15	+	3	TCCA
gi|514486271|gb|KE346361.1|	2654333	2654363	AGC	30	+	10	AGC
gi|514486271|gb|KE346361.1|	2654464	2654495	ATC	31	-	10	ATG
gi|514486271|gb|KE346361.1|	2654607	2654622	AGCATC	15	+	2	GCATCA
gi|514486271|gb|KE346361.1|	2654620	2654637	AGCATC	17	+	2	CAGCAT
gi|514486271|gb|KE346361.1|	2654816	2654836	CCG	20	+	6	CCG
gi|514486271|gb|KE346361.1|	2654913	2654929	AGC	16	+	5	AGC
gi|514486271|gb|KE346361.1|	2654964	2654980	AACACG	16	+	2	ACGAAC
gi|514486271|gb|KE346361.1|	2655036	2655050	AACCACC	14	+	2	ACCACCA
gi|514486271|gb|KE346361.1|	2655063	2655080	ACGATG	17	+	2	GACGAT
gi|514486271|gb|KE346361.1|	2655581	2655595	AAGGAG	14	-	2	TTCTCC
gi|514486271|gb|KE346361.1|	2656359	2656377	ACG	18	+	6	CGA
gi|514486271|gb|KE346361.1|	2657661	2657685	A	24	-	24	T
gi|514486271|gb|KE346361.1|	2657849	2657865	A	16	-	16	T
gi|514486271|gb|KE346361.1|	2658055	2658082	A	27	-	27	T
gi|514486271|gb|KE346361.1|	2658263	2658295	A	32	-	32	T
gi|514486271|gb|KE346361.1|	2662731	2662760	AGC	29	-	9	CTG
gi|514486271|gb|KE346361.1|	2663522	2663539	AG	17	+	8	AG
gi|514486271|gb|KE346361.1|	2663540	2663565	AG	25	+	12	AG
gi|514486271|gb|KE346361.1|	2664156	2664184	AG	28	-	14	CT
gi|514486271|gb|KE346361.1|	2664504	2664518	AG	14	-	7	TC
gi|514486271|gb|KE346361.1|	2664731	2664752	AC	21	+	10	CA
gi|514486271|gb|KE346361.1|	2665250	2665264	ACTGGG	14	-	2	AGTCCC
gi|514486271|gb|KE346361.1|	2665840	2665854	ATCGC	14	+	2	CGCAT
gi|514486271|gb|KE346361.1|	2667460	2667478	AAAAAGC	18	-	2	TTTTGCT
gi|514486271|gb|KE346361.1|	2667473	2667494	A	21	-	21	T
gi|514486271|gb|KE346361.1|	2667517	2667531	AAAAT	14	-	2	TTTTA
gi|514486271|gb|KE346361.1|	2667701	2667751	AG	50	-	25	CT
gi|514486271|gb|KE346361.1|	2667759	2667775	ATC	16	+	5	CAT
